Gene Name,SynH_Exp_BXHU,SynH_Stat1_CUOC,log2change,counts_change,binned,Threshold where |count difference| is,Threshold of 2^n where n is
sokX,1,1,0.0,0,Unchanged,10,5
sokE,1,1,0.0,0,Unchanged,10,5
fnrS,1,2,1.0,1,Unchanged,10,5
mgrR,1,1,0.0,0,Unchanged,10,5
yrdF,2,5,1.3219280948873624,3,Unchanged,10,5
yneO,1069,5385,2.3326844917110794,4316,Upregulated,10,5
aaaE,138,1397,3.339591848631294,1259,Upregulated,10,5
oweE,13,123,3.2420747871981477,110,Upregulated,10,5
sroH,2,16,3.0,14,Upregulated,10,5
eyeA,1,1,0.0,0,Unchanged,10,5
rzoQ,2,22,3.4594316186372973,20,Upregulated,10,5
ykgS,29,83,1.5170584362193527,54,Upregulated,10,5
shoB,1,1,0.0,0,Unchanged,10,5
yshB,4,2,-1.0,-2,Unchanged,10,5
yrbN,1,1,0.0,0,Unchanged,10,5
yqfG,1,1,0.0,0,Unchanged,10,5
yqeL,1,1,0.0,0,Unchanged,10,5
yqcG,1,1,0.0,0,Unchanged,10,5
ypdK,1,1,0.0,0,Unchanged,10,5
yohP,1,1,0.0,0,Unchanged,10,5
yoeI,1,1,0.0,0,Unchanged,10,5
yobI,1,1,0.0,0,Unchanged,10,5
yoaK,1,1,0.0,0,Unchanged,10,5
yoaJ,1,1,0.0,0,Unchanged,10,5
ynbG,1,1,0.0,0,Unchanged,10,5
ymjD,1,1,0.0,0,Unchanged,10,5
ymiB,1,1,0.0,0,Unchanged,10,5
ykgR,1,1,0.0,0,Unchanged,10,5
yjeV,1,1,0.0,0,Unchanged,10,5
ilvX,1,1,0.0,0,Unchanged,10,5
ibsB,1,1,0.0,0,Unchanged,10,5
ibsA,1,1,0.0,0,Unchanged,10,5
ibsE,1,1,0.0,0,Unchanged,10,5
ibsC,1,1,0.0,0,Unchanged,10,5
ibsD,1,1,0.0,0,Unchanged,10,5
azuC,1,1,0.0,0,Unchanged,10,5
sgrT,5,10,1.0,5,Unchanged,10,5
yfcU,353,3690,3.385880727676578,3337,Upregulated,10,5
yhiL,32,433,3.758223214726725,401,Upregulated,10,5
yghX,317,1052,1.730579959152895,735,Upregulated,10,5
yjhZ,2,70,5.129283016944966,68,Upregulated,10,5
yjhY,311,271,-0.19862172877673107,-40,Downregulated,10,5
ythA,1,1,0.0,0,Unchanged,10,5
yjdQ,1,12,3.584962500721156,11,Upregulated,10,5
yicT,1,8,3.0,7,Unchanged,10,5
yibU,1,47,5.554588851677638,46,Upregulated,10,5
yibW,3,83,4.7900769306257684,80,Upregulated,10,5
yibS,3,105,5.129283016944966,102,Upregulated,10,5
ysaD,1,79,6.303780748177103,78,Upregulated,10,5
ysaC,1,1,0.0,0,Unchanged,10,5
mokA,1,15,3.9068905956085187,14,Upregulated,10,5
yrdE,18,203,3.495410915742864,185,Upregulated,10,5
psaA,1,1,0.0,0,Unchanged,10,5
ypjI,5,176,5.137503523749935,171,Upregulated,10,5
pawZ,1,1,0.0,0,Unchanged,10,5
yoeD,1,4,2.0,3,Unchanged,10,5
yoeH,27,18,-0.5849625007211563,-9,Unchanged,10,5
yoeG,160,321,1.0045013922349408,161,Upregulated,10,5
yeeH,1,1,0.0,0,Unchanged,10,5
ttcC,1,1,0.0,0,Unchanged,10,5
uof,1,1,0.0,0,Unchanged,10,5
ybfI,1,14,3.807354922057604,13,Upregulated,10,5
aaaD,6,264,5.459431618637297,258,Upregulated,10,5
xisD,77,169,1.1340928955872829,92,Upregulated,10,5
ylbI,1,1,0.0,0,Unchanged,10,5
ykgQ,1,1,0.0,0,Unchanged,10,5
ykgP,1,1,0.0,0,Unchanged,10,5
ykfK,2,92,5.523561956057013,90,Upregulated,10,5
ykfL,8,186,4.539158811108031,178,Upregulated,10,5
ykfN,1,1,0.0,0,Unchanged,10,5
symR,1,1,0.0,0,Unchanged,10,5
ryjB,1,1,0.0,0,Unchanged,10,5
insO,334,3978,3.5741232683596915,3644,Upregulated,10,5
ytcA,1,290,8.179909090014934,289,Upregulated,10,5
yjbS,1,7,2.807354922057604,6,Unchanged,10,5
yjbT,8,164,4.357552004618084,156,Upregulated,10,5
tisB,1,1,0.0,0,Unchanged,10,5
istR,1,21,4.392317422778761,20,Upregulated,10,5
yibV,3,94,4.9696263509564815,91,Upregulated,10,5
sokA,1,1,0.0,0,Unchanged,10,5
dinQ,2,7,1.8073549220576042,5,Unchanged,10,5
yrhD,1,2,1.0,1,Unchanged,10,5
sibE,3,3,0.0,0,Unchanged,10,5
ryfD,13,3,-2.115477217419936,-10,Downregulated,10,5
ohsC,1,1,0.0,0,Unchanged,10,5
ypfM,1,1,0.0,0,Unchanged,10,5
yojO,1,13,3.700439718141092,12,Upregulated,10,5
rseX,1,1,0.0,0,Unchanged,10,5
cydH,1,1,0.0,0,Unchanged,10,5
ydgU,1,1,0.0,0,Unchanged,10,5
mgtS,1,1,0.0,0,Unchanged,10,5
yncL,1,1,0.0,0,Unchanged,10,5
rydC,1,1,0.0,0,Unchanged,10,5
yciZ,212,57,-1.8950304403984575,-155,Downregulated,10,5
yciY,161,39,-2.0455146592523685,-122,Downregulated,10,5
ymgJ,6,8,0.41503749927884376,2,Unchanged,10,5
ymgI,1,3,1.584962500721156,2,Unchanged,10,5
appX,1,1,0.0,0,Unchanged,10,5
ybfK,1,97,6.599912842187128,96,Upregulated,10,5
ylcI,30,66,1.1375035237499351,36,Upregulated,10,5
ylcH,1,3,1.584962500721156,2,Unchanged,10,5
insN,1725,3383,0.9717068152410945,1658,Upregulated,10,5
ykfM,6,7,0.22239242133644802,1,Unchanged,10,5
chiX,1,1,0.0,0,Unchanged,10,5
yoeA,384,2481,2.6917435191712746,2097,Upregulated,10,5
ybeM,368,1091,1.5678734302665942,723,Upregulated,10,5
yaiT,548,5158,3.234563974828687,4610,Upregulated,10,5
yncK,14,232,4.050626073069968,218,Upregulated,10,5
sgrS,52,86,0.7258250365610057,34,Upregulated,10,5
insB7,37,824,4.477047161554268,787,Upregulated,10,5
yjgX,499,1673,1.745325724701092,1174,Upregulated,10,5
insZ,103,1383,3.7470849139672757,1280,Upregulated,10,5
ylbE,82,3030,5.20755007374223,2948,Upregulated,10,5
lomR,148,2885,4.284902237903895,2737,Upregulated,10,5
yhcE,1924,8506,2.144372055855722,6582,Upregulated,10,5
ytjA,336,72,-2.222392421336448,-264,Downregulated,10,5
yjjZ,6,136,4.502500340529183,130,Upregulated,10,5
topAI,23,98,2.0911478880581953,75,Upregulated,10,5
sgcB,7,172,4.618909832644494,165,Upregulated,10,5
insM,19,45,1.2439255828860891,26,Upregulated,10,5
ghoT,2,6,1.584962500721156,4,Unchanged,10,5
yifL,297,143,-1.0544477840223765,-154,Downregulated,10,5
yidD,474,222,-1.0943273825481532,-252,Downregulated,10,5
ysdC,69,1626,4.558587085296859,1557,Upregulated,10,5
yicS,31,198,2.6751603096927346,167,Upregulated,10,5
yibT,231,122,-0.9210117038531713,-109,Downregulated,10,5
ysaB,34,230,2.7580272096940357,196,Upregulated,10,5
yrhC,7,137,4.290677160902923,130,Upregulated,10,5
yheV,29,32,0.14201900487242786,3,Unchanged,10,5
arfA,59,39,-0.5972408304995929,-20,Downregulated,10,5
ypjJ,1,78,6.285402218862249,77,Upregulated,10,5
ypfN,80,151,0.9164766444377165,71,Upregulated,10,5
ypeB,91,111,0.28662122615140984,20,Upregulated,10,5
ypdJ,1,1,0.0,0,Unchanged,10,5
arnE,34,305,3.1652025911999093,271,Upregulated,10,5
ypaA,50,53,0.08406426478847455,3,Unchanged,10,5
yohO,1,1,0.0,0,Unchanged,10,5
yehK,1,94,6.554588851677638,93,Upregulated,10,5
yoeB,153,170,0.15200309344505006,17,Upregulated,10,5
yoeF,1,10,3.321928094887362,9,Unchanged,10,5
yecJ,185,148,-0.3219280948873623,-37,Downregulated,10,5
yobH,203,65,-1.6429681041567217,-138,Downregulated,10,5
yniD,1,2,1.0,1,Unchanged,10,5
ynfO,16,90,2.4918530963296748,74,Upregulated,10,5
hicA,39,37,-0.07594885323329863,-2,Unchanged,10,5
ydbJ,957,354,-1.4347695644030283,-603,Downregulated,10,5
rzoR,4,5,0.32192809488736235,1,Unchanged,10,5
ydaF,2,31,3.9541963103868754,29,Upregulated,10,5
ydaE,3,9,1.584962500721156,6,Unchanged,10,5
ymjC,2,3,0.5849625007211562,1,Unchanged,10,5
ymjB,29,1743,5.909375858998113,1714,Upregulated,10,5
yciX,30,29,-0.0489096004809464,-1,Unchanged,10,5
ymiA,3,11,1.874469117916141,8,Unchanged,10,5
ycgI,32,227,2.826548487290915,195,Upregulated,10,5
ymgF,9,22,1.289506617194985,13,Upregulated,10,5
icdC,3,27,3.169925001442312,24,Upregulated,10,5
ymdF,130,61,-1.0916304754655681,-69,Downregulated,10,5
gnsA,44,57,0.37345839552744436,13,Upregulated,10,5
insA4,7,262,5.226068079479846,255,Upregulated,10,5
cydX,8,4,-1.0,-4,Unchanged,10,5
ybfQ,10,66,2.722466024471091,56,Upregulated,10,5
kdpF,1,1,0.0,0,Unchanged,10,5
ybdD,18,71,1.9798221180623699,53,Upregulated,10,5
ybdZ,2,133,6.05528243550119,131,Upregulated,10,5
rzoD,5,9,0.8479969065549501,4,Unchanged,10,5
ylcG,1,6,2.584962500721156,5,Unchanged,10,5
peaD,2,231,6.851749041416057,229,Upregulated,10,5
ykgO,1,6,2.584962500721156,5,Unchanged,10,5
insX,130,242,0.89649542424614,112,Upregulated,10,5
ykfH,7,152,4.4405725913859815,145,Upregulated,10,5
yafF,3,90,4.906890595608519,87,Upregulated,10,5
yeiW,4,202,5.658211482751795,198,Upregulated,10,5
torI,13,29,1.15754127698648,16,Upregulated,10,5
yfaS,364,7694,4.401723474097919,7330,Upregulated,10,5
yehH,240,5701,4.570108690524543,5461,Upregulated,10,5
yeeL,51,389,2.931201003014696,338,Upregulated,10,5
yedS,262,791,1.5941108829353414,529,Upregulated,10,5
yedN,29,211,2.863118193579613,182,Upregulated,10,5
arpB,68,987,3.8594434332060583,919,Upregulated,10,5
gapC,14295,3808,-1.9084052362105168,-10487,Downregulated,10,5
ydbA,5237,15549,1.5700092896565043,10312,Upregulated,10,5
ycgH,586,1826,1.639714195561974,1240,Upregulated,10,5
efeU,20,1857,6.536830005048058,1837,Upregulated,10,5
ilvG,7954,14887,0.9043005867860018,6933,Upregulated,10,5
yjdP,165,637,1.9488273480104847,472,Upregulated,10,5
yjiV,1271,5318,2.0649197468527087,4047,Upregulated,10,5
ytfR,175,2691,3.9427155638080884,2516,Upregulated,10,5
cpxP,1372,2510,0.8714068826653221,1138,Upregulated,10,5
tatD,906,1419,0.6472916340143162,513,Upregulated,10,5
yigE,43,1044,4.601641241867787,1001,Upregulated,10,5
wecF,834,1273,0.6101131304566944,439,Upregulated,10,5
hdfR,1225,1064,-0.20328359838874335,-161,Downregulated,10,5
dgoR,326,1708,2.389364105389413,1382,Upregulated,10,5
dgoD,115,2334,4.343098794762973,2219,Upregulated,10,5
dgoA,39,973,4.6408937759188635,934,Upregulated,10,5
gntU,350,3078,3.1365664044958814,2728,Upregulated,10,5
rtcA,332,2851,3.102212892591028,2519,Upregulated,10,5
frlC,64,1370,4.419960177847889,1306,Upregulated,10,5
smf,493,951,0.9478576944826519,458,Upregulated,10,5
yhdP,3334,6050,0.8596810380629025,2716,Upregulated,10,5
tdcG,127,1768,3.799217872619266,1641,Upregulated,10,5
cyuA,278,2229,3.003239828536245,1951,Upregulated,10,5
ygiQ,1439,3832,1.4130309689958824,2393,Upregulated,10,5
glcE,78,2695,5.11066733877762,2617,Upregulated,10,5
glcF,301,3146,3.3856832786559847,2845,Upregulated,10,5
yghJ,7703,8990,0.2229006904246339,1287,Upregulated,10,5
yggP,89,1558,4.129746087095271,1469,Upregulated,10,5
ghxQ,238,1659,2.8012804076479196,1421,Upregulated,10,5
ygcU,68,1934,4.829909238226501,1866,Upregulated,10,5
ygaQ,17,946,5.798233532089056,929,Upregulated,10,5
yfjD,652,1551,1.2502548168050134,899,Upregulated,10,5
araH,277,1225,2.1448238678407443,948,Upregulated,10,5
ryjA,1,16,4.0,15,Upregulated,10,5
oxyS,1,1,0.0,0,Unchanged,10,5
csrC,64712,3906,-4.0502694117477835,-60806,Downregulated,10,5
glmZ,2821,925,-1.608681395181897,-1896,Downregulated,10,5
hokA,1,3,1.584962500721156,2,Unchanged,10,5
rdlD,1,1,0.0,0,Unchanged,10,5
ldrD,1,1,0.0,0,Unchanged,10,5
gadY,1,1,0.0,0,Unchanged,10,5
ryhB,1,1,0.0,0,Unchanged,10,5
arcZ,1,1,0.0,0,Unchanged,10,5
sraG,1,19,4.247927513443585,18,Upregulated,10,5
sibD,3,12,2.0,9,Unchanged,10,5
sibC,1,7,2.807354922057604,6,Unchanged,10,5
omrB,1,1,0.0,0,Unchanged,10,5
omrA,1,1,0.0,0,Unchanged,10,5
gcvB,1042,50,-4.381283372503783,-992,Downregulated,10,5
micA,1,1,0.0,0,Unchanged,10,5
glmY,101,54,-0.9033239805883261,-47,Downregulated,10,5
ryfA,185,389,1.0722448844698798,204,Upregulated,10,5
micF,1,1,0.0,0,Unchanged,10,5
cyaR,1,1,0.0,0,Unchanged,10,5
sibB,1,6,2.584962500721156,5,Unchanged,10,5
sibA,2,10,2.321928094887362,8,Unchanged,10,5
isrC,35,18,-0.9593580155026542,-17,Downregulated,10,5
sdsR,1,1,0.0,0,Unchanged,10,5
ryeA,331,240,-0.46379681119869925,-91,Downregulated,10,5
rprA,1,1,0.0,0,Unchanged,10,5
rydB,1,1,0.0,0,Unchanged,10,5
sokB,1,1,0.0,0,Unchanged,10,5
hokB,6,11,0.874469117916141,5,Unchanged,10,5
micC,1,1,0.0,0,Unchanged,10,5
mcaS,1,13,3.700439718141092,12,Upregulated,10,5
rttR,15,132,3.137503523749935,117,Upregulated,10,5
rdlC,1,1,0.0,0,Unchanged,10,5
ldrC,1,1,0.0,0,Unchanged,10,5
rdlB,1,1,0.0,0,Unchanged,10,5
ldrB,1,3,1.584962500721156,2,Unchanged,10,5
rdlA,1,1,0.0,0,Unchanged,10,5
ldrA,2,1,-1.0,-1,Unchanged,10,5
sraB,2,14,2.807354922057604,12,Upregulated,10,5
rybB,1,1,0.0,0,Unchanged,10,5
rybA,1,1,0.0,0,Unchanged,10,5
hokE,3,18,2.584962500721156,15,Upregulated,10,5
tff,75,8,-3.228818690495881,-67,Downregulated,10,5
sokC,1,1,0.0,0,Unchanged,10,5
hokC,1,10,3.321928094887362,9,Unchanged,10,5
ecnB,30,24,-0.3219280948873623,-6,Unchanged,10,5
ecnA,2,3,0.5849625007211562,1,Unchanged,10,5
blr,16,3,-2.415037499278844,-13,Downregulated,10,5
csrB,623178,260368,-1.2590921550619776,-362810,Downregulated,10,5
thiS,6,71,3.564784618783526,65,Upregulated,10,5
yaeP,974,316,-1.6239972139052394,-658,Downregulated,10,5
yjtD,303,1091,1.8482614028506563,788,Upregulated,10,5
yjjY,1,12,3.584962500721156,11,Upregulated,10,5
arcA,18961,3232,-2.55253595053786,-15729,Downregulated,10,5
creD,132,2359,4.159565583881009,2227,Upregulated,10,5
creC,331,3081,3.2184955602321335,2750,Upregulated,10,5
creB,419,1320,1.6555157805464642,901,Upregulated,10,5
creA,590,815,0.4660851048692364,225,Upregulated,10,5
rob,3855,2200,-0.8092273363903748,-1655,Downregulated,10,5
ytjC,1339,1457,0.12184491674020201,118,Upregulated,10,5
yjjX,410,1130,1.4626269577971038,720,Upregulated,10,5
trpR,367,545,0.5704761668210759,178,Upregulated,10,5
slt,3688,5047,0.4525874308690885,1359,Upregulated,10,5
ettA,10993,4743,-1.2127133793175484,-6250,Downregulated,10,5
nadR,1902,2532,0.4127601585677778,630,Upregulated,10,5
radA,2676,3891,0.5400628643313947,1215,Upregulated,10,5
serB,1260,2385,0.920565532505595,1125,Upregulated,10,5
ytjB,442,1204,1.4457171173682706,762,Upregulated,10,5
lplA,857,2361,1.4620309321161429,1504,Upregulated,10,5
yjjJ,688,2642,1.9411499965447296,1954,Upregulated,10,5
deoD,7557,3615,-1.0638179756169173,-3942,Downregulated,10,5
deoB,10766,7437,-0.5336896532115522,-3329,Downregulated,10,5
deoA,4885,6684,0.4523531712054403,1799,Upregulated,10,5
deoC,2561,3892,0.6038044571836431,1331,Upregulated,10,5
yjjI,5004,5258,0.0714323524522261,254,Upregulated,10,5
yjjW,1294,2319,0.841665202653496,1025,Upregulated,10,5
yjjV,529,1681,1.6679800971221417,1152,Upregulated,10,5
yjjU,1517,2120,0.48284317920352815,603,Upregulated,10,5
osmY,3816,1635,-1.2227705356200667,-2181,Downregulated,10,5
prfC,3488,3339,-0.06298394671381069,-149,Downregulated,10,5
yjjG,1035,1347,0.3801190830756155,312,Upregulated,10,5
rimI,804,829,0.04417660031682193,25,Upregulated,10,5
holD,946,872,-0.11751204856246883,-74,Downregulated,10,5
rsmC,1525,2059,0.4331345872946432,534,Upregulated,10,5
fhuF,67,1197,4.15911824648573,1130,Upregulated,10,5
bglJ,25,477,4.2539892662307865,452,Upregulated,10,5
yjjQ,17,629,5.20945336562895,612,Upregulated,10,5
yjjP,456,1375,1.5923258891346426,919,Upregulated,10,5
yjjB,206,646,1.6488898275107065,440,Upregulated,10,5
dnaT,209,718,1.7804809017421686,509,Upregulated,10,5
dnaC,465,1575,1.7600492072792475,1110,Upregulated,10,5
yjjA,498,897,0.8489622428511803,399,Upregulated,10,5
opgB,2212,5627,1.3470145778228502,3415,Upregulated,10,5
lgoD,25,2008,6.327687364176048,1983,Upregulated,10,5
lgoR,244,1756,2.847339791972472,1512,Upregulated,10,5
lgoT,158,3325,4.395357877098811,3167,Upregulated,10,5
tsr,315,4676,3.8918511961443776,4361,Upregulated,10,5
btsT,618,7336,3.5693148956906797,6718,Upregulated,10,5
yjiX,29,104,1.84245872301352,75,Upregulated,10,5
yjiA,1004,2341,1.2213656651612408,1337,Upregulated,10,5
mrr,878,1767,1.0090091950162585,889,Upregulated,10,5
hsdR,5342,8841,0.7268295852100465,3499,Upregulated,10,5
hsdM,1239,2944,1.2486014839164112,1705,Upregulated,10,5
hsdS,698,1184,0.7623701394192975,486,Upregulated,10,5
symE,93,322,1.7917580670065856,229,Upregulated,10,5
mcrB,870,1119,0.36312273024030334,249,Upregulated,10,5
mcrC,279,477,0.773724144176324,198,Upregulated,10,5
yjiT,3658,2524,-0.5353431647661675,-1134,Downregulated,10,5
yjiS,2,38,4.247927513443585,36,Upregulated,10,5
yjiR,298,2529,3.0851828012010767,2231,Upregulated,10,5
mdtM,575,2213,1.944369589969274,1638,Upregulated,10,5
yjiN,588,2484,2.078777113384117,1896,Upregulated,10,5
yjiM,4315,3389,-0.34850092258232307,-926,Downregulated,10,5
yjiL,1152,1680,0.5443205162238102,528,Upregulated,10,5
yjiK,240,1022,2.090288885329103,782,Upregulated,10,5
yjiJ,100,2147,4.424250286084049,2047,Upregulated,10,5
kptA,173,822,2.2483663560449583,649,Upregulated,10,5
yjiH,20255,4357,-2.2168710666586313,-15898,Downregulated,10,5
yjiG,11863,2271,-2.3850692838713368,-9592,Downregulated,10,5
iadA,53248,9915,-2.425042661024882,-43333,Downregulated,10,5
hypT,7998,3191,-1.3256306725308171,-4807,Downregulated,10,5
iraD,753,575,-0.3890879088401906,-178,Downregulated,10,5
yjiC,34,450,3.7263183499666974,416,Upregulated,10,5
uxuR,769,1481,0.9455161373270212,712,Upregulated,10,5
uxuB,221,3413,3.9489221397074337,3192,Upregulated,10,5
uxuA,200,2027,3.341274183692174,1827,Upregulated,10,5
gntP,123,2064,4.068712750084014,1941,Upregulated,10,5
fimH,225,1241,2.4635062089133197,1016,Upregulated,10,5
fimG,119,676,2.5060616729742407,557,Upregulated,10,5
fimF,73,604,3.0485801804450614,531,Upregulated,10,5
fimD,455,3930,3.1105908620599103,3475,Upregulated,10,5
fimC,251,746,1.5714882663044658,495,Upregulated,10,5
fimI,604,797,0.4000311746653929,193,Upregulated,10,5
fimA,5131,1171,-2.131498949690201,-3960,Downregulated,10,5
fimE,36,611,4.085103568376417,575,Upregulated,10,5
fimB,453,521,0.20177232223227326,68,Upregulated,10,5
nanC,13,540,5.376375878909739,527,Upregulated,10,5
nanM,473,1073,1.1817379874171268,600,Upregulated,10,5
nanS,134,1239,3.2088712816828293,1105,Upregulated,10,5
yjhR,61,1303,4.416884031005248,1242,Upregulated,10,5
yjhQ,164,818,2.3184050283236655,654,Upregulated,10,5
yjhP,281,1574,2.4857935052865603,1293,Upregulated,10,5
sgcX,106,1900,4.163863248655111,1794,Upregulated,10,5
sgcC,109,2384,4.450984195685235,2275,Upregulated,10,5
sgcQ,91,1421,3.964896199044084,1330,Upregulated,10,5
sgcA,87,645,2.890211854461888,558,Upregulated,10,5
sgcE,126,1200,3.2515387669959646,1074,Upregulated,10,5
sgcR,141,1365,3.275133883408421,1224,Upregulated,10,5
yjhI,52,650,3.643856189774725,598,Upregulated,10,5
yjhH,117,1553,3.7304773948038967,1436,Upregulated,10,5
yjhG,585,4332,2.8885247131375604,3747,Upregulated,10,5
yjhF,68,2459,5.176393178345743,2391,Upregulated,10,5
yjhU,1749,2834,0.6963094689963659,1085,Upregulated,10,5
insA7,35,295,3.0752881273042374,260,Upregulated,10,5
fecI,59,1258,4.414273157517448,1199,Upregulated,10,5
fecR,50,2024,5.339137384919585,1974,Upregulated,10,5
fecA,161,6076,5.2379892763874665,5915,Upregulated,10,5
fecB,171,2314,3.758320634221592,2143,Upregulated,10,5
fecC,87,2035,4.547869583304881,1948,Upregulated,10,5
fecD,71,1658,4.545481171991068,1587,Upregulated,10,5
fecE,143,1471,3.3627101944764406,1328,Upregulated,10,5
yjhV,7,388,5.792557920129523,381,Upregulated,10,5
insI3,26,13,-1.0,-13,Downregulated,10,5
yjhE,4,173,5.434628227636725,169,Upregulated,10,5
yjhD,16,125,2.965784284662087,109,Upregulated,10,5
nanY,303,814,1.425711000793296,511,Upregulated,10,5
nanX,73,541,2.889660224946798,468,Upregulated,10,5
insG,539,2030,1.9131225493200332,1491,Upregulated,10,5
yjgZ,2,370,7.531381460516312,368,Upregulated,10,5
insD6,314,333,0.08475761817963527,19,Upregulated,10,5
insC6,297,262,-0.18089611926331556,-35,Downregulated,10,5
intB,473,1343,1.5055472160880472,870,Upregulated,10,5
ahr,1429,1372,-0.0587254349230041,-57,Downregulated,10,5
idnK,61,375,2.620009447820357,314,Upregulated,10,5
idnD,92,1218,3.7267364618493195,1126,Upregulated,10,5
idnO,86,678,2.978876708434246,592,Upregulated,10,5
idnT,135,1472,3.4467463590061818,1337,Upregulated,10,5
idnR,316,1169,1.8872784663545534,853,Upregulated,10,5
yjgR,999,2404,1.2668803129187671,1405,Upregulated,10,5
lptG,1926,2552,0.4060206259214101,626,Upregulated,10,5
lptF,1531,2441,0.6729980122813661,910,Upregulated,10,5
pepA,14790,6269,-1.238314817550709,-8521,Downregulated,10,5
holC,1329,781,-0.7669466511341951,-548,Downregulated,10,5
valS,23802,10327,-1.204661592068277,-13475,Downregulated,10,5
yjgN,38,420,3.466318004222537,382,Upregulated,10,5
yjgM,397,541,0.4464895866838575,144,Upregulated,10,5
rraB,3370,1086,-1.6337244882648594,-2284,Downregulated,10,5
argI,736,3290,2.160309912565591,2554,Upregulated,10,5
yjgL,292,252,-0.21254463538010074,-40,Downregulated,10,5
tabA,1081,416,-1.377711089593558,-665,Downregulated,10,5
bdcR,178,385,1.112981204615866,207,Upregulated,10,5
bdcA,106,792,2.9014361655164103,686,Upregulated,10,5
yjgH,120,294,1.292781749227846,174,Upregulated,10,5
pyrL,186,20,-3.217230716220669,-166,Downregulated,10,5
pyrB,140918,1708,-6.366404119239856,-139210,Downregulated,10,5
pyrI,71072,608,-6.869066164103395,-70464,Downregulated,10,5
ridA,34381,897,-5.26035971204243,-33484,Downregulated,10,5
mgtA,1319,4158,1.6564451936068254,2839,Upregulated,10,5
treR,678,1218,0.8451569547699884,540,Upregulated,10,5
treB,191,2014,3.398419139971036,1823,Upregulated,10,5
treC,173,2259,3.7068403277563595,2086,Upregulated,10,5
nrdD,2249,4026,0.8400635111435228,1777,Upregulated,10,5
nrdG,148,440,1.5719063478957098,292,Upregulated,10,5
cybC,227,432,0.9283390148725535,205,Upregulated,10,5
tldE,3937,2957,-0.41296246903871686,-980,Downregulated,10,5
yjgA,957,820,-0.22289501498057954,-137,Downregulated,10,5
mpl,4487,3051,-0.5564690040976888,-1436,Downregulated,10,5
fbp,5724,2020,-1.5026683790875106,-3704,Downregulated,10,5
yjfF,105,1226,3.5454977460246586,1121,Upregulated,10,5
ytfT,94,1494,3.9903755811115995,1400,Upregulated,10,5
ytfQ,214,1326,2.631398073711441,1112,Upregulated,10,5
ppa,8657,1608,-2.4285997529658547,-7049,Downregulated,10,5
chpB,91,412,2.178705886984522,321,Upregulated,10,5
chpS,81,184,1.183711953172388,103,Upregulated,10,5
ytfP,1536,413,-1.894964529301711,-1123,Downregulated,10,5
tamB,4177,7508,0.8459615066680816,3331,Upregulated,10,5
tamA,2349,3583,0.6091213301985393,1234,Upregulated,10,5
msrA,1422,1071,-0.4089629848691594,-351,Downregulated,10,5
ytfL,468,2004,2.0983020736118037,1536,Upregulated,10,5
ytfK,137,44,-1.6386004643232295,-93,Downregulated,10,5
ytfJ,73,630,3.1093834595072614,557,Upregulated,10,5
ytfI,28,283,3.337303320774278,255,Upregulated,10,5
cysQ,975,1065,0.12737930647622742,90,Upregulated,10,5
cpdB,1721,2884,0.7448240672006189,1163,Upregulated,10,5
ytfH,43,368,3.0972972013549147,325,Upregulated,10,5
qorB,346,1323,1.934969118641952,977,Upregulated,10,5
ytfF,77,1433,4.2180363535672445,1356,Upregulated,10,5
ytfE,87,834,3.2609600775959353,747,Upregulated,10,5
cycA,2479,2784,0.16740093976200615,305,Upregulated,10,5
fklB,5501,1399,-1.9752979404805746,-4102,Downregulated,10,5
ytfB,1143,1018,-0.16708784213878292,-125,Downregulated,10,5
ytfA,5,159,4.990954860396993,154,Upregulated,10,5
yjfZ,28,551,4.298553586513553,523,Upregulated,10,5
rplI,15234,2078,-2.87402724146445,-13156,Downregulated,10,5
rpsR,2683,578,-2.2147056567598424,-2105,Downregulated,10,5
priB,5540,925,-2.582360705532876,-4615,Downregulated,10,5
rpsF,13785,2732,-2.3350698786074626,-11053,Downregulated,10,5
yjfY,23,146,2.666262602823004,123,Upregulated,10,5
ulaF,109,1035,3.247230727609761,926,Upregulated,10,5
ulaE,192,1468,2.9346737521220567,1276,Upregulated,10,5
ulaD,166,1103,2.732177644244458,937,Upregulated,10,5
ulaC,45,499,3.471042909007586,454,Upregulated,10,5
ulaB,14,287,4.357552004618084,273,Upregulated,10,5
ulaA,43,2279,5.727920454563199,2236,Upregulated,10,5
ulaG,75,1749,4.543495883425772,1674,Upregulated,10,5
ulaR,443,1254,1.5011587442470207,811,Upregulated,10,5
yjfP,243,1078,2.1493289591467244,835,Upregulated,10,5
bsmA,77,285,1.8880315683572026,208,Upregulated,10,5
yjfN,41,141,1.78199934778071,100,Upregulated,10,5
aidB,5102,2629,-0.9565487569844264,-2473,Downregulated,10,5
yjfC,41,1601,5.287205587898173,1560,Upregulated,10,5
yjfM,17,759,5.480493234165127,742,Upregulated,10,5
yjfL,6,290,5.594946589293778,284,Upregulated,10,5
yjfK,13,675,5.698303973797101,662,Upregulated,10,5
yjfJ,41,1164,4.8273233382902,1123,Upregulated,10,5
yjfI,12,106,3.142957953842043,94,Upregulated,10,5
rlmB,1045,1441,0.46356739320650253,396,Upregulated,10,5
rnr,10457,8416,-0.31326240762558943,-2041,Downregulated,10,5
nsrR,295,477,0.6932743117563079,182,Upregulated,10,5
purA,23089,18152,-0.3470771762571141,-4937,Downregulated,10,5
yjeT,5,104,4.37851162325373,99,Upregulated,10,5
hflC,6891,3677,-0.9061841808957836,-3214,Downregulated,10,5
hflK,9808,6222,-0.6565805841563997,-3586,Downregulated,10,5
hflX,7991,5306,-0.5907513788716409,-2685,Downregulated,10,5
hfq,4476,1251,-1.839128246810574,-3225,Downregulated,10,5
miaA,10145,7422,-0.45088895894649533,-2723,Downregulated,10,5
mutL,2299,5565,1.2753752215111418,3266,Upregulated,10,5
amiB,1778,3773,1.0854567759803395,1995,Upregulated,10,5
tsaE,552,824,0.5779760704050493,272,Upregulated,10,5
nnr,2667,4200,0.6551715030025589,1533,Upregulated,10,5
queG,779,2929,1.9107129598176977,2150,Upregulated,10,5
orn,1620,1054,-0.6201189461347726,-566,Downregulated,10,5
rsgA,2150,2617,0.28357726457121224,467,Upregulated,10,5
psd,3235,3212,-0.010293819362555372,-23,Downregulated,10,5
mscM,1887,6836,1.857057974075694,4949,Upregulated,10,5
yjeO,23,256,3.476438043942987,233,Upregulated,10,5
yjeN,28,239,3.0935118859231445,211,Upregulated,10,5
yjeM,151,1858,3.6211300470575742,1707,Upregulated,10,5
epmA,421,1287,1.6121199151543057,866,Upregulated,10,5
frdA,38764,8131,-2.253212748243349,-30633,Downregulated,10,5
frdB,10822,2048,-2.4016795259824515,-8774,Downregulated,10,5
frdC,4966,751,-2.725199448662569,-4215,Downregulated,10,5
frdD,5398,836,-2.690850129385969,-4562,Downregulated,10,5
ampC,749,1332,0.8305564586125112,583,Upregulated,10,5
blc,259,528,1.0275858316718995,269,Upregulated,10,5
gdx,132,288,1.1255308820838588,156,Upregulated,10,5
efp,7060,1073,-2.7180181074020204,-5987,Downregulated,10,5
epmB,1192,1594,0.41926739352831016,402,Upregulated,10,5
yjeJ,98,792,3.014646775964401,694,Upregulated,10,5
yjeI,2567,945,-1.4416970614669833,-1622,Downregulated,10,5
groL,60572,25188,-1.2659144754207468,-35384,Downregulated,10,5
groS,4494,1107,-2.0213449023983547,-3387,Downregulated,10,5
yjeH,732,1696,1.2122206162791567,964,Upregulated,10,5
fxsA,574,839,0.5476200737641356,265,Upregulated,10,5
aspA,7847,3180,-1.3031144346913133,-4667,Downregulated,10,5
dcuA,11019,3961,-1.4760566955481942,-7058,Downregulated,10,5
cutA,328,248,-0.4033556942312085,-80,Downregulated,10,5
dsbD,2441,2656,0.12178285156577087,215,Upregulated,10,5
yjdC,1807,825,-1.1311304817314214,-982,Downregulated,10,5
cadC,251,870,1.7933280367853186,619,Upregulated,10,5
cadB,32,1087,5.086136225027309,1055,Upregulated,10,5
cadA,78,2308,4.887025289783234,2230,Upregulated,10,5
dtpC,250,1637,2.7110543218120666,1387,Upregulated,10,5
lysU,3428,2158,-0.6676722446244828,-1270,Downregulated,10,5
ghoS,46,65,0.4988058569714417,19,Upregulated,10,5
yjdJ,160,156,-0.03652587602511404,-4,Unchanged,10,5
yjdI,58,102,0.8144443468439234,44,Upregulated,10,5
dcuS,1229,2441,0.9899873794084922,1212,Upregulated,10,5
dcuR,766,929,0.2783342044576957,163,Upregulated,10,5
dcuB,9416,4483,-1.070649820987756,-4933,Downregulated,10,5
fumB,16430,6852,-1.2617354237534377,-9578,Downregulated,10,5
yjdF,122,849,2.798883405990152,727,Upregulated,10,5
melB,163,1347,3.0468059812312256,1184,Upregulated,10,5
melA,196,1969,3.3285375517863454,1773,Upregulated,10,5
melR,202,1317,2.7048281475047196,1115,Upregulated,10,5
adiA,168,3617,4.428260459877014,3449,Upregulated,10,5
adiY,269,467,0.7958163771530377,198,Upregulated,10,5
adiC,127,1957,3.945743353854638,1830,Upregulated,10,5
eptA,83,2242,4.755531131458502,2159,Upregulated,10,5
basR,363,1064,1.551456697505439,701,Upregulated,10,5
basS,231,1723,2.8989579448088905,1492,Upregulated,10,5
proP,7138,11464,0.6835187082131229,4326,Upregulated,10,5
rdcB,118,2059,4.125085065270413,1941,Upregulated,10,5
rdcA,329,5157,3.970372556463976,4828,Upregulated,10,5
yjdM,620,485,-0.3542834681997476,-135,Downregulated,10,5
yjdN,279,1028,1.8815032373646905,749,Upregulated,10,5
phnC,5,1596,8.318316841334983,1591,Upregulated,10,5
phnD,10,2957,8.207990433232961,2947,Upregulated,10,5
phnF,12,1817,7.242380203512959,1805,Upregulated,10,5
phnG,4,1004,7.971543553950772,1000,Upregulated,10,5
phnH,2,1362,9.411510988012072,1360,Upregulated,10,5
phnI,4,2328,9.184875342908283,2324,Upregulated,10,5
phnJ,12,2435,7.664743556248548,2423,Upregulated,10,5
phnK,15,1614,6.749534267669262,1599,Upregulated,10,5
phnL,40,2108,5.719731056749852,2068,Upregulated,10,5
phnM,29,3408,6.876728625098266,3379,Upregulated,10,5
phnN,33,1465,5.472290829951157,1432,Upregulated,10,5
phnO,153,1071,2.807354922057604,918,Upregulated,10,5
phnP,181,1876,3.373598225432171,1695,Upregulated,10,5
rpiB,45,889,4.304186512500095,844,Upregulated,10,5
alsR,590,1545,1.3888199785425335,955,Upregulated,10,5
alsB,88,1801,4.355150847268979,1713,Upregulated,10,5
alsA,24,2769,6.850186837645774,2745,Upregulated,10,5
alsC,25,2036,6.34766565630097,2011,Upregulated,10,5
alsE,43,1228,4.835830090668082,1185,Upregulated,10,5
alsK,110,1821,4.0491554934521785,1711,Upregulated,10,5
yjcS,27,3694,7.09608064881897,3667,Upregulated,10,5
mdtN,13,1986,7.255210189387282,1973,Upregulated,10,5
mdtO,55,4169,6.24412594328373,4114,Upregulated,10,5
mdtP,42,3298,6.295058260658707,3256,Upregulated,10,5
fdhF,4319,4771,0.14359436977728296,452,Upregulated,10,5
yjcO,696,1490,1.0981531195007956,794,Upregulated,10,5
gltP,6078,5245,-0.21265390205766438,-833,Downregulated,10,5
nrfG,73,1005,3.7831552271862736,932,Upregulated,10,5
nrfF,53,582,3.4569548883450847,529,Upregulated,10,5
nrfE,331,3870,3.547430444224555,3539,Upregulated,10,5
nrfD,2101,2167,0.04462299142062747,66,Upregulated,10,5
nrfC,1432,1468,0.035820475578956346,36,Upregulated,10,5
nrfB,1324,871,-0.604158498208353,-453,Downregulated,10,5
nrfA,7611,3380,-1.1710627736155488,-4231,Downregulated,10,5
acs,65,4302,6.0484239963946065,4237,Upregulated,10,5
yjcH,5,271,5.760220946466509,266,Upregulated,10,5
actP,86,3293,5.25892204189325,3207,Upregulated,10,5
yjcF,11,168,3.932885804141463,157,Upregulated,10,5
yjcE,1302,4311,1.7272931140128571,3009,Upregulated,10,5
ghxP,2213,3334,0.5912506531854052,1121,Upregulated,10,5
soxR,143,614,2.10222350859179,471,Upregulated,10,5
soxS,84,345,2.038135128886771,261,Upregulated,10,5
pdeC,217,2160,3.3152643646063513,1943,Upregulated,10,5
yjcB,58,378,2.7042614290935005,320,Upregulated,10,5
ssb,1912,1466,-0.3831974198469366,-446,Downregulated,10,5
uvrA,5169,8394,0.6994732609398051,3225,Upregulated,10,5
yjbR,2674,610,-2.132118317643104,-2064,Downregulated,10,5
yjbQ,4184,979,-2.0955020866432466,-3205,Downregulated,10,5
aphA,502,1096,1.1264885290097546,594,Upregulated,10,5
tyrB,1916,2412,0.33213234616390447,496,Upregulated,10,5
alr,2452,2474,0.012886521285588268,22,Upregulated,10,5
dnaB,4407,3311,-0.41252988588043665,-1096,Downregulated,10,5
qorA,3702,2050,-0.8526809854777657,-1652,Downregulated,10,5
pspG,511,477,-0.09933402493210979,-34,Downregulated,10,5
dusA,1120,1642,0.5519553948328383,522,Upregulated,10,5
yjbM,14,219,3.967432137543569,205,Upregulated,10,5
yjbL,3,4,0.41503749927884376,1,Unchanged,10,5
zur,717,777,0.11594147970580533,60,Upregulated,10,5
yjbJ,1018,58,-4.1335408509481235,-960,Downregulated,10,5
dinF,680,1930,1.504994196017741,1250,Upregulated,10,5
lexA,4786,1260,-1.92539666315122,-3526,Downregulated,10,5
dgkA,506,514,0.02263097449956785,8,Unchanged,10,5
plsB,7820,5034,-0.6354633910337353,-2786,Downregulated,10,5
ubiA,776,1208,0.6384918971379513,432,Upregulated,10,5
ubiC,444,734,0.7252203864931068,290,Upregulated,10,5
yjbI,18,224,3.6374299206152916,206,Upregulated,10,5
malM,606,1216,1.0047535299706345,610,Upregulated,10,5
lamB,1703,1893,0.15259597602516287,190,Upregulated,10,5
malK,892,1622,0.8626582042969683,730,Upregulated,10,5
malE,3388,2359,-0.5222584560927361,-1029,Downregulated,10,5
malF,1100,2518,1.1947747593069946,1418,Upregulated,10,5
malG,644,1494,1.2140475546746203,850,Upregulated,10,5
xylE,1738,4744,1.4486759277316035,3006,Upregulated,10,5
psiE,269,421,0.6462140605097719,152,Upregulated,10,5
yjbH,366,3374,3.2045444200035234,3008,Upregulated,10,5
yjbG,73,1306,4.161114622666413,1233,Upregulated,10,5
yjbF,90,934,3.3754256433799874,844,Upregulated,10,5
yjbE,250,121,-1.0469210473874926,-129,Downregulated,10,5
pgi,21407,9183,-1.2210451783558893,-12224,Downregulated,10,5
lysC,6664,3490,-0.9331613642685329,-3174,Downregulated,10,5
yjbD,238,190,-0.3249621549769956,-48,Downregulated,10,5
rluF,494,1309,1.4058821503605632,815,Upregulated,10,5
pepE,2509,1372,-0.8708319892363603,-1137,Downregulated,10,5
yjbB,443,2954,2.737291222209771,2511,Upregulated,10,5
metH,13700,9762,-0.4889272363415674,-3938,Downregulated,10,5
iclR,1078,1486,0.4630769377860907,408,Upregulated,10,5
arpA,24,1138,5.567322341585426,1114,Upregulated,10,5
aceK,4932,4807,-0.03703599626494348,-125,Downregulated,10,5
aceA,39373,30142,-0.38543149521528347,-9231,Downregulated,10,5
aceB,48476,32756,-0.5655114666724081,-15720,Downregulated,10,5
metA,6858,1375,-2.31835628563625,-5483,Downregulated,10,5
yjaB,112,468,2.0630097975258006,356,Upregulated,10,5
yjaA,13,288,4.46948528330122,275,Upregulated,10,5
purH,11038,4174,-1.4029762850318608,-6864,Downregulated,10,5
purD,6179,2666,-1.2126965930140288,-3513,Downregulated,10,5
zraR,567,2598,2.1959807905056525,2031,Upregulated,10,5
zraS,213,2435,3.5149964367438664,2222,Upregulated,10,5
zraP,319,591,0.8896017064126631,272,Upregulated,10,5
yjaH,570,1236,1.1166449188522707,666,Upregulated,10,5
hupA,5686,487,-3.5454204215951854,-5199,Downregulated,10,5
yjaG,1224,1253,0.033782856629208644,29,Upregulated,10,5
nfi,1213,1625,0.42186016768266893,412,Upregulated,10,5
hemE,3464,2625,-0.40012150728587764,-839,Downregulated,10,5
nudC,1125,1230,0.12873331412220274,105,Upregulated,10,5
rsd,379,476,0.32876372513685176,97,Upregulated,10,5
thiC,591,3711,2.6505779655199935,3120,Upregulated,10,5
thiE,139,918,2.7234092706903006,779,Upregulated,10,5
thiF,187,906,2.276472780158598,719,Upregulated,10,5
thiG,156,1144,2.8744691179161412,988,Upregulated,10,5
thiH,228,1708,2.9052022454557487,1480,Upregulated,10,5
yjaZ,84,404,2.2658940599730344,320,Upregulated,10,5
rpoC,116263,31573,-1.880628786716989,-84690,Downregulated,10,5
rpoB,100349,30032,-1.7404537796026385,-70317,Downregulated,10,5
rplL,47998,10674,-2.1688733758491825,-37324,Downregulated,10,5
rplJ,38001,8268,-2.2004270898396565,-29733,Downregulated,10,5
rplA,44628,10175,-2.132920359292172,-34453,Downregulated,10,5
rplK,16587,2793,-2.5701654987930755,-13794,Downregulated,10,5
nusG,7247,1625,-2.156944176181562,-5622,Downregulated,10,5
secE,4402,956,-2.203076621910809,-3446,Downregulated,10,5
tufB,124091,9085,-3.771768159629583,-115006,Downregulated,10,5
coaA,1280,570,-1.1671099858352583,-710,Downregulated,10,5
birA,972,1054,0.11684664803143371,82,Upregulated,10,5
murB,1710,1051,-0.7022336558110819,-659,Downregulated,10,5
murI,1263,1275,0.01364260795866807,12,Upregulated,10,5
btuB,5171,2278,-1.1826755577752772,-2893,Downregulated,10,5
trmA,2850,1745,-0.7077348828424518,-1105,Downregulated,10,5
yijD,1185,541,-1.1311865599588062,-644,Downregulated,10,5
fabR,1822,1364,-0.41767931477787823,-458,Downregulated,10,5
sthA,1523,3118,1.0337049862104926,1595,Upregulated,10,5
oxyR,3882,2868,-0.436755094011759,-1014,Downregulated,10,5
argH,2694,6244,1.2127206865156057,3550,Upregulated,10,5
argB,873,2858,1.7109523574663763,1985,Upregulated,10,5
argC,1060,4182,1.9801287971390178,3122,Upregulated,10,5
argE,1712,2751,0.6842734379150636,1039,Upregulated,10,5
ppc,57960,21570,-1.4260314183964753,-36390,Downregulated,10,5
eptC,2362,2543,0.10652249729294909,181,Upregulated,10,5
yijO,313,1320,2.0763033673131974,1007,Upregulated,10,5
frwD,15,370,4.624490864907794,355,Upregulated,10,5
pflC,71,1403,4.3045521741152175,1332,Upregulated,10,5
pflD,215,3525,4.0352146925840575,3310,Upregulated,10,5
frwB,15,292,4.282933963271499,277,Upregulated,10,5
frwC,24,1926,6.3264294871223035,1902,Upregulated,10,5
ptsA,64,5236,6.354249381945241,5172,Upregulated,10,5
fsaB,58,1113,4.262256882214388,1055,Upregulated,10,5
gldA,4373,3057,-0.5165067961942377,-1316,Downregulated,10,5
yijF,41,1245,4.924378022337359,1204,Upregulated,10,5
yijE,232,2071,3.15813084309294,1839,Upregulated,10,5
katG,12988,8272,-0.6508711989711533,-4716,Downregulated,10,5
metF,9695,1797,-2.431650489484213,-7898,Downregulated,10,5
metL,6845,6356,-0.10693141679674281,-489,Downregulated,10,5
metB,3035,2976,-0.028321990035013005,-59,Downregulated,10,5
metJ,1479,629,-1.2334901302197785,-850,Downregulated,10,5
yiiX,291,1184,2.024578022720666,893,Upregulated,10,5
rpmE,2756,248,-3.474163862317416,-2508,Downregulated,10,5
priA,1969,5388,1.4522867395607493,3419,Upregulated,10,5
cytR,1719,2338,0.4437053850535952,619,Upregulated,10,5
ftsN,3531,2793,-0.33826124747965053,-738,Downregulated,10,5
hslV,1400,1369,-0.03230438057442922,-31,Downregulated,10,5
hslU,6710,4604,-0.5434249329553156,-2106,Downregulated,10,5
menA,336,1485,2.143929792909368,1149,Upregulated,10,5
rraA,3976,1609,-1.30515343083884,-2367,Downregulated,10,5
zapB,2193,353,-2.6351657234024133,-1840,Downregulated,10,5
glpF,859,2218,1.3685293290232465,1359,Upregulated,10,5
glpK,3569,5846,0.71192992775703,2277,Upregulated,10,5
glpX,1094,1723,0.6553099634323917,629,Upregulated,10,5
fpr,1073,1284,0.2589951263657812,211,Upregulated,10,5
uspD,2255,405,-2.4771336203707564,-1850,Downregulated,10,5
yiiS,752,232,-1.6966078565500653,-520,Downregulated,10,5
yiiR,154,406,1.3985493764902748,252,Upregulated,10,5
yiiQ,930,718,-0.3732468721723423,-212,Downregulated,10,5
tpiA,23875,4031,-2.566291044846756,-19844,Downregulated,10,5
cdh,263,737,1.4866018198027673,474,Upregulated,10,5
sbp,188,1385,2.8810814092589134,1197,Upregulated,10,5
pfkA,23466,6406,-1.873076238679418,-17060,Downregulated,10,5
fieF,1262,1614,0.3549286682952314,352,Upregulated,10,5
cpxR,3536,1738,-1.0246901925770315,-1798,Downregulated,10,5
cpxA,5040,3645,-0.4675049191729794,-1395,Downregulated,10,5
yiiM,550,882,0.6813470371454985,332,Upregulated,10,5
kdgT,125,1308,3.3873625408359955,1183,Upregulated,10,5
sodA,141,699,2.3095972929766426,558,Upregulated,10,5
rhaT,82,1367,4.059245522987976,1285,Upregulated,10,5
rhaR,66,853,3.6920078119598365,787,Upregulated,10,5
rhaS,56,951,4.085946608802959,895,Upregulated,10,5
rhaB,29,1677,5.853685978436774,1648,Upregulated,10,5
rhaA,52,1817,5.1269029860930235,1765,Upregulated,10,5
rhaD,20,1098,5.778734244117836,1078,Upregulated,10,5
rhaM,6,192,5.0,186,Upregulated,10,5
frvA,4,396,6.6293566200796095,392,Upregulated,10,5
frvB,43,1811,5.39630607624807,1768,Upregulated,10,5
frvX,155,1366,3.139617363015853,1211,Upregulated,10,5
frvR,66,1954,4.887820632609932,1888,Upregulated,10,5
yiiG,38,1003,4.7221783771685955,965,Upregulated,10,5
fdhD,786,1084,0.4637635390952651,298,Upregulated,10,5
fdoG,2541,8206,1.6912827788391802,5665,Upregulated,10,5
fdoH,474,1652,1.8012547225211863,1178,Upregulated,10,5
fdoI,222,822,1.888578717331577,600,Upregulated,10,5
fdhE,1278,1682,0.3962898693081497,404,Upregulated,10,5
yiiF,26,65,1.3219280948873624,39,Upregulated,10,5
yiiE,2,97,5.599912842187128,95,Upregulated,10,5
fabY,2113,1982,-0.09233580474845246,-131,Downregulated,10,5
dtd,706,729,0.046250631055756906,23,Upregulated,10,5
yihY,840,1367,0.7025520099399374,527,Upregulated,10,5
yihX,974,1073,0.13965639867417973,99,Upregulated,10,5
csqR,594,1412,1.2492052524704145,818,Upregulated,10,5
yihV,218,1613,2.887346398378716,1395,Upregulated,10,5
yihU,85,1370,4.010569241710187,1285,Upregulated,10,5
yihT,130,1527,3.5541165337683966,1397,Upregulated,10,5
yihS,193,1833,3.2475340332718052,1640,Upregulated,10,5
yihR,26,1212,5.542734265331859,1186,Upregulated,10,5
yihQ,73,2759,5.240105182473256,2686,Upregulated,10,5
yihP,59,1762,4.900355159558573,1703,Upregulated,10,5
yihO,49,1320,4.751612370130608,1271,Upregulated,10,5
ompL,23,310,3.7525624492172245,287,Upregulated,10,5
yihN,30,1034,5.107129874706416,1004,Upregulated,10,5
yihM,202,784,1.9564983613634135,582,Upregulated,10,5
yihL,123,686,2.479550260833572,563,Upregulated,10,5
bipA,15404,6513,-1.241910896460685,-8891,Downregulated,10,5
glnA,37650,4026,-3.2252307875253132,-33624,Downregulated,10,5
glnL,2170,1207,-0.8462693665768202,-963,Downregulated,10,5
glnG,2812,1939,-0.5362837909657429,-873,Downregulated,10,5
hemN,3168,2152,-0.5578942575229855,-1016,Downregulated,10,5
yihI,1747,591,-1.563649572739227,-1156,Downregulated,10,5
yihA,1405,982,-0.5167752007935955,-423,Downregulated,10,5
spf,1,1,0.0,0,Unchanged,10,5
polA,6942,4346,-0.6756631906473631,-2596,Downregulated,10,5
yihG,94,663,2.81827620843495,569,Upregulated,10,5
yihF,73,909,3.6383119253140896,836,Upregulated,10,5
dsbA,3208,1199,-1.4198424830406966,-2009,Downregulated,10,5
srkA,1460,1400,-0.060541541935050854,-60,Downregulated,10,5
yihD,1200,263,-2.1898997012035784,-937,Downregulated,10,5
mobA,482,536,0.15319985422781088,54,Upregulated,10,5
mobB,199,411,1.046369963138034,212,Upregulated,10,5
hemG,824,961,0.22189209359053216,137,Upregulated,10,5
trkH,2179,2871,0.39788713409127496,692,Upregulated,10,5
yigZ,910,988,0.11864449649861893,78,Upregulated,10,5
pepQ,7192,4804,-0.5821568698088132,-2388,Downregulated,10,5
fadB,83,4238,5.674128441025245,4155,Upregulated,10,5
fadA,113,1989,4.137648598418556,1876,Upregulated,10,5
fre,2208,2326,0.07511092469504942,118,Upregulated,10,5
ubiD,3612,3922,0.11879164271129077,310,Upregulated,10,5
rfaH,413,538,0.38146439113717884,125,Upregulated,10,5
tatC,2151,1476,-0.5433148033626648,-675,Downregulated,10,5
tatB,2415,1601,-0.5930498812068785,-814,Downregulated,10,5
tatA,1202,482,-1.318331844481224,-720,Downregulated,10,5
ubiB,2176,2923,0.4257712725557133,747,Upregulated,10,5
ubiJ,1465,1552,0.08322789287751733,87,Upregulated,10,5
ubiE,2522,1969,-0.3571051644266662,-553,Downregulated,10,5
rmuC,764,2777,1.8618826337830974,2013,Upregulated,10,5
udp,4338,3195,-0.44121412183791714,-1143,Downregulated,10,5
ysgA,990,1785,0.85042364394949,795,Upregulated,10,5
metE,151815,8934,-4.086864277642487,-142881,Downregulated,10,5
metR,1649,1797,0.12399901007247463,148,Upregulated,10,5
bioP,168,1461,3.120423040024738,1293,Upregulated,10,5
yigL,1041,1303,0.3238670152687173,262,Upregulated,10,5
pldB,1659,1719,0.05125565852219775,60,Upregulated,10,5
rhtB,317,927,1.5480864984861236,610,Upregulated,10,5
rhtC,1200,1291,0.1054545948113099,91,Upregulated,10,5
recQ,2236,4352,0.9607583684071493,2116,Upregulated,10,5
pldA,1157,1401,0.2760680913233281,244,Upregulated,10,5
yigI,35,564,4.010268335453827,529,Upregulated,10,5
rarD,35,1308,5.223863808553117,1273,Upregulated,10,5
yigG,19,41,1.1096244911744981,22,Upregulated,10,5
yigF,51,39,-0.38702312310924736,-12,Downregulated,10,5
corA,1730,1625,-0.09033231972090777,-105,Downregulated,10,5
uvrD,4390,4846,0.1425734650286259,456,Upregulated,10,5
yigB,1270,1401,0.14162845877128982,131,Upregulated,10,5
xerC,1449,1497,0.04701662650148736,48,Upregulated,10,5
yigA,1139,1302,0.19296170145752364,163,Upregulated,10,5
dapF,2502,1799,-0.4758866029143375,-703,Downregulated,10,5
cyaY,526,360,-0.5470658929626278,-166,Downregulated,10,5
cyaA,19913,8497,-1.228685117159587,-11416,Downregulated,10,5
hemC,4656,3040,-0.6150197345773359,-1616,Downregulated,10,5
hemD,2000,1464,-0.4500844463780446,-536,Downregulated,10,5
hemX,3758,2514,-0.5799804169995477,-1244,Downregulated,10,5
hemY,3585,2489,-0.5264068886082314,-1096,Downregulated,10,5
aslA,190,1831,3.268560467466389,1641,Upregulated,10,5
aslB,67,1339,4.320851054866538,1272,Upregulated,10,5
yifK,1189,1944,0.7092795038601252,755,Upregulated,10,5
rffM,364,754,1.0506260730699681,390,Upregulated,10,5
wzyE,423,1677,1.9871531204443966,1254,Upregulated,10,5
wzxE,861,1705,0.9856865965146908,844,Upregulated,10,5
wecE,1198,1202,0.004808987922399752,4,Unchanged,10,5
rffC,535,801,0.5822633511202008,266,Upregulated,10,5
rffH,1371,1245,-0.1390828288237825,-126,Downregulated,10,5
rffG,1148,1197,0.06030051026781422,49,Upregulated,10,5
wecC,1649,1850,0.1659338719662074,201,Upregulated,10,5
wecB,1558,1501,-0.05377125644098082,-57,Downregulated,10,5
wzzE,1756,1541,-0.1884259830205729,-215,Downregulated,10,5
rfe,2529,1782,-0.5050697001413166,-747,Downregulated,10,5
rho,16327,6259,-1.3832556462639225,-10068,Downregulated,10,5
trxA,4974,1611,-1.6264500135103377,-3363,Downregulated,10,5
rhlB,9617,4307,-1.1589035953510602,-5310,Downregulated,10,5
gpp,4838,3572,-0.437678688858702,-1266,Downregulated,10,5
rep,2378,3712,0.6424479953819163,1334,Upregulated,10,5
yifN,148,317,1.0988856645104577,169,Upregulated,10,5
ppiC,458,285,-0.68438567904484,-173,Downregulated,10,5
ilvC,6527,7258,0.15315201751530103,731,Upregulated,10,5
ilvY,298,1789,2.5857691515897465,1491,Upregulated,10,5
ilvA,2139,6251,1.5471505200137825,4112,Upregulated,10,5
ilvD,2843,7254,1.3513626462927524,4411,Upregulated,10,5
ilvE,2849,3534,0.31084641822776565,685,Upregulated,10,5
ilvM,57,152,1.4150374992788437,95,Upregulated,10,5
ilvL,5,1,-2.321928094887362,-4,Unchanged,10,5
yifB,119,1868,3.9724609764017185,1749,Upregulated,10,5
maoP,2495,247,-3.336456868639945,-2248,Downregulated,10,5
yieP,1498,800,-0.9049657186840264,-698,Downregulated,10,5
hsrA,532,1203,1.177138491674887,671,Upregulated,10,5
rbsR,261,826,1.6620919748495608,565,Upregulated,10,5
rbsK,955,894,-0.09522590173979334,-61,Downregulated,10,5
rbsB,965,1040,0.10798268087301181,75,Upregulated,10,5
rbsC,372,847,1.1870593482241671,475,Upregulated,10,5
rbsA,354,1341,1.9214879718214766,987,Upregulated,10,5
rbsD,178,276,0.6327910258117713,98,Upregulated,10,5
kup,1100,2089,0.9253089686550864,989,Upregulated,10,5
ravA,3473,2132,-0.7039749726229158,-1341,Downregulated,10,5
viaA,1679,1845,0.13601858601072842,166,Upregulated,10,5
asnA,9999,1668,-2.583664529386741,-8331,Downregulated,10,5
asnC,246,265,0.10733404411132155,19,Upregulated,10,5
mioC,1426,709,-1.008116449204372,-717,Downregulated,10,5
mnmG,5984,3809,-0.6516978873242968,-2175,Downregulated,10,5
rsmG,492,515,0.0659141167313407,23,Upregulated,10,5
atpI,2245,1032,-1.121272474205255,-1213,Downregulated,10,5
atpB,9110,2765,-1.7201715735673437,-6345,Downregulated,10,5
atpE,5496,1686,-1.7047774678760177,-3810,Downregulated,10,5
atpF,13857,5874,-1.2381997812453418,-7983,Downregulated,10,5
atpH,7853,2508,-1.6467065489612145,-5345,Downregulated,10,5
atpA,51387,15621,-1.7179166167467441,-35766,Downregulated,10,5
atpG,16560,4776,-1.7938279311218825,-11784,Downregulated,10,5
atpD,33969,10488,-1.6954791572393584,-23481,Downregulated,10,5
atpC,6559,1406,-2.2218792806442558,-5153,Downregulated,10,5
glmU,7570,2271,-1.7369655941662063,-5299,Downregulated,10,5
glmS,12007,3506,-1.7759778313677734,-8501,Downregulated,10,5
pstS,1038,2492,1.2634976246661211,1454,Upregulated,10,5
pstC,536,1468,1.4535470623854403,932,Upregulated,10,5
pstA,473,1526,1.6898428734951354,1053,Upregulated,10,5
pstB,650,1187,0.8688083117260899,537,Upregulated,10,5
phoU,715,840,0.23244608600037084,125,Upregulated,10,5
bglG,5,424,6.405992359675837,419,Upregulated,10,5
bglF,59,1846,4.967543788283933,1787,Upregulated,10,5
bglB,45,1355,4.9122240399115595,1310,Upregulated,10,5
bglH,41,1037,4.660648174195142,996,Upregulated,10,5
yieL,57,1066,4.225101708594434,1009,Upregulated,10,5
yieK,52,704,3.758991900496205,652,Upregulated,10,5
cbrC,123,406,1.7228214118459364,283,Upregulated,10,5
cbrB,41,199,2.279072615925565,158,Upregulated,10,5
yieH,349,562,0.6873430940112738,213,Upregulated,10,5
adeP,3864,2057,-0.9095533003108393,-1807,Downregulated,10,5
yieF,2244,796,-1.495232340065144,-1448,Downregulated,10,5
yieE,1616,1097,-0.5588636723486019,-519,Downregulated,10,5
yidZ,274,1110,2.0183118782769416,836,Upregulated,10,5
mdtL,89,1617,4.183370532507264,1528,Upregulated,10,5
tnaB,83,1333,4.005421633742048,1250,Upregulated,10,5
tnaA,470,1770,1.9130166984053603,1300,Upregulated,10,5
tnaC,1,1,0.0,0,Unchanged,10,5
mnmE,1854,3190,0.7829151800267009,1336,Upregulated,10,5
yidC,10512,5470,-0.9424244426424108,-5042,Downregulated,10,5
rnpA,2093,1162,-0.8489622428511804,-931,Downregulated,10,5
rpmH,189,26,-2.8618027060799807,-163,Downregulated,10,5
dnaA,5764,6098,0.08126581483500073,334,Upregulated,10,5
dnaN,3270,3696,0.17667412103061272,426,Upregulated,10,5
recF,909,2547,1.4864467600800875,1638,Upregulated,10,5
gyrB,7976,8286,0.05501041058101118,310,Upregulated,10,5
yidB,364,505,0.4723449374404608,141,Upregulated,10,5
yidA,1879,1853,-0.020102185392789726,-26,Downregulated,10,5
yidX,161,616,1.9358696625802845,455,Upregulated,10,5
dgoK,141,1492,3.4034804678564443,1351,Upregulated,10,5
dgoT,128,2796,4.449148645375437,2668,Upregulated,10,5
cbrA,60,1845,4.94251450533924,1785,Upregulated,10,5
yidR,743,2342,1.656306959962619,1599,Upregulated,10,5
yidQ,507,566,0.15881630582854173,59,Upregulated,10,5
ibpA,1901,1915,0.010585860163767334,14,Upregulated,10,5
ibpB,1602,1879,0.2300909190113455,277,Upregulated,10,5
yidE,1562,3542,1.181169758609935,1980,Upregulated,10,5
yidP,33,1110,5.0719498418790145,1077,Upregulated,10,5
glvC,49,3064,5.966490737809749,3015,Upregulated,10,5
yidL,84,792,3.237039197300849,708,Upregulated,10,5
yidK,33,3442,6.70463726268175,3409,Upregulated,10,5
yidJ,85,2930,5.1072940131719085,2845,Upregulated,10,5
yidI,157,881,2.4883774600287865,724,Upregulated,10,5
yidH,104,569,2.4518451241654895,465,Upregulated,10,5
yidG,69,634,3.199814573361238,565,Upregulated,10,5
yidF,118,977,3.049571702606544,859,Upregulated,10,5
emrD,362,2620,2.8555052093416076,2258,Upregulated,10,5
ivbL,2,1,-1.0,-1,Unchanged,10,5
ilvB,2579,4890,0.923022692050382,2311,Upregulated,10,5
ilvN,261,440,0.7534537169547751,179,Upregulated,10,5
uhpA,1530,1855,0.2778875339281514,325,Upregulated,10,5
uhpB,725,3971,2.4534494606221715,3246,Upregulated,10,5
uhpC,293,2916,3.3150181499046893,2623,Upregulated,10,5
uhpT,121,2792,4.528219988935057,2671,Upregulated,10,5
adeD,284,3768,3.729836130108101,3484,Upregulated,10,5
adeQ,29,2189,6.238075244053374,2160,Upregulated,10,5
yicN,133,757,2.508867054484542,624,Upregulated,10,5
nepI,74,2570,5.1180992784522905,2496,Upregulated,10,5
nlpA,741,1189,0.682203267439822,448,Upregulated,10,5
yicL,776,1500,0.9508339431961156,724,Upregulated,10,5
setC,33,1329,5.3317312699177215,1296,Upregulated,10,5
yicJ,417,2121,2.3466253320858916,1704,Upregulated,10,5
yicI,1128,3650,1.6941293962559485,2522,Upregulated,10,5
yicH,2902,3471,0.25830384576190163,569,Upregulated,10,5
xanP,2237,4150,0.8915460800625307,1913,Upregulated,10,5
gltS,1632,2468,0.5967013371779223,836,Upregulated,10,5
recG,2589,3699,0.514740335223884,1110,Upregulated,10,5
trmH,1288,1093,-0.23683919244271237,-195,Downregulated,10,5
spoT,8066,4697,-0.7801138121480885,-3369,Downregulated,10,5
rpoZ,1832,499,-1.8763077827596835,-1333,Downregulated,10,5
gmk,1941,875,-1.1494451959939727,-1066,Downregulated,10,5
ligB,164,2345,3.837820202784655,2181,Upregulated,10,5
yicG,59,579,3.294776488627395,520,Upregulated,10,5
dinD,187,612,1.7104933828050153,425,Upregulated,10,5
yicC,2695,1634,-0.7218772894941843,-1061,Downregulated,10,5
rph,1482,1167,-0.3447408865984856,-315,Downregulated,10,5
pyrE,218,712,1.7075491061894714,494,Upregulated,10,5
slmA,1552,783,-0.9870443448960871,-769,Downregulated,10,5
dut,2074,802,-1.3707417523583054,-1272,Downregulated,10,5
dfp,1410,2259,0.6799891081069284,849,Upregulated,10,5
yicR,125,535,2.097610796626422,410,Upregulated,10,5
rpmB,4413,578,-2.9326183494753075,-3835,Downregulated,10,5
rpmG,394,33,-3.5776577000979226,-361,Downregulated,10,5
mutM,346,964,1.4782611085932371,618,Upregulated,10,5
coaD,486,455,-0.09508976851972227,-31,Downregulated,10,5
waaA,1954,1881,-0.0549306184451902,-73,Downregulated,10,5
waaQ,1321,1036,-0.3506064635602737,-285,Downregulated,10,5
waaG,1122,1171,0.06166839989242229,49,Upregulated,10,5
waaP,522,600,0.2009126939259963,78,Upregulated,10,5
waaS,596,124,-2.2649722100752863,-472,Downregulated,10,5
waaB,819,655,-0.3223685452161959,-164,Downregulated,10,5
waaO,758,478,-0.6651872301903431,-280,Downregulated,10,5
waaJ,573,241,-1.2495019925269433,-332,Downregulated,10,5
waaY,324,199,-0.703225382340976,-125,Downregulated,10,5
waaZ,462,191,-1.2743202133803089,-271,Downregulated,10,5
waaU,601,230,-1.3857311297668102,-371,Downregulated,10,5
waaL,965,267,-1.8536892004678887,-698,Downregulated,10,5
waaC,1000,1429,0.5150059164337295,429,Upregulated,10,5
waaF,2318,1918,-0.273277845988341,-400,Downregulated,10,5
rfaD,5066,2415,-1.0688238879893655,-2651,Downregulated,10,5
htrL,436,534,0.29251160691062766,98,Upregulated,10,5
kbl,2767,2368,-0.2246535629810049,-399,Downregulated,10,5
tdh,2485,1837,-0.43589422533829897,-648,Downregulated,10,5
waaH,48,1252,4.705056346211462,1204,Upregulated,10,5
yibQ,874,1777,1.02373849652808,903,Upregulated,10,5
envC,2596,2798,0.10810557916561489,202,Upregulated,10,5
gpmM,25148,9653,-1.3813943842068739,-15495,Downregulated,10,5
yibN,1884,721,-1.3857278003719606,-1163,Downregulated,10,5
grxC,501,377,-0.4102460799265441,-124,Downregulated,10,5
secB,4683,1272,-1.8803343674147095,-3411,Downregulated,10,5
gpsA,6796,3582,-0.9239205151982594,-3214,Downregulated,10,5
cysE,2197,2354,0.09957945061516768,157,Upregulated,10,5
trmL,404,793,0.9729655729521837,389,Upregulated,10,5
lldD,149,2275,3.9324823095112595,2126,Upregulated,10,5
lldR,36,1328,5.205114429904612,1292,Upregulated,10,5
lldP,71,2903,5.35358173712198,2832,Upregulated,10,5
yibL,587,565,-0.05510963580750217,-22,Downregulated,10,5
mtlR,485,1057,1.123918724308193,572,Upregulated,10,5
mtlD,2605,3431,0.39734575339178413,826,Upregulated,10,5
mtlA,2167,4386,1.0172066585799198,2219,Upregulated,10,5
yibI,10,368,5.20163386116965,358,Upregulated,10,5
yibH,98,2041,4.380350622917511,1943,Upregulated,10,5
yibG,16,49,1.6147098441152081,33,Upregulated,10,5
yibJ,130,1063,3.03155806850265,933,Upregulated,10,5
yibA,450,424,-0.08586073665383794,-26,Downregulated,10,5
rhsA,366,10019,4.774751061072336,9653,Upregulated,10,5
yibF,208,1199,2.5271762252731316,991,Upregulated,10,5
selA,1966,3509,0.835796626061586,1543,Upregulated,10,5
selB,3610,4915,0.4451925794534096,1305,Upregulated,10,5
yiaY,28,1916,6.096526923678576,1888,Upregulated,10,5
aldB,438,3256,2.8940979246650738,2818,Upregulated,10,5
yiaW,9,268,4.89616418901546,259,Upregulated,10,5
yiaV,35,2012,5.845131572860561,1977,Upregulated,10,5
yiaU,248,1570,2.6623525333921143,1322,Upregulated,10,5
yiaT,41,1021,4.638215146259718,980,Upregulated,10,5
sgbE,76,1240,4.028196891830652,1164,Upregulated,10,5
sgbU,34,1839,5.7572429231615985,1805,Upregulated,10,5
sgbH,30,1274,5.408258966647782,1244,Upregulated,10,5
lyxK,57,3738,6.035160839580416,3681,Upregulated,10,5
yiaO,19,1897,6.64157644996789,1878,Upregulated,10,5
yiaN,5,1823,8.510170751151772,1818,Upregulated,10,5
yiaM,4,369,6.527477006060396,365,Upregulated,10,5
yiaL,4,501,6.968666793195208,497,Upregulated,10,5
yiaK,31,1747,5.816467582529884,1716,Upregulated,10,5
plaR,1332,1498,0.1694435413874888,166,Upregulated,10,5
ysaA,128,592,2.2094533656289497,464,Upregulated,10,5
avtA,4799,3973,-0.27250501962809504,-826,Downregulated,10,5
malS,638,3422,2.423211430724544,2784,Upregulated,10,5
bax,3282,3500,0.09277968320597837,218,Upregulated,10,5
xylR,869,1948,1.1645655952679421,1079,Upregulated,10,5
xylH,947,2923,1.6260134983376677,1976,Upregulated,10,5
xylG,1210,3135,1.3734583955274444,1925,Upregulated,10,5
xylF,2117,3345,0.659984941521234,1228,Upregulated,10,5
xylA,13390,26193,0.9680253467260126,12803,Upregulated,10,5
xylB,2209,6519,1.5612572565471643,4310,Upregulated,10,5
yiaB,29,203,2.807354922057604,174,Upregulated,10,5
yiaA,38,225,2.5658536777734517,187,Upregulated,10,5
wecH,152,1242,3.0305219447768956,1090,Upregulated,10,5
glyQ,3658,2820,-0.37535991246256056,-838,Downregulated,10,5
glyS,11607,7367,-0.6558459868776659,-4240,Downregulated,10,5
insK,34,542,3.994686200103532,508,Upregulated,10,5
insJ,54,442,3.033015057227963,388,Upregulated,10,5
cspA,215,104,-1.0477531314483681,-111,Downregulated,10,5
yiaG,504,202,-1.3190684407481217,-302,Downregulated,10,5
yiaF,4325,1494,-1.5335199846222123,-2831,Downregulated,10,5
ghrB,4650,2724,-0.7715040128706849,-1926,Downregulated,10,5
yiaD,712,957,0.4266416835196278,245,Upregulated,10,5
bisC,2467,4695,0.9283674422410138,2228,Upregulated,10,5
yiaC,184,610,1.7291034763932356,426,Upregulated,10,5
tag,423,891,1.074767768401972,468,Upregulated,10,5
yhjY,306,945,1.6267826764157833,639,Upregulated,10,5
yhjX,239,2161,3.1766165488787586,1922,Upregulated,10,5
eptB,570,3013,2.4021668485423593,2443,Upregulated,10,5
dppA,43323,15745,-1.4602393916424727,-27578,Downregulated,10,5
dppB,4233,3361,-0.33278994601041856,-872,Downregulated,10,5
dppC,3717,2966,-0.32562009040712725,-751,Downregulated,10,5
dppD,4792,3524,-0.44341398386837216,-1268,Downregulated,10,5
dppF,5587,3683,-0.6011924230542905,-1904,Downregulated,10,5
yhjV,149,2135,3.8408518340456914,1986,Upregulated,10,5
bcsG,551,3352,2.604897925128194,2801,Upregulated,10,5
bcsF,22,87,1.983511877211431,65,Upregulated,10,5
bcsE,1412,3250,1.2026996295319987,1838,Upregulated,10,5
yhjR,8,50,2.643856189774725,42,Upregulated,10,5
bcsQ,98,1274,3.700439718141092,1176,Upregulated,10,5
bcsA,220,6265,4.831739080684563,6045,Upregulated,10,5
bcsB,286,5746,4.328470940754134,5460,Upregulated,10,5
bcsZ,122,2522,4.369615222765334,2400,Upregulated,10,5
bcsC,901,9157,3.3452760114038442,8256,Upregulated,10,5
pdeK,1176,4903,2.0597767014493207,3727,Upregulated,10,5
dctA,854,3817,2.1601312115950675,2963,Upregulated,10,5
yhjJ,1582,3047,0.9456399002136937,1465,Upregulated,10,5
kdgK,2716,2589,-0.06908851434462052,-127,Downregulated,10,5
pdeH,154,1466,3.2508828474389104,1312,Upregulated,10,5
yhjG,561,4057,2.85434062659748,3496,Upregulated,10,5
yhjE,679,3384,2.3172460888752178,2705,Upregulated,10,5
yhjD,1063,1813,0.7702373282130534,750,Upregulated,10,5
rcdB,615,1504,1.2901462514510351,889,Upregulated,10,5
yhjB,72,636,3.142957953842043,564,Upregulated,10,5
treF,1655,3234,0.9664884617790815,1579,Upregulated,10,5
ccp,626,2106,1.7502708740930986,1480,Upregulated,10,5
gadA,84374,2314,-5.188337728783573,-82060,Downregulated,10,5
gadX,7380,635,-3.5387923192882305,-6745,Downregulated,10,5
gadW,1920,597,-1.6853034743437136,-1323,Downregulated,10,5
mdtF,23634,5264,-2.1666324285999576,-18370,Downregulated,10,5
mdtE,10863,1846,-2.5569481245515595,-9017,Downregulated,10,5
gadE,8655,52,-7.378878386112909,-8603,Downregulated,10,5
hdeD,19860,681,-4.866067014403665,-19179,Downregulated,10,5
hdeA,47430,300,-7.304693557471008,-47130,Downregulated,10,5
hdeB,21226,176,-6.914113284587107,-21050,Downregulated,10,5
yhiD,1758,442,-1.9918167957519726,-1316,Downregulated,10,5
dctR,778,294,-1.4039540001498274,-484,Downregulated,10,5
slp,18758,480,-5.288327798153594,-18278,Downregulated,10,5
insH11,2861,6302,1.1392902566943568,3441,Upregulated,10,5
yhiS,30,1163,5.276744785864699,1133,Upregulated,10,5
arsC,73,546,2.9029325820398353,473,Upregulated,10,5
arsB,114,2219,4.28280393803227,2105,Upregulated,10,5
arsR,52,495,3.25084499682588,443,Upregulated,10,5
gor,3774,2762,-0.4503811033423945,-1012,Downregulated,10,5
rlmJ,707,1402,0.9877042292012244,695,Upregulated,10,5
prlC,5483,5545,0.01622198675227321,62,Upregulated,10,5
rsmJ,413,1425,1.786748232520021,1012,Upregulated,10,5
dtpB,380,2238,2.5581387126454462,1858,Upregulated,10,5
uspA,13688,2505,-2.4500291564068424,-11183,Downregulated,10,5
uspB,357,352,-0.020348645391802367,-5,Unchanged,10,5
pitA,5346,3507,-0.6082224069902658,-1839,Downregulated,10,5
yhiN,643,2561,1.993816610269521,1918,Upregulated,10,5
yhiM,3659,1478,-1.3078031461929363,-2181,Downregulated,10,5
yhiJ,177,922,2.3810173903463405,745,Upregulated,10,5
yhiI,3338,4509,0.433823555274922,1171,Upregulated,10,5
rbbA,5282,9113,0.7868417659846224,3831,Upregulated,10,5
yhhJ,1056,3283,1.6364049152145272,2227,Upregulated,10,5
yhhI,45,1287,4.837943241891027,1242,Upregulated,10,5
yhhH,12,43,1.8413022539809418,31,Upregulated,10,5
rhsB,323,9201,4.832184597294251,8878,Upregulated,10,5
nikR,249,865,1.7965543904560062,616,Upregulated,10,5
nikE,172,2038,3.566673581463716,1866,Upregulated,10,5
nikD,159,1933,3.6037429669268803,1774,Upregulated,10,5
nikC,118,2243,4.248570855724431,2125,Upregulated,10,5
nikB,152,2281,3.907523217868552,2129,Upregulated,10,5
nikA,585,4397,2.9100110027418804,3812,Upregulated,10,5
acpT,303,1152,1.9267510179693614,849,Upregulated,10,5
yhhT,245,2363,3.269765974971276,2118,Upregulated,10,5
yhhS,753,3765,2.321928094887362,3012,Upregulated,10,5
dcrB,2236,1765,-0.3412520046846474,-471,Downregulated,10,5
yhhQ,321,1525,2.248164040215308,1204,Upregulated,10,5
tusA,421,386,-0.12521938579831574,-35,Downregulated,10,5
zntA,3321,8642,1.3797475080870254,5321,Upregulated,10,5
yhhN,1888,1916,0.021238796374339088,28,Upregulated,10,5
yhhM,339,570,0.7496766459157601,231,Upregulated,10,5
yhhL,50,302,2.594548549550354,252,Upregulated,10,5
rsmD,412,1156,1.4884251553174606,744,Upregulated,10,5
ftsY,2698,5500,1.0275412703511169,2802,Upregulated,10,5
ftsE,1354,2543,0.9093037231151095,1189,Upregulated,10,5
ftsX,2279,3607,0.6623984985222731,1328,Upregulated,10,5
rpoH,8677,7277,-0.2538525184568444,-1400,Downregulated,10,5
livJ,931,5040,2.436570660828485,4109,Upregulated,10,5
panZ,261,666,1.3514723705013778,405,Upregulated,10,5
livK,1281,3323,1.375215817350385,2042,Upregulated,10,5
livH,460,2082,2.178264302355042,1622,Upregulated,10,5
livM,750,3537,2.2375637183176758,2787,Upregulated,10,5
livG,384,1971,2.3597495603223297,1587,Upregulated,10,5
livF,367,1917,2.3849983688249377,1550,Upregulated,10,5
ugpB,66,3358,5.668992395578576,3292,Upregulated,10,5
ugpA,14,1800,7.006426269159433,1786,Upregulated,10,5
ugpE,16,1914,6.902375114486025,1898,Upregulated,10,5
ugpC,224,3157,3.816983623255381,2933,Upregulated,10,5
ugpQ,405,1696,2.0661423567912123,1291,Upregulated,10,5
yhhA,691,681,-0.02103091237618736,-10,Downregulated,10,5
ggt,726,4134,2.5094969354296968,3408,Upregulated,10,5
yrhB,29,196,2.756728848987636,167,Upregulated,10,5
insB6,27,582,4.429987840744816,555,Upregulated,10,5
insA6,19,138,2.8605969433345835,119,Upregulated,10,5
yrhA,64,1403,4.454299293619899,1339,Upregulated,10,5
yhhZ,7,378,5.754887502163468,371,Upregulated,10,5
yhhY,429,721,0.7490216117412769,292,Upregulated,10,5
yhhX,2696,2337,-0.20616276239903314,-359,Downregulated,10,5
yhhW,680,1364,1.0042369928864707,684,Upregulated,10,5
gntR,1344,2156,0.6818240399737453,812,Upregulated,10,5
gntK,215,998,2.2147031557478,783,Upregulated,10,5
yhgN,306,1086,1.8274205451117096,780,Upregulated,10,5
asd,23151,4703,-2.299421274271237,-18448,Downregulated,10,5
glgB,28851,8488,-1.7651247633993101,-20363,Downregulated,10,5
glgX,13428,6106,-1.13694494749077,-7322,Downregulated,10,5
glgC,8727,4002,-1.1247646299157215,-4725,Downregulated,10,5
glgA,10568,4664,-1.1800626780463312,-5904,Downregulated,10,5
glgP,16457,6670,-1.3029426996386781,-9787,Downregulated,10,5
yzgL,47,115,1.2909011992667379,68,Upregulated,10,5
glpD,30707,17890,-0.7794141839751701,-12817,Downregulated,10,5
glpE,324,612,0.9175378398080271,288,Upregulated,10,5
glpG,1232,2371,0.9444934067871066,1139,Upregulated,10,5
glpR,657,2284,1.7975973750405132,1627,Upregulated,10,5
rtcR,143,4617,5.0128686802709765,4474,Upregulated,10,5
rtcB,370,3291,3.152928850608037,2921,Upregulated,10,5
malT,10083,14588,0.5328571563069545,4505,Upregulated,10,5
malP,5521,6437,0.22145886771777157,916,Upregulated,10,5
malQ,4684,5326,0.18531135270939908,642,Upregulated,10,5
gntT,1015,3421,1.7529383766953612,2406,Upregulated,10,5
nfuA,2759,1924,-0.520036657583231,-835,Downregulated,10,5
yhgH,629,1596,1.3433287293430567,967,Upregulated,10,5
bioH,668,1764,1.4009305530834684,1096,Upregulated,10,5
rpnA,177,1433,3.0172173441791483,1256,Upregulated,10,5
feoC,56,215,1.9408379275318561,159,Upregulated,10,5
feoB,2414,5919,1.2939277806896936,3505,Upregulated,10,5
feoA,72,142,0.9798221180623697,70,Upregulated,10,5
yhgF,6540,7440,0.18601198560994894,900,Upregulated,10,5
greB,449,909,1.01756484945296,460,Upregulated,10,5
ompR,1923,2016,0.06813687616001932,93,Upregulated,10,5
envZ,1475,3630,1.299254593746547,2155,Upregulated,10,5
pck,8165,6843,-0.25482393841576373,-1322,Downregulated,10,5
yhgE,711,2977,2.065937756618621,2266,Upregulated,10,5
hslO,1596,2535,0.667525095668357,939,Upregulated,10,5
hslR,435,945,1.1192989283723445,510,Upregulated,10,5
yrfG,707,1153,0.705610392842373,446,Upregulated,10,5
igaA,1772,5675,1.6792417885106214,3903,Upregulated,10,5
nudE,580,1060,0.8699394594356271,480,Upregulated,10,5
mrcA,1704,6041,1.8258620510107209,4337,Upregulated,10,5
hofM,105,1517,3.852759852580911,1412,Upregulated,10,5
hofN,39,875,4.487736987857443,836,Upregulated,10,5
hofO,34,698,4.359620384959313,664,Upregulated,10,5
hofP,36,553,3.9412106687923947,517,Upregulated,10,5
hofQ,161,2253,3.806714720120811,2092,Upregulated,10,5
aroK,3467,1619,-1.0985848509002676,-1848,Downregulated,10,5
aroB,5938,3294,-0.8501365382603008,-2644,Downregulated,10,5
damX,6548,4044,-0.6952713245711387,-2504,Downregulated,10,5
dam,905,1159,0.3568908690359041,254,Upregulated,10,5
rpe,2973,1410,-1.0762243006214884,-1563,Downregulated,10,5
gph,2327,1466,-0.6665861072715368,-861,Downregulated,10,5
trpS,5478,2391,-1.1960351359937502,-3087,Downregulated,10,5
yhfZ,213,1677,2.976957353338508,1464,Upregulated,10,5
yhfY,42,335,2.9956998625663744,293,Upregulated,10,5
yhfX,59,2288,5.277228287416548,2229,Upregulated,10,5
yhfW,50,2553,5.674121632632394,2503,Upregulated,10,5
php,52,1707,5.036807624886646,1655,Upregulated,10,5
yhfU,23,377,4.034858757211651,354,Upregulated,10,5
yhfT,140,3035,4.438197784198078,2895,Upregulated,10,5
yhfS,110,2446,4.474848975002727,2336,Upregulated,10,5
frlR,517,1397,1.4340958350945283,880,Upregulated,10,5
frlD,136,1943,3.8366073443350053,1807,Upregulated,10,5
frlB,61,1723,4.819969648662062,1662,Upregulated,10,5
frlA,19,2478,7.027032958697016,2459,Upregulated,10,5
yhfL,5,10,1.0,5,Unchanged,10,5
cysG,1554,2510,0.6917008604304243,956,Upregulated,10,5
nirC,657,1034,0.6542709099926051,377,Upregulated,10,5
nirD,656,394,-0.7355001851617075,-262,Downregulated,10,5
nirB,10239,5867,-0.8033799231486566,-4372,Downregulated,10,5
tsgA,224,1621,2.8553134534599374,1397,Upregulated,10,5
ppiA,1448,1023,-0.5012554573378766,-425,Downregulated,10,5
yhfG,38,34,-0.1604646721932461,-4,Unchanged,10,5
fic,842,660,-0.3513542088205804,-182,Downregulated,10,5
pabA,146,719,2.300023401559281,573,Upregulated,10,5
argD,1848,6525,1.8200131449285517,4677,Upregulated,10,5
yhfK,1403,2709,0.9492453845821154,1306,Upregulated,10,5
crp,6168,1746,-1.8207492062855943,-4422,Downregulated,10,5
yhfA,1356,527,-1.3634823114991292,-829,Downregulated,10,5
prkB,1319,1280,-0.043300754364182376,-39,Downregulated,10,5
yheU,93,68,-0.45169596985769195,-25,Downregulated,10,5
yheT,1403,1497,0.0935592124385177,94,Upregulated,10,5
yheS,3561,3585,0.009690683226204215,24,Upregulated,10,5
kefG,71,510,2.844606317354176,439,Upregulated,10,5
kefB,229,2317,3.338838540767878,2088,Upregulated,10,5
slyD,10267,2496,-2.040324850873917,-7771,Downregulated,10,5
slyX,499,96,-2.3779335046161045,-403,Downregulated,10,5
fkpA,5129,1554,-1.7226910675696074,-3575,Downregulated,10,5
yheO,2832,1316,-1.1056617763477559,-1516,Downregulated,10,5
tusD,1063,721,-0.5600704322902822,-342,Downregulated,10,5
tusC,439,369,-0.250600123474962,-70,Downregulated,10,5
tusB,318,223,-0.5119830553640508,-95,Downregulated,10,5
rpsL,12880,2267,-2.5062762972611936,-10613,Downregulated,10,5
rpsG,40203,8973,-2.16364084490506,-31230,Downregulated,10,5
fusA,259693,76012,-1.772508027192603,-183681,Downregulated,10,5
tufA,160805,46439,-1.79190345454288,-114366,Downregulated,10,5
chiA,831,2716,1.7085630974743873,1885,Upregulated,10,5
bfd,22,34,0.6280312226130421,12,Upregulated,10,5
bfr,3471,318,-3.4482526945442906,-3153,Downregulated,10,5
gspO,53,459,3.1144298888506086,406,Upregulated,10,5
gspM,31,274,3.1438357725736514,243,Upregulated,10,5
gspL,78,964,3.6274871173677132,886,Upregulated,10,5
gspK,37,703,4.247927513443585,666,Upregulated,10,5
gspJ,16,389,4.603626344986192,373,Upregulated,10,5
gspI,9,213,4.564784618783526,204,Upregulated,10,5
gspH,16,345,4.430452551665532,329,Upregulated,10,5
gspG,8,222,4.794415866350106,214,Upregulated,10,5
gspF,51,1045,4.356861884996749,994,Upregulated,10,5
gspE,44,1138,4.692853223669284,1094,Upregulated,10,5
gspD,161,1577,3.2920500666758934,1416,Upregulated,10,5
gspC,25,343,3.7782085763980877,318,Upregulated,10,5
gspA,50,1087,4.442280035252584,1037,Upregulated,10,5
gspB,54,179,1.728928275100788,125,Upregulated,10,5
rpsJ,10057,3779,-1.4121235901216238,-6278,Downregulated,10,5
rplC,42078,15345,-1.455297488040335,-26733,Downregulated,10,5
rplD,31887,10386,-1.618328241472831,-21501,Downregulated,10,5
rplW,8356,3575,-1.224869250513994,-4781,Downregulated,10,5
rplB,39272,12341,-1.6700417699882626,-26931,Downregulated,10,5
rpsS,11292,3428,-1.7198620193371932,-7864,Downregulated,10,5
rplV,5558,1516,-1.8742960810294704,-4042,Downregulated,10,5
rpsC,44308,14383,-1.6232025832147647,-29925,Downregulated,10,5
rplP,22826,6892,-1.7276834589420342,-15934,Downregulated,10,5
rpmC,3854,1490,-1.3710442409461971,-2364,Downregulated,10,5
rpsQ,9771,1997,-2.2906718876730867,-7774,Downregulated,10,5
rplN,31865,7634,-2.061461569083948,-24231,Downregulated,10,5
rplX,12642,2961,-2.0940683243609084,-9681,Downregulated,10,5
rplE,55153,19803,-1.4777203582025369,-35350,Downregulated,10,5
rpsN,16351,6471,-1.337318288921691,-9880,Downregulated,10,5
rpsH,20946,9110,-1.2011518035844966,-11836,Downregulated,10,5
rplF,39469,15343,-1.3631393680768504,-24126,Downregulated,10,5
rplR,16562,6565,-1.3350099846171433,-9997,Downregulated,10,5
rpsE,31390,10710,-1.5513465488318592,-20680,Downregulated,10,5
rpmD,1969,803,-1.2939912183842393,-1166,Downregulated,10,5
rplO,38072,15326,-1.3127491487962615,-22746,Downregulated,10,5
secY,81723,25549,-1.677475340973498,-56174,Downregulated,10,5
rpmJ,14,8,-0.8073549220576042,-6,Unchanged,10,5
rpsM,22470,6025,-1.8989669780625833,-16445,Downregulated,10,5
rpsK,20635,6328,-1.705271933421605,-14307,Downregulated,10,5
rpsD,39080,11165,-1.8074472161459116,-27915,Downregulated,10,5
rpoA,81897,23791,-1.783394691518744,-58106,Downregulated,10,5
rplQ,10483,1884,-2.476180772934456,-8599,Downregulated,10,5
yhdN,514,336,-0.6133071264151178,-178,Downregulated,10,5
zntR,422,374,-0.1742047288195484,-48,Downregulated,10,5
mscL,1527,334,-2.192780054322799,-1193,Downregulated,10,5
trkA,1754,1350,-0.3776893405065398,-404,Downregulated,10,5
rsmB,1846,1650,-0.16193652851259613,-196,Downregulated,10,5
fmt,2838,1732,-0.7124356593338266,-1106,Downregulated,10,5
def,1586,634,-1.322838025564571,-952,Downregulated,10,5
smg,2402,915,-1.3923925025342294,-1487,Downregulated,10,5
yrdD,1185,647,-0.8730494417931141,-538,Downregulated,10,5
tsaC,588,550,-0.09638453642434239,-38,Downregulated,10,5
aroE,882,771,-0.19404779564248634,-111,Downregulated,10,5
yrdB,113,102,-0.1477536204436922,-11,Downregulated,10,5
yrdA,1919,639,-1.586466875248386,-1280,Downregulated,10,5
yhdZ,82,517,2.6564684656968507,435,Upregulated,10,5
yhdY,42,886,4.398845465776258,844,Upregulated,10,5
yhdX,40,807,4.334496768390418,767,Upregulated,10,5
yhdW,87,801,3.202714936559982,714,Upregulated,10,5
yhdV,77,61,-0.33604920313201503,-16,Downregulated,10,5
acrF,280,3050,3.4453105103926442,2770,Upregulated,10,5
acrE,8,1076,7.071462362556624,1068,Upregulated,10,5
envR,6,359,5.902877533101895,353,Upregulated,10,5
yhdU,6,13,1.1154772174199359,7,Unchanged,10,5
yhdJ,87,856,3.2985234905524186,769,Upregulated,10,5
fis,2042,284,-2.8460200313731194,-1758,Downregulated,10,5
dusB,5968,1842,-1.6959744741639022,-4126,Downregulated,10,5
prmA,614,1175,0.9363501960821826,561,Upregulated,10,5
panF,300,1753,2.5467915902636573,1453,Upregulated,10,5
yhdT,35,112,1.6780719051126378,77,Upregulated,10,5
accC,15629,4037,-1.9528699805079672,-11592,Downregulated,10,5
accB,4322,1068,-2.0167874251719535,-3254,Downregulated,10,5
yhdH,1520,1361,-0.1594042568269532,-159,Downregulated,10,5
csrD,2543,2901,0.19001883350789106,358,Upregulated,10,5
mreB,10632,4009,-1.4070986871254039,-6623,Downregulated,10,5
mreC,2373,1876,-0.33905227267857135,-497,Downregulated,10,5
mreD,621,560,-0.14916644127551495,-61,Downregulated,10,5
yhdE,929,892,-0.05863488646234817,-37,Downregulated,10,5
rng,2994,2528,-0.2440777578813138,-466,Downregulated,10,5
tldD,3850,2725,-0.4986022159179751,-1125,Downregulated,10,5
aaeR,571,1150,1.0100712104688947,579,Upregulated,10,5
aaeX,7,59,3.0752881273042374,52,Upregulated,10,5
aaeA,88,979,3.4757334309663976,891,Upregulated,10,5
aaeB,184,2827,3.9414942117741627,2643,Upregulated,10,5
yhcO,68,108,0.667424660913129,40,Upregulated,10,5
yhcN,39,171,2.1324502960236495,132,Upregulated,10,5
argR,2895,1486,-0.9621292323380028,-1409,Downregulated,10,5
mdh,52912,3353,-3.9800705623973305,-49559,Downregulated,10,5
degS,984,1573,0.6767884500764468,589,Upregulated,10,5
degQ,1658,2030,0.2920357205767883,372,Upregulated,10,5
yhcB,3230,1259,-1.3592558818622706,-1971,Downregulated,10,5
zapE,1290,1824,0.4997346638541252,534,Upregulated,10,5
rplM,14631,2459,-2.5728847381609414,-12172,Downregulated,10,5
rpsI,24032,3493,-2.7824181701194073,-20539,Downregulated,10,5
sspA,7161,3029,-1.2413194890075603,-4132,Downregulated,10,5
sspB,3922,1919,-1.0312348239967688,-2003,Downregulated,10,5
dcuD,47,1991,5.404688654042865,1944,Upregulated,10,5
nanR,1477,1729,0.2272680428774925,252,Upregulated,10,5
nanA,112,1531,3.7729036454421836,1419,Upregulated,10,5
nanT,149,3044,4.3525841230413835,2895,Upregulated,10,5
nanE,107,1248,3.5439352324611013,1141,Upregulated,10,5
nanK,343,1588,2.2109304309701456,1245,Upregulated,10,5
yhcH,175,441,1.3334237337251917,266,Upregulated,10,5
yhcG,71,1640,4.529732980000764,1569,Upregulated,10,5
yhcF,131,553,2.0777126686972567,422,Upregulated,10,5
insH10,4199,3723,-0.17358017198350417,-476,Downregulated,10,5
yhcD,160,2481,3.9547779250050685,2321,Upregulated,10,5
yhcA,21,409,4.2836396101629886,388,Upregulated,10,5
gltF,128,612,2.2573878426926517,484,Upregulated,10,5
gltD,13762,7198,-0.9350221414734571,-6564,Downregulated,10,5
gltB,43846,23742,-0.885003762782498,-20104,Downregulated,10,5
yhcC,678,1574,1.2150783623711425,896,Upregulated,10,5
arcB,2328,4031,0.7920467249427957,1703,Upregulated,10,5
elbB,1816,1414,-0.36098208248151614,-402,Downregulated,10,5
mtgA,490,1060,1.113210610447991,570,Upregulated,10,5
yrbL,13706,5128,-1.418339425042558,-8578,Downregulated,10,5
npr,157,161,0.03629612922298996,4,Unchanged,10,5
rapZ,4030,2115,-0.9301221754080176,-1915,Downregulated,10,5
ptsN,2341,1144,-1.0330378823336233,-1197,Downregulated,10,5
hpf,2711,892,-1.6037094979174071,-1819,Downregulated,10,5
rpoN,7574,5098,-0.5711240478622175,-2476,Downregulated,10,5
lptB,2771,1705,-0.7006349715698823,-1066,Downregulated,10,5
lptA,2797,1472,-0.9261025824191789,-1325,Downregulated,10,5
lptC,1520,1064,-0.5145731728297583,-456,Downregulated,10,5
kdsC,1998,1443,-0.46948528330122025,-555,Downregulated,10,5
kdsD,2932,2230,-0.39484139332614476,-702,Downregulated,10,5
yrbG,1016,1370,0.43127549107572327,354,Upregulated,10,5
mlaF,2567,2111,-0.2821567172282624,-456,Downregulated,10,5
mlaE,2524,2167,-0.22001275688887545,-357,Downregulated,10,5
mlaD,1460,1055,-0.4687253701728321,-405,Downregulated,10,5
mlaC,3345,1922,-0.7993978747550728,-1423,Downregulated,10,5
mlaB,737,497,-0.5684187675327834,-240,Downregulated,10,5
ibaG,791,237,-1.7387906355745328,-554,Downregulated,10,5
murA,4837,2509,-0.94700006703669,-2328,Downregulated,10,5
sfsB,58,246,2.0845335102116676,188,Upregulated,10,5
ispB,3351,1721,-0.9613445891642675,-1630,Downregulated,10,5
rplU,8615,2069,-2.057917151252301,-6546,Downregulated,10,5
rpmA,5837,1321,-2.1435966016354113,-4516,Downregulated,10,5
yhbE,700,1310,0.9041399845924838,610,Upregulated,10,5
obgE,1606,3346,1.0589655525210382,1740,Upregulated,10,5
dacB,1392,1814,0.3820152446797941,422,Upregulated,10,5
greA,624,583,-0.0980501456617519,-41,Downregulated,10,5
yhbY,719,377,-0.9314272471706336,-342,Downregulated,10,5
rlmE,3352,2370,-0.5001350899137301,-982,Downregulated,10,5
ftsH,20778,14521,-0.5169159842939776,-6257,Downregulated,10,5
folP,2274,1280,-0.8290884440048853,-994,Downregulated,10,5
glmM,6991,3076,-1.1844433316791783,-3915,Downregulated,10,5
secG,4618,641,-2.848871911155374,-3977,Downregulated,10,5
yhbX,129,1075,3.0588936890535687,946,Upregulated,10,5
argG,3641,5672,0.6395227917950013,2031,Upregulated,10,5
rimP,2598,1236,-1.0717226875435064,-1362,Downregulated,10,5
nusA,11192,7760,-0.5283393100902632,-3432,Downregulated,10,5
infB,31405,17363,-0.8549780294361183,-14042,Downregulated,10,5
rbfA,1438,1041,-0.46609360713988074,-397,Downregulated,10,5
truB,2889,2497,-0.21037438263640323,-392,Downregulated,10,5
rpsO,5789,553,-3.387962770994172,-5236,Downregulated,10,5
pnp,29966,11315,-1.4050899345052204,-18651,Downregulated,10,5
nlpI,9908,3930,-1.334064556100394,-5978,Downregulated,10,5
deaD,5729,8287,0.5325665844045654,2558,Upregulated,10,5
mtr,727,2577,1.8256652679400254,1850,Upregulated,10,5
yhbW,269,1946,2.8548336322244876,1677,Upregulated,10,5
ubiV,1423,1744,0.2934643782504439,321,Upregulated,10,5
ubiU,1769,2243,0.34249557239581396,474,Upregulated,10,5
ubiT,3518,1679,-1.0671532525349308,-1839,Downregulated,10,5
yhbS,2449,1725,-0.5055964120110843,-724,Downregulated,10,5
yhbQ,85,508,2.579293750634464,423,Upregulated,10,5
yhbP,213,737,1.7908111888692315,524,Upregulated,10,5
yhbO,578,736,0.34863627355633403,158,Upregulated,10,5
yraR,222,1063,2.259510015180999,841,Upregulated,10,5
yraQ,471,2233,2.2451842862096902,1762,Upregulated,10,5
yraP,1666,1291,-0.36789940005835703,-375,Downregulated,10,5
diaA,1427,1028,-0.4731450702818853,-399,Downregulated,10,5
yraN,346,640,0.8872998672506377,294,Upregulated,10,5
lpoA,3959,5243,0.40525647848625845,1284,Upregulated,10,5
rsmI,692,1425,1.0421179763027415,733,Upregulated,10,5
yraK,109,1207,3.469025635978095,1098,Upregulated,10,5
yraJ,163,3021,4.212082314496864,2858,Upregulated,10,5
yraI,12,449,5.225609134019991,437,Upregulated,10,5
yraH,59,597,3.3389440719029637,538,Upregulated,10,5
agaI,21,875,5.380821783940931,854,Upregulated,10,5
agaD,18,995,5.788627713988699,977,Upregulated,10,5
agaC,9,770,6.4187896341399515,761,Upregulated,10,5
agaB,10,321,5.004501392234941,311,Upregulated,10,5
kbaY,11,1421,7.013259220605483,1410,Upregulated,10,5
agaS,19,1984,6.70626879694329,1965,Upregulated,10,5
agaA,67,841,3.6498727997973717,774,Upregulated,10,5
agaW,26,328,3.6571122864769916,302,Upregulated,10,5
agaV,32,553,4.111135670234707,521,Upregulated,10,5
kbaZ,38,2119,5.801240358928585,2081,Upregulated,10,5
agaR,1420,1559,0.13472999830574028,139,Upregulated,10,5
yhaV,555,633,0.18971772819087288,78,Upregulated,10,5
prlF,314,392,0.32008909522358114,78,Upregulated,10,5
garD,643,2624,2.0288770772901366,1981,Upregulated,10,5
garP,21,2163,6.6865005271832185,2142,Upregulated,10,5
garL,42,927,4.464108105846771,885,Upregulated,10,5
garR,216,1252,2.53513134476915,1036,Upregulated,10,5
garK,299,1832,2.615202113898839,1533,Upregulated,10,5
rnpB,949408,275071,-1.7872241582140715,-674337,Downregulated,10,5
yhaC,11,117,3.4109331009461075,106,Upregulated,10,5
yhaB,7,86,3.6189098326444937,79,Upregulated,10,5
tdcR,2,15,2.9068905956085187,13,Upregulated,10,5
tdcA,40,605,3.9188632372745946,565,Upregulated,10,5
tdcB,36,1199,5.057690941971911,1163,Upregulated,10,5
tdcC,202,1948,3.2695664793305474,1746,Upregulated,10,5
tdcD,57,1434,4.6529392945371635,1377,Upregulated,10,5
tdcE,222,3579,4.010924962066278,3357,Upregulated,10,5
tdcF,30,425,3.8244284354165456,395,Upregulated,10,5
cyuP,131,1930,3.8809621306179922,1799,Upregulated,10,5
yhaL,111,66,-0.7500217469916525,-45,Downregulated,10,5
yhaK,139,1084,2.963207968630364,945,Upregulated,10,5
yhaJ,943,1548,0.7150757954693138,605,Upregulated,10,5
yhaI,16,271,4.082149041353872,255,Upregulated,10,5
yhaH,548,468,-0.22766736337712226,-80,Downregulated,10,5
yqjG,576,1330,1.2072855289462394,754,Upregulated,10,5
yqjF,83,468,2.49532528823648,385,Upregulated,10,5
yqjK,5091,625,-3.02602097071437,-4466,Downregulated,10,5
yqjE,7344,706,-3.3788259701426275,-6638,Downregulated,10,5
yqjD,3018,458,-2.7201733024297394,-2560,Downregulated,10,5
yqjC,2697,650,-2.0528438983197868,-2047,Downregulated,10,5
mzrA,327,492,0.5893676798411575,165,Upregulated,10,5
yqjA,831,1014,0.287137270232996,183,Upregulated,10,5
exuR,1427,1820,0.35095311561029513,393,Upregulated,10,5
exuT,368,2439,2.7285120867391712,2071,Upregulated,10,5
uxaC,489,2861,2.5486131273709494,2372,Upregulated,10,5
uxaA,383,2925,2.933020327433172,2542,Upregulated,10,5
ygjV,107,638,2.5759456273637227,531,Upregulated,10,5
sstT,12868,4460,-1.5286722258450713,-8408,Downregulated,10,5
alx,105,1615,3.9430729319151645,1510,Upregulated,10,5
ygjR,700,1752,1.3235759477688445,1052,Upregulated,10,5
ygjQ,17,893,5.715053523870884,876,Upregulated,10,5
ygjP,190,618,1.7016074195734268,428,Upregulated,10,5
rlmG,328,2153,2.71458059954915,1825,Upregulated,10,5
higB,38,164,2.109624491174498,126,Upregulated,10,5
higA,160,706,2.1415962783838176,546,Upregulated,10,5
fadH,130,3960,4.928916901938518,3830,Upregulated,10,5
ygjK,111,4518,5.347052689042978,4407,Upregulated,10,5
ygjJ,7,1654,7.884388597113671,1647,Upregulated,10,5
ygjI,12,2141,7.479106579664354,2129,Upregulated,10,5
ebgC,9,445,5.627736524411448,436,Upregulated,10,5
ebgA,111,5640,5.66706358093605,5529,Upregulated,10,5
ebgR,444,1662,1.9042888004202385,1218,Upregulated,10,5
ygjH,6,380,5.984893107609792,374,Upregulated,10,5
patA,306,2431,2.989946335336077,2125,Upregulated,10,5
aer,185,2941,3.990709608370752,2756,Upregulated,10,5
nfeR,1179,1221,0.05049948200764056,42,Upregulated,10,5
nfeF,133,1323,3.314314910777487,1190,Upregulated,10,5
mug,1050,1094,0.05922341023907156,44,Upregulated,10,5
rpoD,12120,7711,-0.6523998257123927,-4409,Downregulated,10,5
dnaG,4439,4268,-0.05667453250066833,-171,Downregulated,10,5
rpsU,3308,384,-3.1067810184501186,-2924,Downregulated,10,5
tsaD,2887,2215,-0.3822644087936013,-672,Downregulated,10,5
ttdT,78,2873,5.202940058670276,2795,Upregulated,10,5
ttdB,137,1004,2.873511470990245,867,Upregulated,10,5
ttdA,194,1390,2.840956325423742,1196,Upregulated,10,5
ttdR,134,1392,3.376854305390956,1258,Upregulated,10,5
plsY,481,899,0.9022842217444054,418,Upregulated,10,5
folB,235,528,1.1678771727934538,293,Upregulated,10,5
bacA,997,1647,0.7241751453281589,650,Upregulated,10,5
cca,2899,2989,0.044107563616697605,90,Upregulated,10,5
ygiM,3729,2044,-0.8673936008360197,-1685,Downregulated,10,5
ygiF,1686,2589,0.618790428958029,903,Upregulated,10,5
glnE,4421,6303,0.5116659284401358,1882,Upregulated,10,5
hldE,2863,3195,0.15828826083500397,332,Upregulated,10,5
yqiK,77,2629,5.093511885923145,2552,Upregulated,10,5
yqiJ,19,397,4.385067683699372,378,Upregulated,10,5
glgS,276,80,-1.7865963618908067,-196,Downregulated,10,5
yqiI,47,517,3.4594316186372973,470,Upregulated,10,5
yqiH,40,361,3.1739269319998087,321,Upregulated,10,5
yqiG,258,3301,3.677460167799282,3043,Upregulated,10,5
insD5,419,649,0.631268234299787,230,Upregulated,10,5
insC5,388,374,-0.05301838229949099,-14,Downregulated,10,5
ygiL,11,351,4.9958956016672635,340,Upregulated,10,5
ubiK,1100,370,-1.5719063478957098,-730,Downregulated,10,5
ribB,4708,1358,-1.7936308407937125,-3350,Downregulated,10,5
zupT,1120,1151,0.03938910118726399,31,Upregulated,10,5
ygiD,168,1069,2.6697287149417304,901,Upregulated,10,5
ygiC,4783,2546,-0.9096833720849474,-2237,Downregulated,10,5
ygiB,3032,1622,-0.9024959339538187,-1410,Downregulated,10,5
tolC,11961,4410,-1.439487450273604,-7551,Downregulated,10,5
nudF,1144,892,-0.35897143685808475,-252,Downregulated,10,5
yqiB,709,558,-0.3455205054103285,-151,Downregulated,10,5
cpdA,2709,1885,-0.5231958700459878,-824,Downregulated,10,5
yqiA,967,941,-0.039321166748304485,-26,Downregulated,10,5
parE,4327,4059,-0.09224278072419789,-268,Downregulated,10,5
ygiN,3693,622,-2.5698067770750113,-3071,Downregulated,10,5
mdaB,921,842,-0.12938092302493956,-79,Downregulated,10,5
ygiZ,9,59,2.712718047919529,50,Upregulated,10,5
qseC,371,2323,2.6464980621880043,1952,Upregulated,10,5
qseB,184,911,2.3077452877450377,727,Upregulated,10,5
ygiW,2630,545,-2.270734664515376,-2085,Downregulated,10,5
ygiV,424,532,0.32736198093799046,108,Upregulated,10,5
mqsR,432,412,-0.06838697498025013,-20,Downregulated,10,5
mqsA,613,779,0.3457362543708877,166,Upregulated,10,5
ygiS,629,2644,2.071590254628403,2015,Upregulated,10,5
parC,6193,5018,-0.3035259753083543,-1175,Downregulated,10,5
plsC,947,891,-0.087938993946463,-56,Downregulated,10,5
ftsP,2332,2706,0.2145940507760408,374,Upregulated,10,5
yqhH,15,163,3.441837558622559,148,Upregulated,10,5
yqhG,108,1103,3.352329573427914,995,Upregulated,10,5
dkgA,3767,3626,-0.05503710820323461,-141,Downregulated,10,5
yqhD,7937,12203,0.6205701546581761,4266,Upregulated,10,5
yqhC,450,1404,1.6415460290875237,954,Upregulated,10,5
yghB,859,888,0.04790154521164227,29,Upregulated,10,5
metC,3522,1898,-0.891914916810099,-1624,Downregulated,10,5
exbB,410,941,1.1985708132230906,531,Upregulated,10,5
exbD,152,357,1.2318527505855144,205,Upregulated,10,5
yghA,3921,1504,-1.3824170748389522,-2417,Downregulated,10,5
yqhA,1118,1033,-0.11407993397813058,-85,Downregulated,10,5
gpr,1742,2642,0.600885842647963,900,Upregulated,10,5
yghW,10,275,4.78135971352466,265,Upregulated,10,5
hybO,9003,6137,-0.552872236181934,-2866,Downregulated,10,5
hybA,6466,4321,-0.5815082765363517,-2145,Downregulated,10,5
hybB,4812,3264,-0.5599955852045808,-1548,Downregulated,10,5
hybC,7003,6707,-0.06230548542503315,-296,Downregulated,10,5
hybD,1761,1393,-0.3381996512299555,-368,Downregulated,10,5
hybE,1558,1264,-0.3016987698845663,-294,Downregulated,10,5
hybF,270,331,0.2938718097563867,61,Upregulated,10,5
hybG,260,180,-0.5305147166987798,-80,Downregulated,10,5
yghU,2035,1817,-0.16347037491949354,-218,Downregulated,10,5
gss,6278,3983,-0.6564495492179292,-2295,Downregulated,10,5
pitB,49,2667,5.766292265435718,2618,Upregulated,10,5
yghT,11,860,6.288761230952163,849,Upregulated,10,5
yghS,23,980,5.413075982945558,957,Upregulated,10,5
yghR,22,1246,5.823656734386705,1224,Upregulated,10,5
yghQ,28,1654,5.884388597113671,1626,Upregulated,10,5
insH9,8435,3459,-1.286033054802,-4976,Downregulated,10,5
yghO,58,2245,5.274518734500937,2187,Upregulated,10,5
glcC,36,1427,5.308844618033451,1391,Upregulated,10,5
glcD,108,3740,5.11393505261153,3632,Upregulated,10,5
glcG,194,630,1.6992951762001511,436,Upregulated,10,5
glcB,1975,5449,1.4641388376246995,3474,Upregulated,10,5
glcA,80,2929,5.194264382992005,2849,Upregulated,10,5
pppA,608,1301,1.0974777332742098,693,Upregulated,10,5
yghG,100,363,1.859969548221026,263,Upregulated,10,5
yghF,109,1375,3.657031578522458,1266,Upregulated,10,5
yghE,429,1651,1.9442905674137125,1222,Upregulated,10,5
yghD,63,678,3.4278615396364276,615,Upregulated,10,5
yqgA,202,1036,2.358596804934759,834,Upregulated,10,5
speC,4947,3646,-0.4402393381194889,-1301,Downregulated,10,5
nupG,776,2199,1.5027190466678404,1423,Upregulated,10,5
mltC,1057,1697,0.6830111881599804,640,Upregulated,10,5
yggX,571,233,-1.2931607907085627,-338,Downregulated,10,5
mutY,1232,2016,0.7104933828050152,784,Upregulated,10,5
trmB,1644,1293,-0.3464880238714287,-351,Downregulated,10,5
yggL,1162,400,-1.5385381636298043,-762,Downregulated,10,5
yggN,575,1372,1.2546466203410749,797,Upregulated,10,5
ansB,3176,2156,-0.5588537343904522,-1020,Downregulated,10,5
yggM,43,1205,4.808552676415226,1162,Upregulated,10,5
hemW,835,2153,1.3665002168058191,1318,Upregulated,10,5
rdgB,792,1168,0.5604679388004076,376,Upregulated,10,5
yggU,186,265,0.5106897383425302,79,Upregulated,10,5
yggT,1213,916,-0.40516004702356645,-297,Downregulated,10,5
yggS,575,1072,0.898671044626035,497,Upregulated,10,5
yggR,43,1759,5.354275012769863,1716,Upregulated,10,5
yqgF,396,591,0.5776577000979228,195,Upregulated,10,5
yqgE,1563,1407,-0.15169544976313168,-156,Downregulated,10,5
gshB,1785,1954,0.13050639305192333,169,Upregulated,10,5
rsmE,922,1206,0.38739125147074693,284,Upregulated,10,5
endA,144,930,2.6911619045530815,786,Upregulated,10,5
yggI,237,550,1.214544559513763,313,Upregulated,10,5
galP,6076,3254,-0.9009076188295557,-2822,Downregulated,10,5
metK,44281,4382,-3.3370264134996166,-39899,Downregulated,10,5
yqgC,53,60,0.1789701410453193,7,Unchanged,10,5
yqgB,4,3,-0.4150374992788438,-1,Unchanged,10,5
speA,8034,4151,-0.9526595294418588,-3883,Downregulated,10,5
speB,1381,1420,0.04017761013399361,39,Upregulated,10,5
loiP,1397,1491,0.09394823687397919,94,Upregulated,10,5
tktA,40006,8739,-2.194676280715382,-31267,Downregulated,10,5
cmtB,7,241,5.105534414172357,234,Upregulated,10,5
cmtA,42,1733,5.366738516381409,1691,Upregulated,10,5
yggF,58,1365,4.556704240679642,1307,Upregulated,10,5
fumE,555,924,0.7354050801785893,369,Upregulated,10,5
yggC,563,1177,1.0639074929582146,614,Upregulated,10,5
epd,15423,4216,-1.8711366458342684,-11207,Downregulated,10,5
pgk,58834,15751,-1.9012066999993138,-43083,Downregulated,10,5
fbaA,127930,16826,-2.926590466055984,-111104,Downregulated,10,5
mscS,16583,3317,-2.3217541085098135,-13266,Downregulated,10,5
argO,334,855,1.3560763172992079,521,Upregulated,10,5
yggE,6522,1741,-1.9053982380973644,-4781,Downregulated,10,5
ygfI,231,959,2.0536379636020734,728,Upregulated,10,5
scpC,118,2210,4.227187604916953,2092,Upregulated,10,5
scpB,81,979,3.59531504671907,898,Upregulated,10,5
argK,68,1382,4.34507905913792,1314,Upregulated,10,5
scpA,140,3559,4.667973200564819,3419,Upregulated,10,5
argP,1776,1544,-0.20195882908202553,-232,Downregulated,10,5
yqfE,17,187,3.4594316186372973,170,Upregulated,10,5
rpiA,7654,2989,-1.3565510039904012,-4665,Downregulated,10,5
serA,48418,9691,-2.3208260392246167,-38727,Downregulated,10,5
fau,364,706,0.955729733072484,342,Upregulated,10,5
ssrS,6382,624,-3.3543906744170635,-5758,Downregulated,10,5
zapA,1183,460,-1.362744307395413,-723,Downregulated,10,5
ygfB,4239,1617,-1.390404287581434,-2622,Downregulated,10,5
pepP,10390,4728,-1.1358937136140417,-5662,Downregulated,10,5
ubiH,4132,3224,-0.3579885103370922,-908,Downregulated,10,5
ubiI,3056,2643,-0.20946811839417878,-413,Downregulated,10,5
gcvT,2759,2186,-0.3358520556813683,-573,Downregulated,10,5
gcvH,1286,556,-1.2097338546044398,-730,Downregulated,10,5
gcvP,4765,5353,0.16787143851768954,588,Upregulated,10,5
ygfF,137,1043,2.928491359559239,906,Upregulated,10,5
bglA,3541,2603,-0.443981531986804,-938,Downregulated,10,5
yqfB,500,296,-0.7563309190331373,-204,Downregulated,10,5
yqfA,468,1126,1.266626392496825,658,Upregulated,10,5
ygfZ,5845,3029,-0.9483614466236463,-2816,Downregulated,10,5
sdhE,872,598,-0.5441826505788212,-274,Downregulated,10,5
ygfX,1050,993,-0.08052370502511108,-57,Downregulated,10,5
fldB,1045,708,-0.5616816768852476,-337,Downregulated,10,5
xerD,2425,1805,-0.425985910187319,-620,Downregulated,10,5
dsbC,2407,1563,-0.6229183634748325,-844,Downregulated,10,5
recJ,4869,4760,-0.03266392707382181,-109,Downregulated,10,5
prfB,6706,3578,-0.9062990957418762,-3128,Downregulated,10,5
lysS,11239,5398,-1.0580167942800915,-5841,Downregulated,10,5
idi,181,509,1.49167595899249,328,Upregulated,10,5
uacT,14,1355,6.59672221418363,1341,Upregulated,10,5
ygfT,170,2332,3.777961137062795,2162,Upregulated,10,5
ygfS,41,420,3.356693513048039,379,Upregulated,10,5
guaD,321,1480,2.204951973394009,1159,Upregulated,10,5
xanQ,81,1283,3.985455452205058,1202,Upregulated,10,5
xdhD,412,3601,3.127681357007062,3189,Upregulated,10,5
ygfM,55,791,3.846174170948132,736,Upregulated,10,5
ssnA,48,1502,4.967706596793116,1454,Upregulated,10,5
ygfK,131,3110,4.569275863480515,2979,Upregulated,10,5
mocA,72,366,2.34577483684173,294,Upregulated,10,5
yqeC,68,788,3.534588978206037,720,Upregulated,10,5
yqeB,312,1897,2.604101744549227,1585,Upregulated,10,5
yqeA,155,781,2.333054332867742,626,Upregulated,10,5
hyuA,67,1470,4.455511249265954,1403,Upregulated,10,5
ygeY,108,1108,3.3588546638857197,1000,Upregulated,10,5
ygeX,68,1344,4.304854581528421,1276,Upregulated,10,5
ygeW,39,1194,4.936184902402557,1155,Upregulated,10,5
ygeV,542,1615,1.5751694082274157,1073,Upregulated,10,5
xdhC,85,400,2.234465253637023,315,Upregulated,10,5
xdhB,119,982,3.0447614510067496,863,Upregulated,10,5
xdhA,362,2539,2.8101987925643006,2177,Upregulated,10,5
ygeR,833,936,0.16819203421785683,103,Upregulated,10,5
ygeQ,169,600,1.8279392542136965,431,Upregulated,10,5
insC4,261,494,0.9204612350147932,233,Upregulated,10,5
insD4,297,752,1.3402697308768716,455,Upregulated,10,5
ygeO,36,68,0.9175378398080271,32,Upregulated,10,5
ygeN,36,39,0.11547721741993588,3,Unchanged,10,5
ygeL,9,132,3.8744691179161412,123,Upregulated,10,5
pbl,2,58,4.857980995127572,56,Upregulated,10,5
ygeI,2,3,0.5849625007211562,1,Unchanged,10,5
ygeH,12,130,3.4374053123072983,118,Upregulated,10,5
ygeG,4,20,2.321928094887362,16,Upregulated,10,5
ygeF,5,52,3.37851162325373,47,Upregulated,10,5
yqeK,5,7,0.48542682717024166,2,Unchanged,10,5
yqeJ,45,37,-0.282399730700725,-8,Unchanged,10,5
yqeI,222,245,0.14222207265246467,23,Upregulated,10,5
yqeH,37,138,1.8990710911492192,101,Upregulated,10,5
yqeG,393,779,0.9870940158030628,386,Upregulated,10,5
yqeF,130,1295,3.3163685695454617,1165,Upregulated,10,5
kduI,78,740,3.2459792416540636,662,Upregulated,10,5
kduD,153,772,2.3350691945754285,619,Upregulated,10,5
araE,535,1642,1.6178433304892954,1107,Upregulated,10,5
ygeA,439,672,0.6142402932434021,233,Upregulated,10,5
lysR,267,1107,2.0517435750939983,840,Upregulated,10,5
lysA,718,1585,1.1424270912037182,867,Upregulated,10,5
galR,663,1519,1.1960410943894957,856,Upregulated,10,5
aas,1936,2778,0.5209676467067981,842,Upregulated,10,5
lplT,801,1632,1.0267669095627856,831,Upregulated,10,5
tas,3231,2100,-0.6215914227118787,-1131,Downregulated,10,5
ygdR,408,99,-2.043068721891886,-309,Downregulated,10,5
ygdQ,382,1163,1.6062065534374697,781,Upregulated,10,5
mutH,409,1181,1.5298362164554085,772,Upregulated,10,5
rppH,3547,1514,-1.228234124949457,-2033,Downregulated,10,5
ptsP,6027,5486,-0.13568544260617083,-541,Downregulated,10,5
lgt,796,1141,0.5194584557450329,345,Upregulated,10,5
thyA,1386,1144,-0.27684020535882436,-242,Downregulated,10,5
ppdA,46,565,3.618545101245537,519,Upregulated,10,5
ppdB,135,734,2.442820655792382,599,Upregulated,10,5
ygdB,95,409,2.106101424610801,314,Upregulated,10,5
ppdC,58,262,2.1754420064098783,204,Upregulated,10,5
recC,3896,6288,0.6906075401762644,2392,Upregulated,10,5
ptrA,3035,5745,0.9206103763904312,2710,Upregulated,10,5
recB,4763,9327,0.9695425686981982,4564,Upregulated,10,5
recD,1512,3949,1.385029228239276,2437,Upregulated,10,5
argA,2043,5720,1.4853259429325243,3677,Upregulated,10,5
amiC,3720,2741,-0.44060029316961863,-979,Downregulated,10,5
mltA,2422,1986,-0.28633324216595485,-436,Downregulated,10,5
tcdA,309,1510,2.2888698063080666,1201,Upregulated,10,5
csdE,474,826,0.8012547225211862,352,Upregulated,10,5
csdA,2838,3493,0.29959205333431327,655,Upregulated,10,5
ygdI,787,166,-2.2451803941605615,-621,Downregulated,10,5
gcvA,1154,1751,0.6015358597880753,597,Upregulated,10,5
ygdD,429,674,0.6517709436823129,245,Upregulated,10,5
rlmM,1847,2280,0.30384995806966586,433,Upregulated,10,5
fucR,551,939,0.7690728390826168,388,Upregulated,10,5
fucU,454,560,0.3027345296540515,106,Upregulated,10,5
fucK,235,2406,3.355903980611077,2171,Upregulated,10,5
fucI,240,3344,3.8004685364723643,3104,Upregulated,10,5
fucP,40,1792,5.485426827170242,1752,Upregulated,10,5
fucA,37,822,4.473541218052733,785,Upregulated,10,5
fucO,1239,2308,0.8974670365048809,1069,Upregulated,10,5
ygdG,509,1252,1.2984970008569232,743,Upregulated,10,5
sdaB,1306,2363,0.855464732427416,1057,Upregulated,10,5
sdaC,3225,2429,-0.40893667056211386,-796,Downregulated,10,5
ppnN,5017,3382,-0.5689482783543135,-1635,Downregulated,10,5
queF,935,1189,0.3467104449706569,254,Upregulated,10,5
syd,688,840,0.28798076296402464,152,Upregulated,10,5
yqcC,227,274,0.2714835956696118,47,Upregulated,10,5
truC,600,1086,0.8559896973084807,486,Upregulated,10,5
yqcA,1328,630,-1.0758314129596458,-698,Downregulated,10,5
gudP,63,1746,4.792557920129523,1683,Upregulated,10,5
gudX,179,1748,3.287673692236342,1569,Upregulated,10,5
gudD,447,2124,2.248437029620836,1677,Upregulated,10,5
barA,1859,3721,1.001163620206291,1862,Upregulated,10,5
rlmD,961,2028,1.0774493162295902,1067,Upregulated,10,5
relA,4341,4857,0.1620380637708414,516,Upregulated,10,5
mazE,228,461,1.0157329262645964,233,Upregulated,10,5
mazF,274,358,0.3857836943037298,84,Upregulated,10,5
mazG,1247,2351,0.9148130738233513,1104,Upregulated,10,5
pyrG,25298,7476,-1.7586848591770456,-17822,Downregulated,10,5
eno,95671,30399,-1.6540578123284673,-65272,Downregulated,10,5
ygcG,13,321,4.625989768981211,308,Upregulated,10,5
queE,539,1103,1.0330756128388772,564,Upregulated,10,5
ygcE,81,1673,4.368371727153728,1592,Upregulated,10,5
yqcE,24,1512,5.977279923499917,1488,Upregulated,10,5
ygcW,14,671,5.582814034142579,657,Upregulated,10,5
ygcS,56,1777,4.987873043971074,1721,Upregulated,10,5
ygcR,42,1244,4.888453347351843,1202,Upregulated,10,5
ygcQ,80,1208,3.9164766444377164,1128,Upregulated,10,5
ygcP,85,530,2.6404576133128597,445,Upregulated,10,5
ygcO,10,142,3.8278190246173196,132,Upregulated,10,5
ygcN,370,1949,2.3971369147415778,1579,Upregulated,10,5
queD,429,405,-0.08305573972755852,-24,Downregulated,10,5
cysJ,422,5213,3.626798955888827,4791,Upregulated,10,5
cysI,469,5428,3.5327608929034775,4959,Upregulated,10,5
cysH,236,1489,2.6574849892202588,1253,Upregulated,10,5
cas3,306,2941,3.264703226194412,2635,Upregulated,10,5
casA,164,1734,3.4023361786037514,1570,Upregulated,10,5
casB,92,504,2.4537179674429037,412,Upregulated,10,5
casC,353,1240,1.8126000320030573,887,Upregulated,10,5
casD,180,898,2.3187185384114724,718,Upregulated,10,5
casE,222,731,1.7193117296023313,509,Upregulated,10,5
cas1,318,1412,2.150641417986825,1094,Upregulated,10,5
cas2,60,276,2.2016338611696504,216,Upregulated,10,5
iap,545,1587,1.5419739931708931,1042,Upregulated,10,5
cysD,382,3783,3.3078862330136274,3401,Upregulated,10,5
cysN,880,6089,2.7906298840799177,5209,Upregulated,10,5
cysC,130,1389,3.417463070952938,1259,Upregulated,10,5
ygbE,61,298,2.2884311828992754,237,Upregulated,10,5
ftsB,714,479,-0.5758984182929195,-235,Downregulated,10,5
ispD,1716,1620,-0.08305573972755852,-96,Downregulated,10,5
ispF,1077,709,-0.6031607173046915,-368,Downregulated,10,5
truD,3937,2572,-0.6142060698310937,-1365,Downregulated,10,5
umpG,2166,1754,-0.30438449516359406,-412,Downregulated,10,5
pcm,1324,1128,-0.23113605440842414,-196,Downregulated,10,5
nlpD,8032,12648,0.6550780984075988,4616,Upregulated,10,5
rpoS,26810,22547,-0.24983573142950463,-4263,Downregulated,10,5
ygbN,132,1960,3.892243819644117,1828,Upregulated,10,5
ygbM,92,1072,3.5425272344007595,980,Upregulated,10,5
ygbL,54,1100,4.3484003062485534,1046,Upregulated,10,5
ygbK,103,2074,4.331699651630007,1971,Upregulated,10,5
ygbJ,62,1604,4.693262116068045,1542,Upregulated,10,5
ygbI,471,1357,1.5266217558060708,886,Upregulated,10,5
pphB,34,493,3.8579809951275723,459,Upregulated,10,5
mutS,2242,5382,1.2633561128349906,3140,Upregulated,10,5
ygbA,37,463,3.6454150176312865,426,Upregulated,10,5
fhlA,1088,4631,2.089645200453354,3543,Upregulated,10,5
hypE,1891,2273,0.2654483208680863,382,Upregulated,10,5
hypD,2762,3198,0.21145661922228126,436,Upregulated,10,5
hypC,262,377,0.5249977117312139,115,Upregulated,10,5
hypB,2678,2636,-0.022805590316258825,-42,Downregulated,10,5
hypA,168,614,1.869777422591419,446,Upregulated,10,5
hycA,178,814,2.1931515532998493,636,Upregulated,10,5
hycB,153,1186,2.954500451853352,1033,Upregulated,10,5
hycC,477,4998,3.389289730081192,4521,Upregulated,10,5
hycD,215,2287,3.4110478008222125,2072,Upregulated,10,5
hycE,590,4908,3.0563483894137016,4318,Upregulated,10,5
hycF,162,1198,2.886562189904161,1036,Upregulated,10,5
hycG,319,1666,2.3847600716006783,1347,Upregulated,10,5
hycH,180,694,1.9469387562485863,514,Upregulated,10,5
hycI,257,836,1.7017345828870047,579,Upregulated,10,5
ascB,431,3340,2.9540883282723165,2909,Upregulated,10,5
ascF,310,3787,3.610715300610182,3477,Upregulated,10,5
ascG,412,2505,2.6040943608993525,2093,Upregulated,10,5
hydN,207,768,1.8914755432218309,561,Upregulated,10,5
hypF,1876,6526,1.7985391595764877,4650,Upregulated,10,5
norW,116,2928,4.65771884315647,2812,Upregulated,10,5
norV,249,3637,3.868531278387536,3388,Upregulated,10,5
norR,792,3969,2.3252032269202236,3177,Upregulated,10,5
gutQ,1080,2405,1.1550055816065732,1325,Upregulated,10,5
srlR,672,1493,1.1516810273557812,821,Upregulated,10,5
gutM,45,461,3.356769844099663,416,Upregulated,10,5
srlD,346,1916,2.4692536180994558,1570,Upregulated,10,5
srlB,36,591,4.03708931873522,555,Upregulated,10,5
srlE,87,1760,4.338416217675931,1673,Upregulated,10,5
srlA,41,699,4.091596640757353,658,Upregulated,10,5
mltB,1378,2250,0.7073491134001081,872,Upregulated,10,5
pncC,685,778,0.18366616713830297,93,Upregulated,10,5
recA,17576,4915,-1.8383434531953335,-12661,Downregulated,10,5
recX,112,628,2.487265826834023,516,Upregulated,10,5
alaS,28405,11168,-1.3467740563194006,-17237,Downregulated,10,5
csrA,1690,209,-3.015448399088664,-1481,Downregulated,10,5
yqaB,769,951,0.3064617428987369,182,Upregulated,10,5
yqaA,623,484,-0.36422511574940736,-139,Downregulated,10,5
gshA,5324,3238,-0.7174075856093258,-2086,Downregulated,10,5
luxS,7464,1341,-2.4766397489472847,-6123,Downregulated,10,5
emrB,1165,2349,1.0117167584705542,1184,Upregulated,10,5
emrA,1958,1855,-0.07796157809552932,-103,Downregulated,10,5
mprA,4158,1218,-1.7713756249520376,-2940,Downregulated,10,5
ygaH,691,555,-0.3161979391507903,-136,Downregulated,10,5
ygaZ,3482,2195,-0.6656952632283807,-1287,Downregulated,10,5
ygaY,261,2112,3.016488122788569,1851,Upregulated,10,5
proX,21168,17839,-0.24685022229369336,-3329,Downregulated,10,5
proW,20183,20659,0.0336297896684495,476,Upregulated,10,5
proV,29020,25379,-0.19341229512175842,-3641,Downregulated,10,5
nrdF,34,1274,5.227686721005961,1240,Upregulated,10,5
nrdE,114,3660,5.004737919006663,3546,Upregulated,10,5
nrdI,10,348,5.121015400961366,338,Upregulated,10,5
nrdH,7,179,4.676460855206653,172,Upregulated,10,5
ygaM,2129,484,-2.1370969971776996,-1645,Downregulated,10,5
ygaC,795,346,-1.200182822534993,-449,Downregulated,10,5
alaE,143,446,1.6410285631419153,303,Upregulated,10,5
stpA,7718,1603,-2.2674526183867063,-6115,Downregulated,10,5
ygaP,221,666,1.5914758076798305,445,Upregulated,10,5
ygaV,67,246,1.8764253148814674,179,Upregulated,10,5
yqaE,34,44,0.37196877738695794,10,Unchanged,10,5
kbp,3208,787,-2.0272386009474337,-2421,Downregulated,10,5
glaR,326,1185,1.861943189554544,859,Upregulated,10,5
gabP,140,2040,3.8650704199138914,1900,Upregulated,10,5
gabT,630,2902,2.2036237856794654,2272,Upregulated,10,5
gabD,737,3073,2.0599112424978925,2336,Upregulated,10,5
lhgD,230,2559,3.475874381095071,2329,Upregulated,10,5
glaH,222,1571,2.8230515989440903,1349,Upregulated,10,5
ypjC,10,184,4.20163386116965,174,Upregulated,10,5
pinH,1,97,6.599912842187128,96,Upregulated,10,5
ypjA,579,5165,3.1571330957631853,4586,Upregulated,10,5
ypjF,12,137,3.5130695822393703,125,Upregulated,10,5
yfjZ,3,115,5.260527550223219,112,Upregulated,10,5
yfjY,9,350,5.281286110390016,341,Upregulated,10,5
yfjX,10,488,5.608809242675524,478,Upregulated,10,5
yfjW,751,237,-1.6639258486160127,-514,Downregulated,10,5
yfjV,226,1065,2.236458752698013,839,Upregulated,10,5
yfjU,3,2,-0.5849625007211563,-1,Unchanged,10,5
yfjT,47,384,3.030373649043519,337,Upregulated,10,5
yfjS,14,289,4.3675707604430745,275,Upregulated,10,5
ypjK,7,109,3.9608294027193223,102,Upregulated,10,5
yfjR,27,593,4.457000792382535,566,Upregulated,10,5
yfjQ,18,800,5.473931188332412,782,Upregulated,10,5
yfjP,75,952,3.665999072812063,877,Upregulated,10,5
rnlB,396,325,-0.28506071216379275,-71,Downregulated,10,5
rnlA,4217,1619,-1.3811140359765677,-2598,Downregulated,10,5
yfjM,14,109,2.9608294027193223,95,Upregulated,10,5
abpA,1810,1794,-0.01280980705130656,-16,Downregulated,10,5
abpB,1926,2173,0.1740804713378237,247,Upregulated,10,5
yfjJ,25,146,2.5459683691052923,121,Upregulated,10,5
yfjI,45,437,3.2796363731709235,392,Upregulated,10,5
alpA,7,62,3.146841388329271,55,Upregulated,10,5
yfjH,292,345,0.2406279927855141,53,Upregulated,10,5
intA,1577,1368,-0.20511442990461237,-209,Downregulated,10,5
ssrA,836700,230403,-1.8605509333377752,-606297,Downregulated,10,5
smpB,1129,586,-0.9460729163507529,-543,Downregulated,10,5
ratA,1459,749,-0.9619422594591398,-710,Downregulated,10,5
yfjF,337,212,-0.6686843266186594,-125,Downregulated,10,5
bamE,2178,451,-2.271804615461526,-1727,Downregulated,10,5
recN,4802,2374,-1.0163154685885099,-2428,Downregulated,10,5
nadK,1039,895,-0.21523606675259307,-144,Downregulated,10,5
grpE,13820,4361,-1.6640267201940149,-9459,Downregulated,10,5
ypjD,620,749,0.2726975031845134,129,Upregulated,10,5
ffh,7914,4949,-0.677270023105698,-2965,Downregulated,10,5
rpsP,3736,790,-2.241569896645197,-2946,Downregulated,10,5
rimM,20347,4125,-2.302350072026451,-16222,Downregulated,10,5
trmD,22564,4815,-2.2284151388740416,-17749,Downregulated,10,5
rplS,6860,906,-2.9206256210139396,-5954,Downregulated,10,5
yfiB,519,272,-0.9321278871075415,-247,Downregulated,10,5
dgcN,547,986,0.8500468135853549,439,Upregulated,10,5
yfiR,386,430,0.1557358123213798,44,Upregulated,10,5
yfiL,47,144,1.615336149764675,97,Upregulated,10,5
aroF,1014,3907,1.9460036031803325,2893,Upregulated,10,5
tyrA,1266,3519,1.4748881093213233,2253,Upregulated,10,5
pheA,2987,1816,-0.7179330350198756,-1171,Downregulated,10,5
pheL,1,1,0.0,0,Unchanged,10,5
raiA,10047,3287,-1.6119214203475616,-6760,Downregulated,10,5
bamD,6003,1875,-1.6787930723562918,-4128,Downregulated,10,5
rluD,2293,1726,-0.40980389040183846,-567,Downregulated,10,5
pgeF,778,832,0.0968133731549001,54,Upregulated,10,5
clpB,36074,29838,-0.27380856564118633,-6236,Downregulated,10,5
kgtP,3210,4043,0.3328529062620291,833,Upregulated,10,5
yfiM,100,301,1.5897634869849773,201,Upregulated,10,5
pssA,4784,2306,-1.0528248765463333,-2478,Downregulated,10,5
patZ,2061,4108,0.9950916767789388,2047,Upregulated,10,5
tapT,142,783,2.4631213777863588,641,Upregulated,10,5
trxC,116,351,1.5973462251769885,235,Upregulated,10,5
yfiF,2027,1938,-0.06477751805181789,-89,Downregulated,10,5
ung,1231,1055,-0.22258776288990983,-176,Downregulated,10,5
grcA,2592,1976,-0.39148277129994696,-616,Downregulated,10,5
eamB,196,795,2.0201012060565096,599,Upregulated,10,5
yfiE,174,1283,2.882361959240954,1109,Upregulated,10,5
srmB,3008,3387,0.17120341981651963,379,Upregulated,10,5
yfiC,508,1020,1.005668750086692,512,Upregulated,10,5
nadB,16222,3755,-2.1110668866170283,-12467,Downregulated,10,5
rpoE,9016,2998,-1.5884871322243617,-6018,Downregulated,10,5
rseA,13743,5654,-1.2813531804079885,-8089,Downregulated,10,5
rseB,7779,2854,-1.4465993720986874,-4925,Downregulated,10,5
rseC,2917,1030,-1.5018410488275968,-1887,Downregulated,10,5
lepA,10039,5222,-0.9429412046435173,-4817,Downregulated,10,5
lepB,3404,1888,-0.8503722723241213,-1516,Downregulated,10,5
rnc,2100,1337,-0.6513898624601321,-763,Downregulated,10,5
era,3271,2582,-0.3412427587755877,-689,Downregulated,10,5
recO,630,1027,0.7050124479309162,397,Upregulated,10,5
pdxJ,2397,1487,-0.6888252615967143,-910,Downregulated,10,5
acpS,605,552,-0.13226687538378784,-53,Downregulated,10,5
yfhL,99,112,0.17799830197799443,13,Upregulated,10,5
yfhH,425,1286,1.597355896302883,861,Upregulated,10,5
pgpC,1126,1457,0.3717940499842829,331,Upregulated,10,5
tadA,684,952,0.4769652484220457,268,Upregulated,10,5
mltF,354,2764,2.964936350305261,2410,Upregulated,10,5
purL,26525,18325,-0.533539552780953,-8200,Downregulated,10,5
glrK,1115,3405,1.6106110880917666,2290,Upregulated,10,5
qseG,780,1496,0.9395641461380261,716,Upregulated,10,5
glrR,1138,3048,1.4213623451867403,1910,Upregulated,10,5
glnB,1054,452,-1.2214801892220268,-602,Downregulated,10,5
hmp,402,2387,2.569931159902848,1985,Upregulated,10,5
glyA,93445,9592,-3.2842139072946566,-83853,Downregulated,10,5
yphH,303,2184,2.8495831574469017,1881,Upregulated,10,5
yphG,152,6405,5.397055341785423,6253,Upregulated,10,5
yphF,51,1392,4.770518153877233,1341,Upregulated,10,5
yphE,52,3191,5.93935317513822,3139,Upregulated,10,5
yphD,58,1914,5.044394119358453,1856,Upregulated,10,5
yphC,290,2141,2.884159990370575,1851,Upregulated,10,5
yphB,183,1595,3.1236408703681895,1412,Upregulated,10,5
yphA,471,473,0.006113123726612006,2,Unchanged,10,5
hcaD,206,2111,3.3572103361639374,1905,Upregulated,10,5
hcaB,180,1745,3.27715822476734,1565,Upregulated,10,5
hcaC,50,475,3.2479275134435857,425,Upregulated,10,5
hcaF,53,665,3.649290075825353,612,Upregulated,10,5
hcaE,854,3166,1.8903532805166907,2312,Upregulated,10,5
hcaR,164,1769,3.4311663280723748,1605,Upregulated,10,5
hcaT,380,2506,2.7213150909909127,2126,Upregulated,10,5
csiE,616,2389,1.955404597761431,1773,Upregulated,10,5
yfhR,49,1977,5.334387311614,1928,Upregulated,10,5
suhB,2777,1927,-0.5271706055231249,-850,Downregulated,10,5
trmJ,2986,4118,0.463729664497713,1132,Upregulated,10,5
iscR,525,1270,1.274439169106043,745,Upregulated,10,5
iscS,4420,5898,0.41617945278294277,1478,Upregulated,10,5
iscU,1186,1325,0.1598883497919203,139,Upregulated,10,5
iscA,1381,1280,-0.10956950937068856,-101,Downregulated,10,5
hscB,757,1434,0.9216798187161731,677,Upregulated,10,5
hscA,5431,7576,0.48021846754418435,2145,Upregulated,10,5
fdx,758,794,0.06694115897186609,36,Upregulated,10,5
iscX,121,228,0.9140267768901471,107,Upregulated,10,5
pepB,2829,5045,0.8345620925974669,2216,Upregulated,10,5
sseB,1007,1602,0.6698104644019254,595,Upregulated,10,5
sseA,2118,2089,-0.019890096925228282,-29,Downregulated,10,5
yfhM,7373,14354,0.9611291637400687,6981,Upregulated,10,5
pbpC,591,5700,3.269731883761934,5109,Upregulated,10,5
ndk,263,834,1.6649845841523612,571,Upregulated,10,5
rlmN,1606,2891,0.848096715959735,1285,Upregulated,10,5
rodZ,3168,3074,-0.043455170388838255,-94,Downregulated,10,5
ispG,5829,4374,-0.41429518125840753,-1455,Downregulated,10,5
hisS,7522,4323,-0.7990834701444027,-3199,Downregulated,10,5
yfgM,3246,1861,-0.8025849444888199,-1385,Downregulated,10,5
bamB,9072,4553,-0.9946031809230298,-4519,Downregulated,10,5
der,2925,3850,0.3964218211114968,925,Upregulated,10,5
yfgJ,25,92,1.8797057662822882,67,Upregulated,10,5
xseA,2388,2775,0.21668493486002566,387,Upregulated,10,5
guaB,42100,4813,-3.1288119048762484,-37287,Downregulated,10,5
guaA,43232,4688,-3.205055104903437,-38544,Downregulated,10,5
yfgI,48,854,4.153129758899334,806,Upregulated,10,5
yfgH,25,453,4.17951105027151,428,Upregulated,10,5
yfgG,37,84,1.1828640571498104,47,Upregulated,10,5
pdeF,214,3472,4.020084246043332,3258,Upregulated,10,5
ppx,3634,3416,-0.0892504446136255,-218,Downregulated,10,5
ppk,6678,5093,-0.39090037616558193,-1585,Downregulated,10,5
purN,3619,1701,-1.0892079667091537,-1918,Downregulated,10,5
purM,12455,5024,-1.3098166522365717,-7431,Downregulated,10,5
upp,17025,1252,-3.7653483308541777,-15773,Downregulated,10,5
uraA,7735,2163,-1.8383676263744193,-5572,Downregulated,10,5
hda,1509,1751,0.21458627790687457,242,Upregulated,10,5
yfgD,1555,699,-1.1535502196425285,-856,Downregulated,10,5
bepA,3959,4232,0.09620356008392907,273,Upregulated,10,5
yfgO,1210,2575,1.0895653847959863,1365,Upregulated,10,5
focB,97,1824,4.232977171977614,1727,Upregulated,10,5
hyfR,167,4278,4.679016474690992,4111,Upregulated,10,5
hyfJ,33,563,4.092596992721776,530,Upregulated,10,5
hyfI,71,1370,4.270213058343207,1299,Upregulated,10,5
hyfH,61,982,4.008841876751807,921,Upregulated,10,5
hyfG,231,3849,4.0585189143947815,3618,Upregulated,10,5
hyfF,92,2853,4.954702075524707,2761,Upregulated,10,5
hyfE,19,1270,6.062685268215943,1251,Upregulated,10,5
hyfD,34,2758,6.341943900263641,2724,Upregulated,10,5
hyfC,10,1798,7.490249210627085,1788,Upregulated,10,5
hyfB,105,4560,5.4405725913859815,4455,Upregulated,10,5
hyfA,13,1186,6.511448576404911,1173,Upregulated,10,5
bcp,4909,1094,-2.1658164285734918,-3815,Downregulated,10,5
gcvR,2622,1276,-1.0390393564568852,-1346,Downregulated,10,5
dapA,12848,5392,-1.252651396335456,-7456,Downregulated,10,5
bamC,10846,6171,-0.8135868757691186,-4675,Downregulated,10,5
purC,16539,4418,-1.9044066834569928,-12121,Downregulated,10,5
ypfJ,1889,2527,0.41980296255640537,638,Upregulated,10,5
tmcA,1729,5079,1.5546066049745162,3350,Upregulated,10,5
ypfH,1234,1969,0.6741207167521358,735,Upregulated,10,5
dapE,1373,2801,1.028610357927406,1428,Upregulated,10,5
yffB,299,509,0.7675201718775903,210,Upregulated,10,5
acrD,590,7637,3.694219164132008,7047,Upregulated,10,5
narQ,1044,3821,1.8718285457876267,2777,Upregulated,10,5
aegA,577,4592,2.9924794180302055,4015,Upregulated,10,5
nudK,547,1258,1.2015191840867327,711,Upregulated,10,5
ypfG,1168,2779,1.2505255603205445,1611,Upregulated,10,5
tktB,9029,5549,-0.7023384089773067,-3480,Downregulated,10,5
talA,4121,1996,-1.045882742943239,-2125,Downregulated,10,5
maeB,3955,7260,0.8762918535229589,3305,Upregulated,10,5
eutS,3,592,7.624490864907794,589,Upregulated,10,5
eutP,8,762,6.573647187493322,754,Upregulated,10,5
eutQ,28,1891,6.077578725892158,1863,Upregulated,10,5
eutT,34,2262,6.0559203727394815,2228,Upregulated,10,5
eutD,40,3074,6.263973354803409,3034,Upregulated,10,5
eutM,22,300,3.7693870718585836,278,Upregulated,10,5
eutN,1,410,8.679480099505446,409,Upregulated,10,5
eutE,41,3690,6.491853096329675,3649,Upregulated,10,5
eutJ,17,2236,7.0392416315928505,2219,Upregulated,10,5
eutG,58,3404,5.87503432655839,3346,Upregulated,10,5
eutH,64,3375,5.720671786825555,3311,Upregulated,10,5
eutA,68,3885,5.8362360420447335,3817,Upregulated,10,5
yffS,1061,1909,0.8473924464891729,848,Upregulated,10,5
yffR,350,616,0.8155754288625726,266,Upregulated,10,5
yffQ,19,335,4.1400897719015495,316,Upregulated,10,5
yffP,70,1248,4.156119201917282,1178,Upregulated,10,5
yffO,52,584,3.489384840738925,532,Upregulated,10,5
yffN,21,491,4.547261791535933,470,Upregulated,10,5
yffM,6,238,5.309855262586788,232,Upregulated,10,5
yffL,322,1063,1.7230090034164878,741,Upregulated,10,5
intZ,335,2598,2.9551684301027463,2263,Upregulated,10,5
eutB,1718,4213,1.2941178794237909,2495,Upregulated,10,5
eutC,532,1618,1.604713456928788,1086,Upregulated,10,5
eutL,472,1549,1.7144783794277272,1077,Upregulated,10,5
eutK,305,1070,1.8107296488382607,765,Upregulated,10,5
eutR,393,2680,2.7696317830865285,2287,Upregulated,10,5
hemF,810,1930,1.2526070343834557,1120,Upregulated,10,5
amiA,1373,2284,0.7342310252157421,911,Upregulated,10,5
ypeA,656,1134,0.7896529203241452,478,Upregulated,10,5
yfeZ,277,934,1.7535365736604736,657,Upregulated,10,5
yfeY,758,1244,0.7147167319595109,486,Upregulated,10,5
yfeX,5567,2892,-0.9448325309147156,-2675,Downregulated,10,5
yfeW,108,2888,4.740967524723702,2780,Upregulated,10,5
murP,144,3370,4.548607874626908,3226,Upregulated,10,5
murQ,163,2127,3.7058761637295947,1964,Upregulated,10,5
murR,216,2029,3.2316656475931906,1813,Upregulated,10,5
ucpA,1306,2375,0.8627726165592418,1069,Upregulated,10,5
cysP,329,4508,3.7763280264369796,4179,Upregulated,10,5
cysU,126,2847,4.4979468542423495,2721,Upregulated,10,5
cysW,204,3261,3.99867338377697,3057,Upregulated,10,5
cysA,366,5022,3.7783464749874573,4656,Upregulated,10,5
cysM,795,3112,1.9688152948144741,2317,Upregulated,10,5
yfeS,267,511,0.9364835492500674,244,Upregulated,10,5
yfeK,103,367,1.8331357256599945,264,Upregulated,10,5
pdxK,2480,1933,-0.35949848306300186,-547,Downregulated,10,5
crr,33596,4329,-2.9561837677075102,-29267,Downregulated,10,5
ptsI,141378,27201,-2.377826042236528,-114177,Downregulated,10,5
ptsH,17812,2381,-2.9032099911725697,-15431,Downregulated,10,5
cysK,9227,22902,1.3115400305896625,13675,Upregulated,10,5
cysZ,1228,1754,0.5143381870745536,526,Upregulated,10,5
zipA,6068,3569,-0.7657011841980108,-2499,Downregulated,10,5
ligA,3873,5243,0.43694104448800836,1370,Upregulated,10,5
yfeH,505,1848,1.8716094637769005,1343,Upregulated,10,5
yfeR,249,1853,2.895645233959185,1604,Upregulated,10,5
yfeN,124,972,2.970616193218906,848,Upregulated,10,5
xapA,27,1285,5.572665141917772,1258,Upregulated,10,5
xapB,252,1929,2.936357504549187,1677,Upregulated,10,5
xapR,432,1545,1.8385036206282683,1113,Upregulated,10,5
gltX,10436,4711,-1.147463612149531,-5725,Downregulated,10,5
yfeD,238,384,0.6901447374132127,146,Upregulated,10,5
yfeC,183,310,0.7604245669901952,127,Upregulated,10,5
pdeA,2579,3873,0.5866397282391328,1294,Upregulated,10,5
insL3,895,2493,1.4779232953398818,1598,Upregulated,10,5
nupC,4556,2436,-0.9032536138017795,-2120,Downregulated,10,5
mntH,249,2205,3.146561008376802,1956,Upregulated,10,5
ypeC,313,495,0.6612658680343536,182,Upregulated,10,5
yfeO,189,1851,3.2918467556495017,1662,Upregulated,10,5
glk,3112,4006,0.36432036082651587,894,Upregulated,10,5
fryB,3,312,6.700439718141092,309,Upregulated,10,5
fryC,28,2076,6.212235806300277,2048,Upregulated,10,5
ypdF,49,1997,5.348908773328764,1948,Upregulated,10,5
ypdE,24,1459,5.925801667196735,1435,Upregulated,10,5
fryA,199,4641,4.543595361626543,4442,Upregulated,10,5
ypdC,232,1474,2.6675398139674975,1242,Upregulated,10,5
pyrR,434,979,1.1736138171592156,545,Upregulated,10,5
pyrS,303,2444,3.0118545863457786,2141,Upregulated,10,5
alaC,1743,2657,0.6082256583648216,914,Upregulated,10,5
lpxP,110,1433,3.703463180737486,1323,Upregulated,10,5
yfdY,183,163,-0.16697168405296492,-20,Downregulated,10,5
ypdI,5,106,4.405992359675837,101,Upregulated,10,5
yfdX,40,573,3.8404632338695426,533,Upregulated,10,5
frc,63,1091,4.114155462823691,1028,Upregulated,10,5
oxc,43,1478,5.103165799444053,1435,Upregulated,10,5
yfdV,24,609,4.6653359171851765,585,Upregulated,10,5
yfdE,57,951,4.060411516695822,894,Upregulated,10,5
evgS,3760,2604,-0.5300032133993643,-1156,Downregulated,10,5
evgA,2842,729,-1.9629158349158433,-2113,Downregulated,10,5
emrK,75,574,2.936088236179807,499,Upregulated,10,5
emrY,53,797,3.910515459427273,744,Upregulated,10,5
dsdA,519,1365,1.3950945074493342,846,Upregulated,10,5
dsdX,86,1253,3.8649059446197627,1167,Upregulated,10,5
dsdC,460,896,0.9618648711132289,436,Upregulated,10,5
yfdT,8,130,4.022367813028454,122,Upregulated,10,5
yfdS,5,163,5.026800059343715,158,Upregulated,10,5
yfdR,2,349,7.447083226209652,347,Upregulated,10,5
yfdQ,53,650,3.616375453352618,597,Upregulated,10,5
yfdP,8,218,4.768184324776926,210,Upregulated,10,5
yfdO,5,596,6.897240425574799,591,Upregulated,10,5
yfdN,3,448,7.222392421336448,445,Upregulated,10,5
yfdM,2,163,6.348728154231077,161,Upregulated,10,5
yfdL,5,424,6.405992359675837,419,Upregulated,10,5
yfdK,61,245,2.0059006014396843,184,Upregulated,10,5
tfaS,22,129,2.5517956367859567,107,Upregulated,10,5
yfdI,514,142,-1.855877429689196,-372,Downregulated,10,5
yfdH,920,562,-0.7110637307234491,-358,Downregulated,10,5
yfdG,289,212,-0.4470052279374796,-77,Downregulated,10,5
intS,574,1301,1.1804983200421075,727,Upregulated,10,5
yfdC,477,900,0.9159357352115255,423,Upregulated,10,5
mlaA,5785,1100,-2.3948134355828303,-4685,Downregulated,10,5
yfdF,46,258,2.4876652993662414,212,Upregulated,10,5
fadL,415,1341,1.6921259956701868,926,Upregulated,10,5
yfcZ,971,280,-1.7940444684742258,-691,Downregulated,10,5
fadI,57,1688,4.888209174542443,1631,Upregulated,10,5
fadJ,295,3042,3.366233293475293,2747,Upregulated,10,5
sixA,1782,871,-1.0327527129230574,-911,Downregulated,10,5
yfcV,9,496,5.784271308944563,487,Upregulated,10,5
yfcS,23,1040,5.498805856971441,1017,Upregulated,10,5
yfcR,35,439,3.6487941125903918,404,Upregulated,10,5
yfcQ,22,441,4.325203226920223,419,Upregulated,10,5
yfcP,27,675,4.643856189774724,648,Upregulated,10,5
yfcO,624,971,0.6379252665569439,347,Upregulated,10,5
smrB,1050,1099,0.06580205839574609,49,Upregulated,10,5
prmB,4764,2105,-1.1783531799103557,-2659,Downregulated,10,5
aroC,6610,3877,-0.7697095366438736,-2733,Downregulated,10,5
mepA,2355,1967,-0.25973010222161524,-388,Downregulated,10,5
yfcA,1300,1687,0.3759483503717489,387,Upregulated,10,5
epmC,1294,1022,-0.34044242105488615,-272,Downregulated,10,5
yfcL,394,370,-0.09067035894006407,-24,Downregulated,10,5
mnmC,1426,4951,1.7957459675182725,3525,Upregulated,10,5
fabB,4505,8243,0.8716423888252957,3738,Upregulated,10,5
yfcJ,390,2621,2.7485713245788066,2231,Upregulated,10,5
flk,872,1911,1.1319277382005304,1039,Upregulated,10,5
pdxB,3710,3424,-0.11573648510701863,-286,Downregulated,10,5
usg,1978,2961,0.5820420644184431,983,Upregulated,10,5
truA,555,1242,1.162105496983013,687,Upregulated,10,5
dedA,692,1230,0.8298143725898777,538,Upregulated,10,5
accD,13002,4494,-1.5326615296349224,-8508,Downregulated,10,5
folC,2611,3447,0.40073884105442764,836,Upregulated,10,5
dedD,2006,1673,-0.26188416057382796,-333,Downregulated,10,5
cvpA,4868,2123,-1.1972247968083507,-2745,Downregulated,10,5
purF,7738,5515,-0.48859984296447145,-2223,Downregulated,10,5
ubiX,634,1019,0.6845993060264066,385,Upregulated,10,5
argT,206,1178,2.515623296647242,972,Upregulated,10,5
hisJ,1225,3490,1.5104452872070817,2265,Upregulated,10,5
hisQ,422,1865,2.143860726435415,1443,Upregulated,10,5
hisM,278,1192,2.100227447738654,914,Upregulated,10,5
hisP,311,1687,2.4394734881569633,1376,Upregulated,10,5
rpnB,127,895,2.817059185379453,768,Upregulated,10,5
yfcH,1907,2064,0.11413812711049784,157,Upregulated,10,5
folX,662,308,-1.1039008661123162,-354,Downregulated,10,5
yfcG,248,841,1.761765679868269,593,Upregulated,10,5
yfcF,507,894,0.8182890841799771,387,Upregulated,10,5
yfcE,2076,1156,-0.8446650458572021,-920,Downregulated,10,5
yfcD,2943,1323,-1.153474480661718,-1620,Downregulated,10,5
yfcC,1489,2693,0.8548704759195719,1204,Upregulated,10,5
pta,1966,4752,1.2732715144601852,2786,Upregulated,10,5
ackA,2,1,-1.0,-1,Unchanged,10,5
yfbV,1435,1347,-0.09130088610074703,-88,Downregulated,10,5
yfbU,2808,1368,-1.0374747054186628,-1440,Downregulated,10,5
hxpA,4106,2090,-0.9742306851403568,-2016,Downregulated,10,5
yfbS,1499,3405,1.183654414951574,1906,Upregulated,10,5
yfbR,796,862,0.1149194385454494,66,Upregulated,10,5
alaA,4858,2801,-0.7944205065613587,-2057,Downregulated,10,5
lrhA,1614,2427,0.5885335298733533,813,Upregulated,10,5
nuoA,1799,1096,-0.7149473882909556,-703,Downregulated,10,5
nuoB,4216,2742,-0.6206462958579887,-1474,Downregulated,10,5
nuoC,9393,7895,-0.25064674311222684,-1498,Downregulated,10,5
nuoE,2488,1928,-0.3678814339006409,-560,Downregulated,10,5
nuoF,6727,5652,-0.2512017924974152,-1075,Downregulated,10,5
nuoG,10852,10182,-0.09193998201804657,-670,Downregulated,10,5
nuoH,3331,2832,-0.23413408859135365,-499,Downregulated,10,5
nuoI,1099,1533,0.4801663107095463,434,Upregulated,10,5
nuoJ,1365,1481,0.11767068948163283,116,Upregulated,10,5
nuoK,291,389,0.418751002077908,98,Upregulated,10,5
nuoL,4609,5209,0.17655266941405348,600,Upregulated,10,5
nuoM,3547,3878,0.12871347317160373,331,Upregulated,10,5
nuoN,5211,4153,-0.3274063830067539,-1058,Downregulated,10,5
yfbP,59,838,3.8281633843375102,779,Upregulated,10,5
yfbO,30,176,2.5525410230287786,146,Upregulated,10,5
yfbN,19,398,4.3886971071000636,379,Upregulated,10,5
yfbM,173,631,1.8668679673458244,458,Upregulated,10,5
yfbL,28,1046,5.223312214189337,1018,Upregulated,10,5
yfbK,79,2576,5.027136129937515,2497,Upregulated,10,5
elaD,55,415,2.9156078127096277,360,Upregulated,10,5
rbn,411,1558,1.9224849343799864,1147,Upregulated,10,5
elaA,690,784,0.18425729244967684,94,Upregulated,10,5
elaB,9861,641,-3.9433376951827253,-9220,Downregulated,10,5
menF,1610,2641,0.7140236131651136,1031,Upregulated,10,5
menD,1714,4043,1.238059094159195,2329,Upregulated,10,5
menH,147,1329,3.17645304443981,1182,Upregulated,10,5
menB,3115,2260,-0.4629093906088141,-855,Downregulated,10,5
menC,2646,2405,-0.13777616762127248,-241,Downregulated,10,5
menE,1821,3248,0.834820710208338,1427,Upregulated,10,5
pmrD,174,246,0.49957100949051153,72,Upregulated,10,5
arnF,69,400,2.5353317329965557,331,Upregulated,10,5
arnT,173,2970,4.101618988051404,2797,Upregulated,10,5
arnD,129,1585,3.6190398696035158,1456,Upregulated,10,5
arnA,615,3468,2.4954455829952327,2853,Upregulated,10,5
arnC,164,1267,2.9496488045227256,1103,Upregulated,10,5
arnB,326,2036,2.6427936918446178,1710,Upregulated,10,5
ais,34,458,3.7517409468466045,424,Upregulated,10,5
nudI,203,508,1.3233487695869897,305,Upregulated,10,5
yfaZ,155,796,2.3605002152694112,641,Upregulated,10,5
yfaY,1564,2724,0.8004861907047189,1160,Upregulated,10,5
yfaX,17,1011,5.894104440652675,994,Upregulated,10,5
rhmD,49,2224,5.504231228608299,2175,Upregulated,10,5
yfaV,37,2380,6.007292492566356,2343,Upregulated,10,5
yfaU,40,1353,5.0800180290891745,1313,Upregulated,10,5
rpnE,283,1170,2.0476345716388846,887,Upregulated,10,5
glpC,14723,6938,-1.0854799232219399,-7785,Downregulated,10,5
glpB,17244,9755,-0.8218806896821039,-7489,Downregulated,10,5
glpA,27879,16500,-0.7567127892131932,-11379,Downregulated,10,5
glpT,9621,4959,-0.956137629149333,-4662,Downregulated,10,5
glpQ,8403,3497,-1.2647866880979461,-4906,Downregulated,10,5
yfaH,3,106,5.142957953842043,103,Upregulated,10,5
inaA,544,1205,1.1473545898669844,661,Upregulated,10,5
yfaE,201,241,0.26183764505103296,40,Upregulated,10,5
nrdB,2013,2355,0.2263798875788059,342,Upregulated,10,5
nrdA,1142,4666,2.0306236566213562,3524,Upregulated,10,5
yfaL,1171,6569,2.487932689709059,5398,Upregulated,10,5
ubiG,1622,1788,0.14057291696604474,166,Upregulated,10,5
gyrA,16891,12835,-0.39617144681057487,-4056,Downregulated,10,5
yfaA,167,2759,4.046225448879221,2592,Upregulated,10,5
yfaT,17,849,5.642157902302699,832,Upregulated,10,5
yfaQ,111,2774,4.643336205973497,2663,Upregulated,10,5
yfaP,28,1013,5.1770635367435345,985,Upregulated,10,5
atoB,96,1658,4.110265790774594,1562,Upregulated,10,5
atoE,62,2130,5.102441404726325,2068,Upregulated,10,5
atoA,9,989,6.779901709316799,980,Upregulated,10,5
atoD,12,953,6.311369903188786,941,Upregulated,10,5
atoC,286,1897,2.7296326266330864,1611,Upregulated,10,5
atoS,165,2557,3.953914230995833,2392,Upregulated,10,5
rcsC,3070,5008,0.7059959066750766,1938,Upregulated,10,5
rcsB,6121,2103,-1.5413185180747846,-4018,Downregulated,10,5
rcsD,7900,6604,-0.25851253303856964,-1296,Downregulated,10,5
ompC,353442,36375,-3.2804543343829895,-317067,Downregulated,10,5
ftp,341,2012,2.5607866607813548,1671,Upregulated,10,5
ada,613,2311,1.9145582807768495,1698,Upregulated,10,5
alkB,157,1046,2.7360463873553145,889,Upregulated,10,5
yojI,106,2952,4.799556551497197,2846,Upregulated,10,5
mqo,82,3739,5.510884751240085,3657,Upregulated,10,5
eco,1033,860,-0.26443168927559924,-173,Downregulated,10,5
napF,210,1020,2.2801079191927354,810,Upregulated,10,5
napD,41,288,2.812372996824229,247,Upregulated,10,5
napA,1787,7122,1.9947428013215722,5335,Upregulated,10,5
napG,268,1491,2.47597535182567,1223,Upregulated,10,5
napH,250,1942,2.957543200757105,1692,Upregulated,10,5
napB,144,787,2.450294824065174,643,Upregulated,10,5
napC,321,946,1.5592668862170922,625,Upregulated,10,5
ccmA,437,1405,1.68486494560769,968,Upregulated,10,5
ccmB,202,1227,2.6027080509111102,1025,Upregulated,10,5
ccmC,401,1443,1.8473971580362778,1042,Upregulated,10,5
ccmD,39,184,2.2381597371947644,145,Upregulated,10,5
ccmE,332,939,1.4999419163068497,607,Upregulated,10,5
ccmF,792,4796,2.598259323334614,4004,Upregulated,10,5
ccmG,203,921,2.1817214289061595,718,Upregulated,10,5
ccmH,455,1900,2.0620609681322515,1445,Upregulated,10,5
narP,1519,1264,-0.2651254063249806,-255,Downregulated,10,5
insH8,7246,3927,-0.8837572077868905,-3319,Downregulated,10,5
yejM,1918,3987,1.0557008849792,2069,Upregulated,10,5
yejL,277,210,-0.3994966483830657,-67,Downregulated,10,5
yejK,3066,2200,-0.47885417324675567,-866,Downregulated,10,5
rplY,9196,1156,-2.991865068217501,-8040,Downregulated,10,5
radD,504,3226,2.6782507996557263,2722,Upregulated,10,5
rsuA,1416,1479,0.06280078701607025,63,Upregulated,10,5
bcr,1387,2263,0.7062687969432897,876,Upregulated,10,5
yejG,163,505,1.6314114234080794,342,Upregulated,10,5
yejF,716,2588,1.8538061247282511,1872,Upregulated,10,5
yejE,272,1356,2.3176786218860044,1084,Upregulated,10,5
yejB,322,1590,2.3038941720571007,1268,Upregulated,10,5
yejA,1017,2815,1.4688152431100918,1798,Upregulated,10,5
pdeN,611,2480,2.021095835455508,1869,Upregulated,10,5
mepS,8428,1858,-2.1814398124346535,-6570,Downregulated,10,5
lpxT,494,771,0.6422198183303567,277,Upregulated,10,5
yeiR,757,1704,1.1705601302401067,947,Upregulated,10,5
yeiQ,90,2504,4.798165750602943,2414,Upregulated,10,5
yeiP,1136,542,-1.0675980781508105,-594,Downregulated,10,5
setB,91,1872,4.362570079384708,1781,Upregulated,10,5
fruB,12073,3052,-1.9839573462841358,-9021,Downregulated,10,5
fruK,8840,2580,-1.7766753039681773,-6260,Downregulated,10,5
fruA,22641,5623,-2.009525728050357,-17018,Downregulated,10,5
psuK,40,977,4.610286657081023,937,Upregulated,10,5
psuG,83,1428,4.104740832682175,1345,Upregulated,10,5
psuT,211,2147,3.3470072871515884,1936,Upregulated,10,5
yeiL,35,501,3.839383776250242,466,Upregulated,10,5
rihB,21,1173,5.803669875249748,1152,Upregulated,10,5
nupX,52,1823,5.131659127898042,1771,Upregulated,10,5
yeiI,661,1942,1.5548210239115006,1281,Upregulated,10,5
nfo,985,1790,0.8617639578078801,805,Upregulated,10,5
yeiH,1807,1907,0.07770833744815672,100,Upregulated,10,5
yeiE,1258,1735,0.46380374058633406,477,Upregulated,10,5
lysP,3826,2848,-0.4258877273797146,-978,Downregulated,10,5
cirA,218,3231,3.8895807104884375,3013,Upregulated,10,5
yeiG,3311,3785,0.19302628947609457,474,Upregulated,10,5
folE,6927,1649,-2.0706392750578044,-5278,Downregulated,10,5
yeiB,1356,2163,0.6736764868256349,807,Upregulated,10,5
galS,218,1860,3.092902581218467,1642,Upregulated,10,5
mglB,126,1676,3.733526510199435,1550,Upregulated,10,5
mglA,30,1812,5.916476644437717,1782,Upregulated,10,5
mglC,34,1684,5.630213581816057,1650,Upregulated,10,5
preA,1569,2762,0.8158679672899533,1193,Upregulated,10,5
preT,2219,3272,0.5602630807447375,1053,Upregulated,10,5
yeiS,54,189,1.8073549220576042,135,Upregulated,10,5
sanA,314,929,1.5649140374910258,615,Upregulated,10,5
cdd,632,2438,1.9477016624431092,1806,Upregulated,10,5
yohK,185,1505,3.0241663111307524,1320,Upregulated,10,5
yohJ,86,802,3.2211936717528222,716,Upregulated,10,5
dusC,165,2308,3.806105294399667,2143,Upregulated,10,5
mdtQ,39,3047,6.2877715658242375,3008,Upregulated,10,5
yohF,287,1591,2.47081119365536,1304,Upregulated,10,5
yohD,419,1101,1.3937923198650173,682,Upregulated,10,5
yohC,377,1073,1.5090136474878577,696,Upregulated,10,5
pbpG,1595,1746,0.13049713497720836,151,Upregulated,10,5
dld,4718,4521,-0.0615335009204825,-197,Downregulated,10,5
bglX,3112,6246,1.0050905090343814,3134,Upregulated,10,5
osmF,919,1761,0.9382581425421738,842,Upregulated,10,5
yehY,448,2612,2.543584259488827,2164,Upregulated,10,5
yehX,252,2102,3.060267030462262,1850,Upregulated,10,5
yehW,135,1352,3.3240638392313535,1217,Upregulated,10,5
mlrA,430,1274,1.5669567126668402,844,Upregulated,10,5
btsS,453,3196,2.8186844528817416,2743,Upregulated,10,5
btsR,363,1122,1.628031222613042,759,Upregulated,10,5
yehS,271,770,1.5065655942283922,499,Upregulated,10,5
yehR,16,435,4.764871590736091,419,Upregulated,10,5
yehQ,123,3454,4.8115378621896845,3331,Upregulated,10,5
yehP,32,1860,5.861086905995394,1828,Upregulated,10,5
yehM,68,4365,6.004303097266463,4297,Upregulated,10,5
yehL,22,1949,6.469086756620593,1927,Upregulated,10,5
yehI,305,5956,4.287462606131851,5651,Upregulated,10,5
metG,10395,6258,-0.7321161945048105,-4137,Downregulated,10,5
mrp,6457,4014,-0.6858234103847323,-2443,Downregulated,10,5
yehE,273,95,-1.5229015325889046,-178,Downregulated,10,5
yehD,115,218,0.9226942738325511,103,Upregulated,10,5
yehC,16,387,4.59618975614441,371,Upregulated,10,5
yehB,89,2652,4.89713162914619,2563,Upregulated,10,5
yehA,18,434,4.5916262310021665,416,Upregulated,10,5
rcnB,1118,456,-1.2938144586784484,-662,Downregulated,10,5
rcnA,78,1094,3.809994803930308,1016,Upregulated,10,5
rcnR,115,276,1.2630344058337937,161,Upregulated,10,5
thiM,194,1102,2.50599566638403,908,Upregulated,10,5
thiD,232,1166,2.329371078072924,934,Upregulated,10,5
yegX,154,1141,2.8892965355937803,987,Upregulated,10,5
yegW,332,1003,1.595066459265256,671,Upregulated,10,5
yegV,288,1793,2.6382347714260623,1505,Upregulated,10,5
yegU,323,1996,2.627505650643336,1673,Upregulated,10,5
yegT,140,2037,3.8629472480209217,1897,Upregulated,10,5
fbaB,28402,3261,-3.1226061781960226,-25141,Downregulated,10,5
gatY,63081,52673,-0.2601419000437396,-10408,Downregulated,10,5
gatZ,94167,68585,-0.45732848476521315,-25582,Downregulated,10,5
gatA,12288,8185,-0.5861957993596403,-4103,Downregulated,10,5
gatB,6011,1944,-1.6285768011158377,-4067,Downregulated,10,5
gatC,39885,22508,-0.825408409408629,-17377,Downregulated,10,5
gatD,5237,6935,0.405155277761614,1698,Upregulated,10,5
insF5,30,675,4.491853096329675,645,Upregulated,10,5
insE5,80,103,0.3645724322958561,23,Upregulated,10,5
yegS,830,1382,0.7355743741539715,552,Upregulated,10,5
yegR,26,87,1.7425037777076362,61,Upregulated,10,5
yegZ,5,57,3.5109619192773796,52,Upregulated,10,5
ogrK,95,130,0.4525122046975067,35,Upregulated,10,5
trhP,1783,3475,0.9627062748732371,1692,Upregulated,10,5
yegP,396,276,-0.5208321633014404,-120,Downregulated,10,5
baeR,709,1435,1.017193204323534,726,Upregulated,10,5
baeS,206,2176,3.400962314067121,1970,Upregulated,10,5
mdtD,195,2620,3.748020782675202,2425,Upregulated,10,5
mdtC,498,6795,3.7702559035866727,6297,Upregulated,10,5
mdtB,687,7160,3.3815775833335184,6473,Upregulated,10,5
mdtA,358,2090,2.5454714497039888,1732,Upregulated,10,5
yegL,54,1058,4.292236409950557,1004,Upregulated,10,5
pphC,23,1372,5.898502810115799,1349,Upregulated,10,5
yegJ,19,339,4.157213949692759,320,Upregulated,10,5
yegI,167,3354,4.327962681090294,3187,Upregulated,10,5
yegD,419,2672,2.6728978587747005,2253,Upregulated,10,5
alkA,316,1378,2.1245794245271883,1062,Upregulated,10,5
dgcE,1170,6681,2.5135555290381792,5511,Upregulated,10,5
udk,1166,1154,-0.014924564555013892,-12,Downregulated,10,5
dcd,3006,2147,-0.4855228180575914,-859,Downregulated,10,5
asmA,3564,4666,0.38868897046227724,1102,Upregulated,10,5
yegH,1224,3651,1.5766881107422328,2427,Upregulated,10,5
wza,169,1416,3.0667261138008133,1247,Upregulated,10,5
wzb,37,533,3.848538357130226,496,Upregulated,10,5
wzc,342,3733,3.448267278417172,3391,Upregulated,10,5
wcaA,129,1122,3.1206297051855385,993,Upregulated,10,5
wcaB,60,557,3.2146429217315133,497,Upregulated,10,5
wcaC,155,1827,3.559136513353251,1672,Upregulated,10,5
wcaD,137,944,2.7846109664013143,807,Upregulated,10,5
wcaE,64,682,3.4136279290241727,618,Upregulated,10,5
wcaF,31,426,3.780513309838963,395,Upregulated,10,5
gmd,291,1452,2.318950395087467,1161,Upregulated,10,5
fcl,241,1314,2.446860224092368,1073,Upregulated,10,5
gmm,66,437,2.727095350142145,371,Upregulated,10,5
wcaI,137,1658,3.5971962085352236,1521,Upregulated,10,5
cpsB,146,2095,3.842909969706697,1949,Upregulated,10,5
cpsG,135,1835,3.764748750679744,1700,Upregulated,10,5
wcaJ,108,1972,4.190556334214443,1864,Upregulated,10,5
wzxC,103,1853,4.1691466388440475,1750,Upregulated,10,5
wcaK,198,1800,3.1844245711374275,1602,Upregulated,10,5
wcaL,283,1732,2.6135649718948426,1449,Upregulated,10,5
wcaM,260,1368,2.3954847018574434,1108,Upregulated,10,5
galF,12704,2315,-2.456198718995359,-10389,Downregulated,10,5
rfbB,4733,1652,-1.5185412353189183,-3081,Downregulated,10,5
rfbD,3083,1511,-1.028831228942346,-1572,Downregulated,10,5
rfbA,3124,1145,-1.448046855157673,-1979,Downregulated,10,5
rfbC,1192,395,-1.5934596773976963,-797,Downregulated,10,5
rfbX,1662,601,-1.467483486059159,-1061,Downregulated,10,5
glf,2686,1029,-1.3842163225334738,-1657,Downregulated,10,5
wbbH,987,513,-0.9440912588493436,-474,Downregulated,10,5
wbbI,2331,592,-1.9772799234999165,-1739,Downregulated,10,5
wbbJ,1085,583,-0.8961272541313453,-502,Downregulated,10,5
wbbK,1597,283,-2.4964903545793504,-1314,Downregulated,10,5
insH7,2926,2885,-0.02035845060564203,-41,Downregulated,10,5
gnd,40426,5825,-2.7949535065669906,-34601,Downregulated,10,5
ugd,1130,905,-0.3203330753319823,-225,Downregulated,10,5
wzzB,6004,2255,-1.412796543477945,-3749,Downregulated,10,5
hisI,1914,1093,-0.808297428814121,-821,Downregulated,10,5
hisF,1889,1433,-0.39858409212622414,-456,Downregulated,10,5
hisA,1544,1471,-0.06987550601325024,-73,Downregulated,10,5
hisH,1302,1105,-0.23668307888684156,-197,Downregulated,10,5
hisB,3244,2322,-0.4824058473517066,-922,Downregulated,10,5
hisC,2844,2568,-0.1472762624971122,-276,Downregulated,10,5
hisD,3180,3383,0.0892764116222706,203,Upregulated,10,5
hisG,2132,2193,0.04069837391441764,61,Upregulated,10,5
hisL,1,1,0.0,0,Unchanged,10,5
yefM,295,285,-0.049753035197099615,-10,Downregulated,10,5
yeeZ,3853,2428,-0.6662137644038679,-1425,Downregulated,10,5
yeeY,311,1361,2.129680581373392,1050,Upregulated,10,5
plaP,1482,1908,0.36451572369967766,426,Upregulated,10,5
yeeE,251,2267,3.175025121790014,2016,Upregulated,10,5
yeeD,97,310,1.67621156308711,213,Upregulated,10,5
sbcB,2188,2526,0.20724190099499581,338,Upregulated,10,5
dacD,369,1468,1.9921592467828166,1099,Upregulated,10,5
sbmC,870,514,-0.7592470415422125,-356,Downregulated,10,5
yeeA,580,1031,0.829919527353174,451,Upregulated,10,5
yeeX,6484,1324,-2.291980968710324,-5160,Downregulated,10,5
yeeW,6,27,2.169925001442312,21,Upregulated,10,5
cbtA,9,194,4.429987840744816,185,Upregulated,10,5
cbeA,17,318,4.225420114034016,301,Upregulated,10,5
yeeT,5,88,4.137503523749935,83,Upregulated,10,5
yeeS,81,450,2.473931188332412,369,Upregulated,10,5
yeeR,1122,2184,0.9609001803110596,1062,Upregulated,10,5
flu,38462,25731,-0.5799262573462889,-12731,Downregulated,10,5
yeeP,83,557,2.746494085993107,474,Upregulated,10,5
insC3,233,153,-0.6067983019616285,-80,Downregulated,10,5
insD3,456,438,-0.05810295456356828,-18,Downregulated,10,5
insH6,511,1656,1.6963074765617039,1145,Upregulated,10,5
cobU,194,535,1.4634822391013815,341,Upregulated,10,5
cobS,373,1097,1.556315990147955,724,Upregulated,10,5
cobT,829,1589,0.9386751178527688,760,Upregulated,10,5
ldtA,1397,1039,-0.4271363665052513,-358,Downregulated,10,5
nac,79,638,3.0136318655877665,559,Upregulated,10,5
cbl,117,875,2.902774487136287,758,Upregulated,10,5
yeeO,650,1648,1.3422046192674015,998,Upregulated,10,5
yeeN,1875,761,-1.30092223676706,-1114,Downregulated,10,5
amn,4097,2585,-0.6644036122780042,-1512,Downregulated,10,5
shiA,1386,1416,0.030894007945783775,30,Upregulated,10,5
yeeJ,1294,7180,2.472146226717906,5886,Upregulated,10,5
mtfA,1449,900,-0.6870606883398924,-549,Downregulated,10,5
yodB,70,270,1.9475325801058645,200,Upregulated,10,5
zinT,51,190,1.8974302663594522,139,Upregulated,10,5
msrQ,194,536,1.4661763482706447,342,Upregulated,10,5
msrP,476,1049,1.1399811992693243,573,Upregulated,10,5
hiuH,31,173,2.4804319172498497,142,Upregulated,10,5
hprR,378,491,0.3773367900936203,113,Upregulated,10,5
hprS,416,747,0.8445247146481449,331,Upregulated,10,5
hchA,6245,911,-2.7771786126932687,-5334,Downregulated,10,5
drpB,486,353,-0.4612881303346007,-133,Downregulated,10,5
yedJ,1422,1072,-0.40761655916164274,-350,Downregulated,10,5
dcm,2938,2402,-0.2905982448506457,-536,Downregulated,10,5
vsr,225,410,0.865698908288409,185,Upregulated,10,5
yedA,31,882,4.830438535170646,851,Upregulated,10,5
yedI,806,1206,0.5813781633721175,400,Upregulated,10,5
yodC,133,80,-0.7333543406138273,-53,Downregulated,10,5
dgcQ,1065,2066,0.9559868237518588,1001,Upregulated,10,5
yedP,900,874,-0.04229172171643864,-26,Downregulated,10,5
dsrA,1,1,0.0,0,Unchanged,10,5
yodD,312,101,-1.6271907361104536,-211,Downregulated,10,5
dsrB,115,50,-1.2016338611696507,-65,Downregulated,10,5
rcsA,605,214,-1.49932434576081,-391,Downregulated,10,5
fliR,70,733,3.3883863711888456,663,Upregulated,10,5
fliQ,39,187,2.261492241025388,148,Upregulated,10,5
fliP,195,683,1.8084114545404797,488,Upregulated,10,5
fliO,160,315,0.9772799234999164,155,Upregulated,10,5
fliN,343,301,-0.1884450894131103,-42,Downregulated,10,5
fliM,895,1085,0.277735455180223,190,Upregulated,10,5
fliL,388,325,-0.25561693427131077,-63,Downregulated,10,5
fliK,341,1315,1.9472191551554923,974,Upregulated,10,5
fliJ,128,315,1.2992080183872787,187,Upregulated,10,5
fliI,526,1813,1.7852442204518557,1287,Upregulated,10,5
fliH,546,839,0.6197698595199709,293,Upregulated,10,5
fliG,755,1299,0.78285288123544,544,Upregulated,10,5
fliF,1100,2147,0.9648186674467513,1047,Upregulated,10,5
fliE,356,213,-0.7410238107405596,-143,Downregulated,10,5
intG,1,14,3.807354922057604,13,Upregulated,10,5
yedL,77,406,2.398549376490275,329,Upregulated,10,5
yedK,102,706,2.7910990312996846,604,Upregulated,10,5
yedF,150,110,-0.4474589769712214,-40,Downregulated,10,5
yedE,1585,1795,0.17950100368364416,210,Upregulated,10,5
yedD,1123,564,-0.9935908600018076,-559,Downregulated,10,5
amyA,977,1698,0.7974059915846532,721,Upregulated,10,5
fliT,50,268,2.4222330006830477,218,Upregulated,10,5
fliS,97,263,1.4390061471051747,166,Upregulated,10,5
fliD,453,1915,2.079761436766084,1462,Upregulated,10,5
fliC,4914,1763,-1.4788653830419831,-3151,Downregulated,10,5
fliA,2101,761,-1.4651078031695006,-1340,Downregulated,10,5
fliZ,827,527,-0.6500843675340601,-300,Downregulated,10,5
tcyJ,4462,4044,-0.14190751634112583,-418,Downregulated,10,5
dcyD,2511,2486,-0.01443573221901491,-25,Downregulated,10,5
tcyL,929,1102,0.24637372218850462,173,Upregulated,10,5
tcyN,1082,1431,0.4033231728998524,349,Upregulated,10,5
sdiA,168,686,2.029747343394052,518,Upregulated,10,5
yecF,153,71,-1.1076407231879697,-82,Downregulated,10,5
uvrY,2317,1116,-1.0539210170356341,-1201,Downregulated,10,5
uvrC,3224,3042,-0.08383159080347061,-182,Downregulated,10,5
pgsA,1305,840,-0.6355885737911242,-465,Downregulated,10,5
yecA,2045,1225,-0.7393190939391782,-820,Downregulated,10,5
tyrP,643,1570,1.287873916451042,927,Upregulated,10,5
yecH,461,271,-0.7664738990754665,-190,Downregulated,10,5
ftnA,20910,1511,-3.7906174963121124,-19399,Downregulated,10,5
yecR,63,203,1.6880559936852597,140,Upregulated,10,5
ftnB,1587,552,-1.5235619560570128,-1035,Downregulated,10,5
araF,121,1145,3.2422686457097116,1024,Upregulated,10,5
araG,171,2094,3.6141932120449107,1923,Upregulated,10,5
otsB,2591,1202,-1.108072119468909,-1389,Downregulated,10,5
otsA,8145,2323,-1.8099255446040725,-5822,Downregulated,10,5
uspC,284,318,0.1631358357796734,34,Upregulated,10,5
insA5,26,90,1.7914133781885826,64,Upregulated,10,5
insB5,32,769,4.586839787961827,737,Upregulated,10,5
flhD,773,319,-1.276911990159978,-454,Downregulated,10,5
flhC,1344,571,-1.2349704874159175,-773,Downregulated,10,5
motA,183,1257,2.780069096136465,1074,Upregulated,10,5
motB,154,1315,3.0940605434847632,1161,Upregulated,10,5
cheA,517,2872,2.473819563508117,2355,Upregulated,10,5
cheW,188,540,1.5222267453731935,352,Upregulated,10,5
tar,475,2445,2.363835046621286,1970,Upregulated,10,5
tap,282,2352,3.0601209924375707,2070,Upregulated,10,5
cheR,124,1158,3.2232232276023614,1034,Upregulated,10,5
cheB,99,1349,3.768318012868658,1250,Upregulated,10,5
cheY,95,346,1.864772619305777,251,Upregulated,10,5
cheZ,243,875,1.8483267031139103,632,Upregulated,10,5
flhB,506,1618,1.6770023177356674,1112,Upregulated,10,5
flhA,997,3210,1.6869078876114694,2213,Upregulated,10,5
flhE,96,337,1.8116422804607022,241,Upregulated,10,5
yecT,35,172,2.2969817377571315,137,Upregulated,10,5
argS,4800,3297,-0.5418805188254936,-1503,Downregulated,10,5
yecM,543,764,0.4926204402313871,221,Upregulated,10,5
cutC,936,1099,0.23161095136582666,163,Upregulated,10,5
torY,13,938,6.173004394374285,925,Upregulated,10,5
torZ,328,3126,3.2525500583815807,2798,Upregulated,10,5
cmoB,1181,1623,0.4586540351508142,442,Upregulated,10,5
cmoA,1152,1150,-0.0025068556105748664,-2,Unchanged,10,5
yecN,669,469,-0.5124182881260844,-200,Downregulated,10,5
yecE,315,803,1.3500481591300355,488,Upregulated,10,5
yecD,866,874,0.013266254773873592,8,Unchanged,10,5
aspS,9753,8775,-0.1524469313322267,-978,Downregulated,10,5
nudB,978,810,-0.27191255718024665,-168,Downregulated,10,5
yebC,2981,2288,-0.38170932321277934,-693,Downregulated,10,5
ruvC,1283,1176,-0.12563311025331814,-107,Downregulated,10,5
yebB,37,434,3.5520978668155294,397,Upregulated,10,5
ruvA,769,747,-0.04187535517258934,-22,Downregulated,10,5
ruvB,2052,1825,-0.16913426695231218,-227,Downregulated,10,5
znuB,644,963,0.5804751097288424,319,Upregulated,10,5
znuC,759,939,0.30702527223830817,180,Upregulated,10,5
znuA,1247,1272,0.028637205454685438,25,Upregulated,10,5
mepM,4091,3182,-0.3625197015569986,-909,Downregulated,10,5
lpxM,1591,1727,0.11833424719787643,136,Upregulated,10,5
pykA,39109,14137,-1.4680246478466752,-24972,Downregulated,10,5
yebK,829,1338,0.6906341091457104,509,Upregulated,10,5
zwf,5426,2890,-0.908819554893825,-2536,Downregulated,10,5
edd,3784,2938,-0.3650776927831154,-846,Downregulated,10,5
eda,9402,2647,-1.828609485698338,-6755,Downregulated,10,5
purT,3466,1840,-0.9135658882157943,-1626,Downregulated,10,5
yebG,1595,615,-1.3748981084256295,-980,Downregulated,10,5
yebF,1866,906,-1.0423660308055236,-960,Downregulated,10,5
yebE,617,1215,0.9776139193437254,598,Upregulated,10,5
ptrB,1446,2692,0.8966108576591993,1246,Upregulated,10,5
exoX,1039,965,-0.10659480674876895,-74,Downregulated,10,5
yobB,1053,749,-0.4914678125669659,-304,Downregulated,10,5
holE,509,130,-1.9691540330472408,-379,Downregulated,10,5
yobA,1006,736,-0.4508526337485142,-270,Downregulated,10,5
yebZ,1348,2008,0.5749387727689135,660,Upregulated,10,5
yebY,664,333,-0.9956610642756626,-331,Downregulated,10,5
pphA,105,590,2.490325626583081,485,Upregulated,10,5
yebW,76,48,-0.6629650127224294,-28,Downregulated,10,5
yebV,517,89,-2.538287039348537,-428,Downregulated,10,5
rsmF,596,1844,1.6294544199671765,1248,Upregulated,10,5
letB,2046,3532,0.7876791979031373,1486,Upregulated,10,5
letA,828,1540,0.8952276780829385,712,Upregulated,10,5
msrC,4221,843,-2.3239802930156066,-3378,Downregulated,10,5
proQ,9926,2443,-2.022558591029864,-7483,Downregulated,10,5
prc,14880,4310,-1.7876147520189332,-10570,Downregulated,10,5
htpX,5623,4150,-0.4382287104191545,-1473,Downregulated,10,5
yebQ,59,1292,4.452747305332084,1233,Upregulated,10,5
kdgR,2476,1831,-0.4353795234169275,-645,Downregulated,10,5
mgrB,45,11,-2.0324214776923775,-34,Downregulated,10,5
yebO,760,220,-1.7884958948062881,-540,Downregulated,10,5
yobF,1076,53,-4.343541907993425,-1023,Downregulated,10,5
cspC,8006,425,-4.235546869362475,-7581,Downregulated,10,5
rlmA,545,971,0.8332150657549035,426,Upregulated,10,5
mntP,177,656,1.8899464545350864,479,Upregulated,10,5
yobD,853,446,-0.9355020313979854,-407,Downregulated,10,5
manZ,23603,10209,-1.2091286842324276,-13394,Downregulated,10,5
manY,23378,10298,-1.1827873365932655,-13080,Downregulated,10,5
manX,24692,11537,-1.0977755719525577,-13155,Downregulated,10,5
yoaE,1632,2503,0.6170172337168363,871,Upregulated,10,5
pdeD,324,1715,2.40414285817555,1391,Upregulated,10,5
sdaA,1818,2541,0.4830441758592477,723,Upregulated,10,5
nudL,547,694,0.34339482978570424,147,Upregulated,10,5
pabB,1206,1971,0.7086978691434009,765,Upregulated,10,5
yoaH,124,85,-0.5448053742491735,-39,Downregulated,10,5
yoaC,291,174,-0.7419318470595556,-117,Downregulated,10,5
yoaB,2553,549,-2.21731548340192,-2004,Downregulated,10,5
yoaA,2064,3174,0.6208591574119279,1110,Upregulated,10,5
tsaB,661,1159,0.8101583894987802,498,Upregulated,10,5
yeaY,919,821,-0.16268263951122966,-98,Downregulated,10,5
fadD,671,2176,1.6972938850501558,1505,Upregulated,10,5
rnd,994,1599,0.6858521819180459,605,Upregulated,10,5
yeaX,155,953,2.6202079986357045,798,Upregulated,10,5
yeaW,107,1439,3.7493838903391508,1332,Upregulated,10,5
yeaV,86,1656,4.267222202797227,1570,Upregulated,10,5
dmlA,87244,1543,-5.8212459497692866,-85701,Downregulated,10,5
dmlR,1036,1117,0.10860518279676099,81,Upregulated,10,5
leuE,629,481,-0.38702312310924736,-148,Downregulated,10,5
yeaR,28,246,3.1351595832816357,218,Upregulated,10,5
yoaG,2,16,3.0,14,Upregulated,10,5
yeaQ,2365,186,-3.668465657118726,-2179,Downregulated,10,5
dgcP,2402,1469,-0.7094017551493541,-933,Downregulated,10,5
yoaF,80,152,0.925999418556223,72,Upregulated,10,5
yeaO,358,340,-0.07442484112655467,-18,Downregulated,10,5
nimT,144,1366,3.245816766847778,1222,Upregulated,10,5
nimR,279,908,1.7024271754617275,629,Upregulated,10,5
yeaL,294,508,0.7890123419358014,214,Upregulated,10,5
yoaI,1,1,0.0,0,Unchanged,10,5
yeaK,1322,1063,-0.31458057997658706,-259,Downregulated,10,5
dgcJ,427,1152,1.431832741821822,725,Upregulated,10,5
cdgI,122,762,2.6429098499304358,640,Upregulated,10,5
yeaH,733,1323,0.851927958144865,590,Upregulated,10,5
yeaG,2926,2511,-0.220667740866987,-415,Downregulated,10,5
mipA,4677,1445,-1.6945139360308996,-3232,Downregulated,10,5
yeaE,704,1153,0.7117451790144745,449,Upregulated,10,5
yeaD,11466,1765,-2.69962209554007,-9701,Downregulated,10,5
gapA,318154,45160,-2.8166078688035605,-272994,Downregulated,10,5
msrB,802,753,-0.09095237178299216,-49,Downregulated,10,5
yeaC,448,415,-0.11038739582331702,-33,Downregulated,10,5
ydjL,137,1262,3.203464112022022,1125,Upregulated,10,5
ydjK,106,1349,3.6697541783850687,1243,Upregulated,10,5
ydjJ,99,1112,3.4895844526438977,1013,Upregulated,10,5
ydjI,154,755,2.2935462935175397,601,Upregulated,10,5
ydjH,101,849,3.0714092608012438,748,Upregulated,10,5
ydjG,190,944,2.3127874410308937,754,Upregulated,10,5
ydjF,463,574,0.3100385434154514,111,Upregulated,10,5
ydjE,45,1157,4.6843200527778155,1112,Upregulated,10,5
pncA,444,792,0.8349407537295036,348,Upregulated,10,5
ansA,561,1260,1.167351057778486,699,Upregulated,10,5
sppA,1986,2726,0.45691993927683555,740,Upregulated,10,5
ydjA,1447,1795,0.31091892217868905,348,Upregulated,10,5
selD,6696,4166,-0.6846366885096968,-2530,Downregulated,10,5
topB,5499,5407,-0.024340930179042635,-92,Downregulated,10,5
ynjI,130,717,2.4634614956734504,587,Upregulated,10,5
gdhA,22177,12819,-0.7907804948627224,-9358,Downregulated,10,5
ynjH,44,145,1.7204774713776372,101,Upregulated,10,5
nudG,113,442,1.9677235969762439,329,Upregulated,10,5
ynjF,329,823,1.3228048466863842,494,Upregulated,10,5
ynjE,3862,2603,-0.5691728525465383,-1259,Downregulated,10,5
ynjD,428,825,0.9467833227320311,397,Upregulated,10,5
ynjC,1098,2504,1.1893565079274198,1406,Upregulated,10,5
ynjB,2106,2311,0.13401182344191415,205,Upregulated,10,5
ynjA,767,900,0.23069842371410365,133,Upregulated,10,5
ydjZ,1499,1177,-0.3488860629094155,-322,Downregulated,10,5
ydjY,2364,1050,-1.1708407076240475,-1314,Downregulated,10,5
ydjX,1211,919,-0.39806209840529433,-292,Downregulated,10,5
xthA,1677,1280,-0.38973887867698387,-397,Downregulated,10,5
astC,47,2311,5.619712692789993,2264,Upregulated,10,5
astA,31,1997,6.009422307057098,1966,Upregulated,10,5
astD,104,2929,4.815752759738275,2825,Upregulated,10,5
astB,112,2427,4.43760347109353,2315,Upregulated,10,5
astE,34,1527,5.489021505546512,1493,Upregulated,10,5
spy,1578,1880,0.25263545655154107,302,Upregulated,10,5
ves,45,807,4.1645717669481055,762,Upregulated,10,5
cho,1004,1495,0.5743862151346953,491,Upregulated,10,5
nadE,6223,2659,-1.2267264690297064,-3564,Downregulated,10,5
osmE,9861,1027,-3.2632977754832715,-8834,Downregulated,10,5
chbB,57,168,1.5594274086140185,111,Upregulated,10,5
chbC,67,1759,4.714450577014189,1692,Upregulated,10,5
chbA,79,378,2.2584616760439697,299,Upregulated,10,5
chbR,236,738,1.6448339566985548,502,Upregulated,10,5
chbF,158,1477,3.224673362587686,1319,Upregulated,10,5
chbG,370,1035,1.4840335918703755,665,Upregulated,10,5
katE,10012,3934,-1.3476613334098018,-6078,Downregulated,10,5
cedA,98,192,0.970252656605948,94,Upregulated,10,5
ydjO,10,181,4.177917792195843,171,Upregulated,10,5
tcyP,1608,4421,1.4591053277751376,2813,Upregulated,10,5
ydjM,149,714,2.260611743566938,565,Upregulated,10,5
hxpB,873,995,0.18871487180157107,122,Upregulated,10,5
yniB,1201,781,-0.6208416975636547,-420,Downregulated,10,5
yniA,3329,2044,-0.7036936742026417,-1285,Downregulated,10,5
ydiZ,485,236,-1.0391978877126489,-249,Downregulated,10,5
pfkB,5287,3339,-0.6630332333178263,-1948,Downregulated,10,5
ydiY,68,803,3.561793336266975,735,Upregulated,10,5
thrS,43564,13497,-1.6904976541053067,-30067,Downregulated,10,5
infC,37449,8442,-2.1492704605293826,-29007,Downregulated,10,5
rpmI,4477,1441,-1.6354619827287968,-3036,Downregulated,10,5
rplT,29138,6390,-2.1890140195284826,-22748,Downregulated,10,5
pheM,1,1,0.0,0,Unchanged,10,5
pheS,4551,2685,-0.7612614980954147,-1866,Downregulated,10,5
pheT,14837,8307,-0.8367999529957835,-6530,Downregulated,10,5
ihfA,4496,856,-2.392959333819779,-3640,Downregulated,10,5
btuC,858,1462,0.7688937584528917,604,Upregulated,10,5
btuE,1235,640,-0.9483672315846776,-595,Downregulated,10,5
btuD,992,1084,0.1279527309669964,92,Upregulated,10,5
nlpC,1156,574,-1.010018755824991,-582,Downregulated,10,5
rflP,650,520,-0.3219280948873623,-130,Downregulated,10,5
ydiU,550,2041,1.8917726586206973,1491,Upregulated,10,5
ydiE,1,74,6.20945336562895,73,Upregulated,10,5
aroH,2082,1991,-0.0644768475789144,-91,Downregulated,10,5
ppsR,933,1058,0.18139064126226692,125,Upregulated,10,5
ppsA,2893,4128,0.5128766474936545,1235,Upregulated,10,5
fadK,113,1821,4.010336244561651,1708,Upregulated,10,5
ydiT,12,102,3.0874628412503395,90,Upregulated,10,5
ydiS,118,1558,3.722836468699828,1440,Upregulated,10,5
ydiR,136,1197,3.1377445956931624,1061,Upregulated,10,5
ydiQ,54,838,3.955918931535883,784,Upregulated,10,5
ydiP,448,659,0.5567797329504476,211,Upregulated,10,5
ydiO,62,1285,4.373356333694366,1223,Upregulated,10,5
ydiF,35,1628,5.53960196732128,1593,Upregulated,10,5
aroD,969,1127,0.21791894475713997,158,Upregulated,10,5
ydiB,46,788,4.098489863399363,742,Upregulated,10,5
ydiN,33,1220,5.208271313091795,1187,Upregulated,10,5
ydiM,17,982,5.852116373064353,965,Upregulated,10,5
ydiL,13,279,4.423681593688095,266,Upregulated,10,5
ydiK,2717,2239,-0.2791600373693775,-478,Downregulated,10,5
ydiJ,20150,10845,-0.8937497857430559,-9305,Downregulated,10,5
menI,1683,865,-0.960263138805862,-818,Downregulated,10,5
ydiH,1107,400,-1.4685833170068274,-707,Downregulated,10,5
sufA,250,384,0.6191782160590692,134,Upregulated,10,5
sufB,1808,2407,0.4128414640593092,599,Upregulated,10,5
sufC,839,953,0.18380540347011853,114,Upregulated,10,5
sufD,1622,1911,0.23655395876018365,289,Upregulated,10,5
sufS,1259,1702,0.4349527539669462,443,Upregulated,10,5
sufE,296,350,0.24175774620337906,54,Upregulated,10,5
ldtE,3764,1416,-1.4104453626455393,-2348,Downregulated,10,5
lpp,50412,2420,-4.380688239045717,-47992,Downregulated,10,5
pykF,35641,6452,-2.465719472344591,-29189,Downregulated,10,5
fumD,568,150,-1.9209284290088013,-418,Downregulated,10,5
ydhY,1114,502,-1.1499899633892599,-612,Downregulated,10,5
ydhV,3625,2378,-0.6082322800440033,-1247,Downregulated,10,5
ydhW,684,751,0.1348165826283738,67,Upregulated,10,5
ydhX,496,720,0.5376567859427995,224,Upregulated,10,5
ydhU,539,787,0.5460783627549809,248,Upregulated,10,5
ydhT,346,1073,1.6328061331197974,727,Upregulated,10,5
ydhS,1414,1831,0.37284967098793814,417,Upregulated,10,5
ydhR,3473,845,-2.039159164212545,-2628,Downregulated,10,5
ydhQ,7311,2816,-1.3764214178071996,-4495,Downregulated,10,5
mdtK,1116,2488,1.1566494583014149,1372,Upregulated,10,5
ribC,4026,1281,-1.6520766965796931,-2745,Downregulated,10,5
cfa,31218,7370,-2.0826415887154166,-23848,Downregulated,10,5
ydhC,342,1701,2.314314910777487,1359,Upregulated,10,5
ydhB,575,1302,1.179095587333898,727,Upregulated,10,5
purR,3336,1999,-0.7388408167000359,-1337,Downregulated,10,5
ydhP,328,1712,2.383914981783063,1384,Upregulated,10,5
sodB,19516,8797,-1.1495738712222052,-10719,Downregulated,10,5
mepH,795,937,0.23709418748746908,142,Upregulated,10,5
grxD,2100,614,-1.7740787671833054,-1486,Downregulated,10,5
lhr,3450,10768,1.6420820480574232,7318,Upregulated,10,5
rnt,733,1343,0.8735742012936304,610,Upregulated,10,5
gloA,2760,1116,-1.3063312398363438,-1644,Downregulated,10,5
nemA,1073,1992,0.8925675713115591,919,Upregulated,10,5
nemR,260,775,1.5756846871331454,515,Upregulated,10,5
ydhL,172,224,0.38109016735550627,52,Upregulated,10,5
ydhF,1465,1609,0.135263661413836,144,Upregulated,10,5
sodC,1438,758,-0.923793922268206,-680,Downregulated,10,5
ydhK,254,2985,3.5548305293800015,2731,Upregulated,10,5
ydhJ,151,984,2.704109766014161,833,Upregulated,10,5
ydhI,59,160,1.439285045525521,101,Upregulated,10,5
slyA,3696,895,-2.046005169264439,-2801,Downregulated,10,5
slyB,15455,5913,-1.3861114719809438,-9542,Downregulated,10,5
anmK,1482,1821,0.2971854746710044,339,Upregulated,10,5
mliC,375,250,-0.5849625007211563,-125,Downregulated,10,5
pdxH,3123,1131,-1.4653336400307528,-1992,Downregulated,10,5
tyrS,12363,4420,-1.4839105947228617,-7943,Downregulated,10,5
pdxY,2549,1275,-0.9994341262759816,-1274,Downregulated,10,5
gstA,4497,1407,-1.676340555432483,-3090,Downregulated,10,5
dtpA,22029,2339,-3.2354402390036,-19690,Downregulated,10,5
nth,208,562,1.433986602079834,354,Upregulated,10,5
rsxE,257,834,1.6982790242507855,577,Upregulated,10,5
rsxG,225,714,1.6659990728120626,489,Upregulated,10,5
rsxD,396,1312,1.728195384538474,916,Upregulated,10,5
rsxC,1148,3059,1.4139374648825147,1911,Upregulated,10,5
rsxB,313,709,1.1796229703068979,396,Upregulated,10,5
rsxA,399,709,0.8293968810171704,310,Upregulated,10,5
ydgK,557,513,-0.1187185017329777,-44,Downregulated,10,5
cnu,105,66,-0.6698513983076693,-39,Downregulated,10,5
ydgJ,2365,1709,-0.4686877865506181,-656,Downregulated,10,5
add,2223,1743,-0.35093537890130505,-480,Downregulated,10,5
malY,1567,1316,-0.25184569073733876,-251,Downregulated,10,5
malX,318,1971,2.6318291057591305,1653,Upregulated,10,5
malI,281,1324,2.2362610865862917,1043,Upregulated,10,5
hdhA,7599,1287,-2.5617975242129556,-6312,Downregulated,10,5
uidR,854,705,-0.27661281233433443,-149,Downregulated,10,5
uidA,84,2028,4.59352451422458,1944,Upregulated,10,5
uidB,26,1201,5.529580717564542,1175,Upregulated,10,5
uidC,24,903,5.233619676759702,879,Upregulated,10,5
ydgA,7832,2741,-1.51467843677792,-5091,Downregulated,10,5
manA,6596,2470,-1.4170803569654271,-4126,Downregulated,10,5
fumA,1055,1934,0.8743447958822937,879,Upregulated,10,5
fumC,435,1574,1.8553482347713957,1139,Upregulated,10,5
tus,407,953,1.2274474196436949,546,Upregulated,10,5
rstB,1227,1378,0.16744063904138629,151,Upregulated,10,5
rstA,1658,1034,-0.6812078211808157,-624,Downregulated,10,5
ydgC,82,176,1.1018796140192137,94,Upregulated,10,5
folM,333,554,0.7343637989779263,221,Upregulated,10,5
ydgI,437,1565,1.8404574723193823,1128,Upregulated,10,5
ydgH,4232,1815,-1.2213700792309126,-2417,Downregulated,10,5
pntA,20019,7852,-1.3502378317680022,-12167,Downregulated,10,5
pntB,18260,6722,-1.4417243175635825,-11538,Downregulated,10,5
tqsA,398,1120,1.4926583964013178,722,Upregulated,10,5
mdtJ,32,278,3.1189410727235076,246,Upregulated,10,5
mdtI,18,183,3.34577483684173,165,Upregulated,10,5
ydgD,569,738,0.3751921637538141,169,Upregulated,10,5
asr,77,145,0.9131225493200331,68,Upregulated,10,5
ynfM,783,1435,0.8739665242720095,652,Upregulated,10,5
ynfL,308,1055,1.776240742899646,747,Upregulated,10,5
mlc,2569,2592,0.012858827983807924,23,Upregulated,10,5
ynfK,4051,2020,-1.0039227920472795,-2031,Downregulated,10,5
clcB,272,1077,1.985339693293868,805,Upregulated,10,5
dmsD,1985,595,-1.7381774338350142,-1390,Downregulated,10,5
ynfH,6173,964,-2.6788667397930284,-5209,Downregulated,10,5
ynfG,2804,429,-2.708436796511078,-2375,Downregulated,10,5
ynfF,19327,2400,-3.0095114041497926,-16927,Downregulated,10,5
ynfE,6240,2094,-1.5752845868188023,-4146,Downregulated,10,5
ynfD,417,167,-1.3201992809706113,-250,Downregulated,10,5
ynfC,511,625,0.2905328986118282,114,Upregulated,10,5
speG,2243,577,-1.9587863964407897,-1666,Downregulated,10,5
ynfB,1402,389,-1.8496442890244311,-1013,Downregulated,10,5
ynfA,174,244,0.487793841714158,70,Upregulated,10,5
rspA,134,1014,2.919752746545568,880,Upregulated,10,5
rspB,87,709,3.026698321390788,622,Upregulated,10,5
intQ,67,604,3.1723155488673065,537,Upregulated,10,5
insD7,6,1627,8.083036034951371,1621,Upregulated,10,5
ydfE,36,584,4.0198995574377046,548,Upregulated,10,5
ydfD,1,23,4.523561956057013,22,Upregulated,10,5
dicB,2,4,1.0,2,Unchanged,10,5
dicF,1,1,0.0,0,Unchanged,10,5
ydfC,5,56,3.4854268271702415,51,Upregulated,10,5
ydfB,1,7,2.807354922057604,6,Unchanged,10,5
ydfA,3,13,2.1154772174199357,10,Unchanged,10,5
dicA,1209,278,-2.120657456525616,-931,Downregulated,10,5
dicC,5,42,3.070389327891398,37,Upregulated,10,5
ydfX,8,104,3.700439718141092,96,Upregulated,10,5
ydfW,4,18,2.169925001442312,14,Upregulated,10,5
flxA,112,141,0.3321964303411894,29,Upregulated,10,5
ydfV,9,99,3.4594316186372973,90,Upregulated,10,5
relB,516,287,-0.8463203287475664,-229,Downregulated,10,5
relE,685,437,-0.6484707083472907,-248,Downregulated,10,5
hokD,39,29,-0.42742122373467617,-10,Downregulated,10,5
rem,29,98,1.756728848987636,69,Upregulated,10,5
ydfU,26,876,5.074347341460081,850,Upregulated,10,5
ydfT,65,486,2.9024446905773265,421,Upregulated,10,5
cspF,17,66,1.956931278108114,49,Upregulated,10,5
cspB,10,26,1.3785116232537298,16,Upregulated,10,5
essQ,1,29,4.857980995127572,28,Upregulated,10,5
ydfR,10,105,3.3923174227787602,95,Upregulated,10,5
rrrQ,11,372,5.079727192470735,361,Upregulated,10,5
rzpQ,14,292,4.382469636822413,278,Upregulated,10,5
cspI,3,22,2.8744691179161412,19,Upregulated,10,5
ynfN,1,10,3.321928094887362,9,Unchanged,10,5
gnsB,61,6,-3.34577483684173,-55,Downregulated,10,5
ydfO,32,10,-1.6780719051126376,-22,Downregulated,10,5
nohA,28,429,3.9374789154419414,401,Upregulated,10,5
stfQ,28,677,4.595657101517393,649,Upregulated,10,5
tfaQ,19,372,4.291231297664446,353,Upregulated,10,5
pinQ,37,337,3.1871514155529086,300,Upregulated,10,5
ydfK,9,10,0.15200309344505006,1,Unchanged,10,5
ydfI,132,1074,3.024384158626959,942,Upregulated,10,5
ydfZ,11569,474,-4.609233296964281,-11095,Downregulated,10,5
ydfH,1623,1352,-0.26356784826578716,-271,Downregulated,10,5
ydfG,6165,2726,-1.1773153324849919,-3439,Downregulated,10,5
dcp,6944,3189,-1.1226628501922185,-3755,Downregulated,10,5
ydeJ,316,316,0.0,0,Unchanged,10,5
ydeI,995,248,-2.004356405044136,-747,Downregulated,10,5
dgcZ,1305,637,-1.0346845292009466,-668,Downregulated,10,5
ydeE,258,884,1.7766753039681773,626,Upregulated,10,5
eamA,480,823,0.7778580248131072,343,Upregulated,10,5
marB,117,47,-1.3157758679057672,-70,Downregulated,10,5
marA,345,273,-0.337695410745679,-72,Downregulated,10,5
marR,345,380,0.13940305666541644,35,Upregulated,10,5
marC,628,766,0.2865798330333302,138,Upregulated,10,5
ydeA,837,1149,0.4570792700957695,312,Upregulated,10,5
yneK,41,390,3.249778309131527,349,Upregulated,10,5
yneJ,493,967,0.9719282430989297,474,Upregulated,10,5
sad,844,1877,1.153113746123689,1033,Upregulated,10,5
glsB,823,1337,0.7000351296717271,514,Upregulated,10,5
yneG,117,276,1.2381597371947646,159,Upregulated,10,5
dgcF,216,788,1.8671643172929078,572,Upregulated,10,5
uxaB,245,1471,2.5859435922522596,1226,Upregulated,10,5
yneE,302,639,1.0812673816219154,337,Upregulated,10,5
tam,685,640,-0.09803208296052676,-45,Downregulated,10,5
lsrG,37,132,1.8349407537295037,95,Upregulated,10,5
lsrF,253,728,1.524801065504386,475,Upregulated,10,5
lsrB,137,781,2.5111466551814527,644,Upregulated,10,5
lsrD,104,785,2.916109125637897,681,Upregulated,10,5
lsrC,109,969,3.152168530638155,860,Upregulated,10,5
lsrA,213,1472,2.7888523358311748,1259,Upregulated,10,5
lsrR,384,799,1.0570891922068204,415,Upregulated,10,5
lsrK,456,1455,1.6739134236309046,999,Upregulated,10,5
hipB,69,125,0.8572598278839181,56,Upregulated,10,5
hipA,877,1411,0.686069240152531,534,Upregulated,10,5
yneL,4,35,3.1292830169449664,31,Upregulated,10,5
ydeT,116,866,2.9002422195991526,750,Upregulated,10,5
ydeS,20,314,3.9726926540042644,294,Upregulated,10,5
ydeR,21,273,3.700439718141092,252,Upregulated,10,5
ydeQ,29,471,4.021602254485211,442,Upregulated,10,5
ydeP,375,2104,2.488172203909059,1729,Upregulated,10,5
safA,2,8,2.0,6,Unchanged,10,5
ydeO,19,215,3.500265336145875,196,Upregulated,10,5
ydeN,521,983,0.9159080440620724,462,Upregulated,10,5
ydeM,76,431,2.503616545645513,355,Upregulated,10,5
yddA,15,920,5.938599455335857,905,Upregulated,10,5
yddB,139,1547,3.4763164087255283,1408,Upregulated,10,5
pqqL,310,2170,2.807354922057604,1860,Upregulated,10,5
gadB,196014,1537,-6.994695725052132,-194477,Downregulated,10,5
gadC,146286,1329,-6.782306791089309,-144957,Downregulated,10,5
digH,2243,1294,-0.7935920030937648,-949,Downregulated,10,5
dosC,125,902,2.851199338593294,777,Upregulated,10,5
dosP,196,2354,3.586188760923236,2158,Upregulated,10,5
ddpX,9,439,5.608152128093046,430,Upregulated,10,5
ddpA,124,1410,3.5072831368992805,1286,Upregulated,10,5
ddpB,49,965,4.299675288040234,916,Upregulated,10,5
ddpC,104,842,3.017236704925304,738,Upregulated,10,5
ddpD,130,1089,3.0664204256884524,959,Upregulated,10,5
ddpF,117,907,2.954594020945118,790,Upregulated,10,5
osmC,15380,3259,-2.238554246110625,-12121,Downregulated,10,5
bdm,228,119,-0.9380722508567982,-109,Downregulated,10,5
sra,384,41,-3.2274104961030727,-343,Downregulated,10,5
maeA,13004,5143,-1.3382734023378988,-7861,Downregulated,10,5
adhP,787,1269,0.6892565283336195,482,Upregulated,10,5
yddM,248,319,0.36321630337799427,71,Upregulated,10,5
fdnI,220,621,1.4970897446958218,401,Upregulated,10,5
fdnH,172,1049,2.6085342078751697,877,Upregulated,10,5
fdnG,992,4205,2.0836937747556314,3213,Upregulated,10,5
yddG,606,731,0.27055361247948656,125,Upregulated,10,5
yddL,1,73,6.189824558880018,72,Upregulated,10,5
yddK,2,67,5.066089190457772,65,Upregulated,10,5
yddJ,2,38,4.247927513443585,36,Upregulated,10,5
narU,284,1498,2.399074788954069,1214,Upregulated,10,5
narZ,1449,5706,1.9774221520247903,4257,Upregulated,10,5
narY,439,1852,2.076791253724878,1413,Upregulated,10,5
narW,162,869,2.4233623639297757,707,Upregulated,10,5
narV,184,848,2.204358498506186,664,Upregulated,10,5
yddE,1129,1750,0.6323094359466903,621,Upregulated,10,5
nhoA,87,1204,3.7906761809109737,1117,Upregulated,10,5
yddH,151,650,2.105891168590738,499,Upregulated,10,5
pptA,161,72,-1.1609918766723046,-89,Downregulated,10,5
ydcC,27,882,5.029747343394052,855,Upregulated,10,5
yncI,103,489,2.247190127769015,386,Upregulated,10,5
ydcD,47,26,-0.8541491335365452,-21,Downregulated,10,5
rhsE,164,2170,3.725927322713758,2006,Upregulated,10,5
yncH,3,2,-0.5849625007211563,-1,Unchanged,10,5
yncG,247,715,1.533432200081074,468,Upregulated,10,5
ansP,470,2201,2.2274264833265573,1731,Upregulated,10,5
yncE,157,1340,3.093396536453508,1183,Upregulated,10,5
yncD,225,2948,3.7117396178780324,2723,Upregulated,10,5
mcbR,117,563,2.266626392496825,446,Upregulated,10,5
curA,1107,1406,0.34494137229098315,299,Upregulated,10,5
mnaT,1256,998,-0.3317247435543665,-258,Downregulated,10,5
ydcZ,302,369,0.28907226673531705,67,Upregulated,10,5
ydcY,1480,368,-2.0078195044592992,-1112,Downregulated,10,5
ortT,8,23,1.5235619560570128,15,Upregulated,10,5
patD,401,1851,2.2066307534156535,1450,Upregulated,10,5
ydcV,59,867,3.877245133859994,808,Upregulated,10,5
ydcU,128,1114,3.1215335173400316,986,Upregulated,10,5
ydcT,105,1204,3.5193741590935796,1099,Upregulated,10,5
ydcS,238,1403,2.5594815303119556,1165,Upregulated,10,5
ydcR,829,1904,1.199589471812193,1075,Upregulated,10,5
hicB,319,255,-0.32305917690601155,-64,Downregulated,10,5
yncJ,27,107,1.9865794842376783,80,Upregulated,10,5
rlhA,2155,2709,0.330072524225554,554,Upregulated,10,5
sutR,158,492,1.638733757162137,334,Upregulated,10,5
ydcO,113,1274,3.4949705998411127,1161,Upregulated,10,5
insQ,2129,1555,-0.45326136943432904,-574,Downregulated,10,5
ydcL,407,456,0.16400502989849455,49,Upregulated,10,5
tehB,1310,581,-1.1729567430202839,-729,Downregulated,10,5
tehA,539,1460,1.4376111910148741,921,Upregulated,10,5
ydcK,465,938,1.0123572065199826,473,Upregulated,10,5
rimL,682,610,-0.16096249657392386,-72,Downregulated,10,5
ydcH,605,135,-2.163975735111126,-470,Downregulated,10,5
opgD,2569,1982,-0.37424992771432875,-587,Downregulated,10,5
ydcJ,377,1726,2.194796035910291,1349,Upregulated,10,5
ydcI,125,943,2.9153296760130094,818,Upregulated,10,5
trg,288,1891,2.715008646507449,1603,Upregulated,10,5
mokB,21,28,0.41503749927884376,7,Unchanged,10,5
ydcA,97,42,-1.2075954194083673,-55,Downregulated,10,5
cybB,725,607,-0.25628447864661474,-118,Downregulated,10,5
aldA,664,2236,1.7516650414962653,1572,Upregulated,10,5
ydcF,3467,1345,-1.3660816637588469,-2122,Downregulated,10,5
hrpA,5991,8892,0.5697111148618612,2901,Upregulated,10,5
azoR,730,684,-0.09390013888148166,-46,Downregulated,10,5
ynbD,320,1442,2.17192735435346,1122,Upregulated,10,5
ynbC,313,2018,2.6886916121737388,1705,Upregulated,10,5
ynbB,10,790,6.303780748177103,780,Upregulated,10,5
ynbA,9,490,5.766712937560258,481,Upregulated,10,5
ydbD,127,1902,3.9046168440883977,1775,Upregulated,10,5
pdxI,624,1354,1.1176098047127483,730,Upregulated,10,5
insI2,24,14,-0.777607578663552,-10,Downregulated,10,5
insC2,441,166,-1.4095954142105958,-275,Downregulated,10,5
insD2,189,1633,3.1110666513406224,1444,Upregulated,10,5
paaY,519,990,0.9316939866090912,471,Upregulated,10,5
paaX,1037,1845,0.8312049221345328,808,Upregulated,10,5
paaK,236,2047,3.116652337661569,1811,Upregulated,10,5
paaJ,211,2121,3.3294297168233697,1910,Upregulated,10,5
paaI,44,434,3.302119613807182,390,Upregulated,10,5
paaH,179,2266,3.6621163685562594,2087,Upregulated,10,5
paaG,39,1114,4.836131298477784,1075,Upregulated,10,5
paaF,43,1170,4.766028059768669,1127,Upregulated,10,5
paaE,92,1689,4.198391656744373,1597,Upregulated,10,5
paaD,23,592,4.685891409571937,569,Upregulated,10,5
paaC,12,1118,6.541741972122034,1106,Upregulated,10,5
paaB,4,325,6.344295907915817,321,Upregulated,10,5
paaA,8,1296,7.339850002884624,1288,Upregulated,10,5
paaZ,61,3063,5.649992314036071,3002,Upregulated,10,5
tynA,272,3119,3.5194049961238125,2847,Upregulated,10,5
feaB,433,2687,2.633557391286441,2254,Upregulated,10,5
feaR,78,1040,3.736965594166206,962,Upregulated,10,5
ydbL,94,278,1.5643522210458702,184,Upregulated,10,5
ynbE,8,31,1.9541963103868751,23,Upregulated,10,5
ydbH,2187,4757,1.1210988049143613,2570,Upregulated,10,5
ldhA,1,3,1.584962500721156,2,Unchanged,10,5
hslJ,1511,696,-1.1183444493161008,-815,Downregulated,10,5
ydbK,6758,7839,0.21407327487737546,1081,Upregulated,10,5
ompN,37,1344,5.182864057149811,1307,Upregulated,10,5
uspF,2875,736,-1.965784284662087,-2139,Downregulated,10,5
ynaE,13,22,0.7589919004962051,9,Unchanged,10,5
pinR,38,636,4.06495544184077,598,Upregulated,10,5
tfaR,85,855,3.3303896736355583,770,Upregulated,10,5
stfR,294,6096,4.373974842656958,5802,Upregulated,10,5
insH5,215,367,0.7714434032537526,152,Upregulated,10,5
ynaA,158,1057,2.74197891320558,899,Upregulated,10,5
ydaY,19,410,4.43155258606186,391,Upregulated,10,5
ynaK,15,181,3.592955291474687,166,Upregulated,10,5
trkG,593,823,0.4728603258756221,230,Upregulated,10,5
rzpR,17,452,4.732716121164849,435,Upregulated,10,5
ydaW,51,575,3.4949928038602422,524,Upregulated,10,5
ydaV,38,1217,5.001185939270143,1179,Upregulated,10,5
ydaU,53,882,4.056714390994321,829,Upregulated,10,5
ydaT,21,424,4.335603031784439,403,Upregulated,10,5
ydaS,12,111,3.2094533656289497,99,Upregulated,10,5
racR,1145,466,-1.296945738330026,-679,Downregulated,10,5
ydaG,1,6,2.584962500721156,5,Unchanged,10,5
sieB,124,171,0.4636562044990228,47,Upregulated,10,5
kilR,1,27,4.754887502163468,26,Upregulated,10,5
racC,2,70,5.129283016944966,68,Upregulated,10,5
recE,127,3621,4.833487774704012,3494,Upregulated,10,5
recT,147,841,2.5162896454187798,694,Upregulated,10,5
ralR,2,28,3.807354922057604,26,Upregulated,10,5
rcbA,3,15,2.321928094887362,12,Upregulated,10,5
xisR,1,45,5.491853096329675,44,Upregulated,10,5
intR,85,1006,3.5650236536678253,921,Upregulated,10,5
ttcA,1511,1296,-0.2214379422802043,-215,Downregulated,10,5
dbpA,1226,1940,0.6620976733837085,714,Upregulated,10,5
zntB,1530,1780,0.2183455882737461,250,Upregulated,10,5
dgcM,564,1238,1.134244246815471,674,Upregulated,10,5
smrA,916,943,0.041910172578152605,27,Upregulated,10,5
abgR,190,914,2.266194746727122,724,Upregulated,10,5
abgA,55,1664,4.919080004616433,1609,Upregulated,10,5
abgB,104,1982,4.252301529045396,1878,Upregulated,10,5
abgT,116,1859,4.002330059791909,1743,Upregulated,10,5
ogt,310,656,1.0814275993438462,346,Upregulated,10,5
fnr,5164,3184,-0.6976486647635418,-1980,Downregulated,10,5
uspE,9296,3253,-1.5148392463633968,-6043,Downregulated,10,5
ynaJ,463,205,-1.1753882837547904,-258,Downregulated,10,5
insH4,2431,3950,0.7003027599230988,1519,Upregulated,10,5
ynaI,2268,1205,-0.9123874938249048,-1063,Downregulated,10,5
mppA,1034,2278,1.1395315613931771,1244,Upregulated,10,5
pgrR,531,962,0.8573250329658884,431,Upregulated,10,5
ycjY,243,995,2.03374021182523,752,Upregulated,10,5
mpaA,1099,1275,0.2143058607969892,176,Upregulated,10,5
ycjG,965,1995,1.0477878989542653,1030,Upregulated,10,5
tpx,5110,3004,-0.7664384783107119,-2106,Downregulated,10,5
tyrR,3765,4109,0.1261374656083659,344,Upregulated,10,5
ycjF,1053,2524,1.261206473956832,1471,Upregulated,10,5
ycjX,1446,2784,0.9450916588976105,1338,Upregulated,10,5
ycjW,963,1342,0.47877696835672423,379,Upregulated,10,5
ompG,27,1412,5.708636871107712,1385,Upregulated,10,5
ycjU,4,1343,8.391243589427443,1339,Upregulated,10,5
ycjT,176,5304,4.9134334414752905,5128,Upregulated,10,5
ycjS,120,2054,4.097329870709677,1934,Upregulated,10,5
ycjR,60,973,4.019405399172593,913,Upregulated,10,5
ycjQ,103,2082,4.337253826116199,1979,Upregulated,10,5
ycjP,47,1764,5.230045993879883,1717,Upregulated,10,5
ycjO,38,1420,5.223747700948459,1382,Upregulated,10,5
ycjN,58,2498,5.4285767664803855,2440,Upregulated,10,5
ycjM,92,2275,4.6280888739164086,2183,Upregulated,10,5
pspE,2218,2399,0.11317379213172468,181,Upregulated,10,5
pspD,430,785,0.868355994189529,355,Upregulated,10,5
pspC,2288,2807,0.29494201173413503,519,Upregulated,10,5
pspB,792,867,0.13053156314222542,75,Upregulated,10,5
pspA,15001,18263,0.2838650941409044,3262,Upregulated,10,5
pspF,596,2843,2.254029863215366,2247,Upregulated,10,5
puuE,93,3444,5.210710616288813,3351,Upregulated,10,5
puuB,76,2784,5.195015982405143,2708,Upregulated,10,5
puuC,171,3570,4.383855844030564,3399,Upregulated,10,5
puuR,311,849,1.448849973422436,538,Upregulated,10,5
puuD,89,1508,4.082687282302267,1419,Upregulated,10,5
puuA,149,2326,3.964466861011057,2177,Upregulated,10,5
puuP,70,2208,4.979241439833203,2138,Upregulated,10,5
ymjA,251,188,-0.41695470227313464,-63,Downregulated,10,5
sapA,2278,3838,0.7525869644872685,1560,Upregulated,10,5
sapB,839,1898,1.177737276581286,1059,Upregulated,10,5
sapC,546,1818,1.7353793432742548,1272,Upregulated,10,5
sapD,1390,2021,0.5399844387688656,631,Upregulated,10,5
sapF,661,1193,0.8518718661875364,532,Upregulated,10,5
ycjD,76,363,2.255898224552165,287,Upregulated,10,5
fabI,17639,4454,-1.9855953099056673,-13185,Downregulated,10,5
yciW,207,2074,3.3247132213139006,1867,Upregulated,10,5
rnb,12315,5798,-1.0867893893249263,-6517,Downregulated,10,5
pdeR,1106,2600,1.23316023768111,1494,Upregulated,10,5
yciT,1665,1086,-0.6164980741542629,-579,Downregulated,10,5
osmB,2245,259,-3.1156914419419555,-1986,Downregulated,10,5
yciH,444,235,-0.9178989197851062,-209,Downregulated,10,5
pyrF,3520,1514,-1.217210223538928,-2006,Downregulated,10,5
lapB,2581,3383,0.3903730357000183,802,Upregulated,10,5
lapA,1009,617,-0.7095837799569394,-392,Downregulated,10,5
pgpB,770,1196,0.6352870386158413,426,Upregulated,10,5
ribA,1494,1027,-0.5407439664710421,-467,Downregulated,10,5
acnA,3775,7988,1.081357688344169,4213,Upregulated,10,5
cysB,1645,1663,0.01570058466466533,18,Upregulated,10,5
topA,17377,7770,-1.1611925301497397,-9607,Downregulated,10,5
yciN,702,230,-1.6098371693601854,-472,Downregulated,10,5
sohB,3009,2016,-0.5777884678334203,-993,Downregulated,10,5
yciK,1581,1162,-0.44422729895384194,-419,Downregulated,10,5
btuR,759,692,-0.13332784777874168,-67,Downregulated,10,5
rluB,1853,1966,0.08540044031331483,113,Upregulated,10,5
yciQ,402,2066,2.361572847686131,1664,Upregulated,10,5
yciO,1248,972,-0.36058971525646744,-276,Downregulated,10,5
yciV,1408,1390,-0.01856245102642752,-18,Downregulated,10,5
trpL,1,1,0.0,0,Unchanged,10,5
trpE,447,3005,2.74901825441523,2558,Upregulated,10,5
trpD,486,2912,2.5829821365929155,2426,Upregulated,10,5
trpC,695,2552,1.8765434461539996,1857,Upregulated,10,5
trpB,1220,2652,1.1201996276623392,1432,Upregulated,10,5
trpA,961,1512,0.6538498034473221,551,Upregulated,10,5
yciG,49,48,-0.029747343394052068,-1,Unchanged,10,5
yciF,394,377,-0.06363110618771194,-17,Downregulated,10,5
yciE,421,242,-0.7988131857918015,-179,Downregulated,10,5
ompW,148,832,2.4909863525121425,684,Upregulated,10,5
yciC,1653,1078,-0.6167295465398084,-575,Downregulated,10,5
yciB,1086,695,-0.6439392201934918,-391,Downregulated,10,5
yciA,606,359,-0.7553339496498995,-247,Downregulated,10,5
tonB,291,1147,1.9787743331075411,856,Upregulated,10,5
yciI,2138,267,-3.001350206032937,-1871,Downregulated,10,5
kch,1565,1134,-0.46474201687775174,-431,Downregulated,10,5
clsA,2828,2905,0.038756043482492404,77,Upregulated,10,5
yciU,565,324,-0.8022570544179252,-241,Downregulated,10,5
oppF,19319,10416,-0.8912190649685247,-8903,Downregulated,10,5
oppD,19341,11709,-0.724044520709988,-7632,Downregulated,10,5
oppC,14520,9481,-0.614930314102267,-5039,Downregulated,10,5
oppB,12135,8750,-0.47181918643144266,-3385,Downregulated,10,5
oppA,137677,44347,-1.6343791492722417,-93330,Downregulated,10,5
ychE,552,998,0.8543715485590915,446,Upregulated,10,5
adhE,309420,108494,-1.5119511912780845,-200926,Downregulated,10,5
tdk,659,403,-0.7094986264800844,-256,Downregulated,10,5
hns,19492,1620,-3.5888164094203283,-17872,Downregulated,10,5
galU,9254,2068,-2.161840913250361,-7186,Downregulated,10,5
rssB,1397,1426,0.029641961034424947,29,Upregulated,10,5
rssA,1569,1533,-0.03348765530932006,-36,Downregulated,10,5
ychJ,1019,599,-0.7665261433770281,-420,Downregulated,10,5
purU,5913,2151,-1.458882752341581,-3762,Downregulated,10,5
tpr,1,3,1.584962500721156,2,Unchanged,10,5
narI,4057,1259,-1.6881350194872562,-2798,Downregulated,10,5
narJ,3377,1367,-1.3047289364014167,-2010,Downregulated,10,5
narH,10284,3365,-1.6117231053359766,-6919,Downregulated,10,5
narG,32374,9038,-1.840760167980422,-23336,Downregulated,10,5
narK,2637,2262,-0.22129864187473972,-375,Downregulated,10,5
narX,1510,2975,0.9783411188702269,1465,Upregulated,10,5
narL,2927,1446,-1.0173551934576328,-1481,Downregulated,10,5
ychO,668,2328,1.8011710504342318,1660,Upregulated,10,5
ychN,1650,693,-1.2515387669959646,-957,Downregulated,10,5
chaC,782,994,0.3460772442549339,212,Upregulated,10,5
chaB,163,124,-0.39453184384420226,-39,Downregulated,10,5
chaA,752,1871,1.3150049915631468,1119,Upregulated,10,5
kdsA,5904,2643,-1.1595162964188261,-3261,Downregulated,10,5
ychA,1692,1370,-0.3045536752720607,-322,Downregulated,10,5
ychQ,97,337,1.796691938994731,240,Upregulated,10,5
prmC,630,1378,1.1291521543170124,748,Upregulated,10,5
prfA,1895,1827,-0.052721214430965446,-68,Downregulated,10,5
hemA,3806,2947,-0.36902850115002167,-859,Downregulated,10,5
lolB,2723,1389,-0.9711503830624035,-1334,Downregulated,10,5
ispE,3312,1785,-0.8917785985828631,-1527,Downregulated,10,5
prs,49915,6529,-2.9345394796826705,-43386,Downregulated,10,5
dauA,3378,3270,-0.04687869241594091,-108,Downregulated,10,5
ychH,1684,846,-0.9931625699464464,-838,Downregulated,10,5
pth,1487,722,-1.0423339051652476,-765,Downregulated,10,5
ychF,4157,2428,-0.7757743263686903,-1729,Downregulated,10,5
ycgV,1025,3310,1.6912073073017717,2285,Upregulated,10,5
dhaR,704,2359,1.7445280846021654,1655,Upregulated,10,5
dhaK,9338,4852,-0.9445340381216788,-4486,Downregulated,10,5
dhaL,4879,2234,-1.1269562974427123,-2645,Downregulated,10,5
dhaM,10626,4924,-1.109695950988613,-5702,Downregulated,10,5
treA,1261,2158,0.775126589159797,897,Upregulated,10,5
ycgY,23,223,3.2773379438632917,200,Upregulated,10,5
ymgE,116,156,0.4274212237346762,40,Upregulated,10,5
ycgR,59,867,3.877245133859994,808,Upregulated,10,5
emtA,1523,729,-1.0629252221603551,-794,Downregulated,10,5
ldcA,1018,1445,0.505331931312346,427,Upregulated,10,5
cvrA,1648,2647,0.6836419523121802,999,Upregulated,10,5
dadX,727,1607,1.1443426597554995,880,Upregulated,10,5
dadA,1547,2592,0.7445925214355891,1045,Upregulated,10,5
ycgB,1043,1553,0.5743186718675356,510,Upregulated,10,5
fadR,1069,995,-0.10349342228947936,-74,Downregulated,10,5
nhaB,2823,2726,-0.05044356664448337,-97,Downregulated,10,5
dsbB,1210,749,-0.6919694237032059,-461,Downregulated,10,5
umuC,330,1658,2.328906077249935,1328,Upregulated,10,5
umuD,259,292,0.1730162711934633,33,Upregulated,10,5
hlyE,500,536,0.10030490579568548,36,Upregulated,10,5
ycgN,568,458,-0.31054333140773804,-110,Downregulated,10,5
ycgM,1868,841,-1.1513167494545176,-1027,Downregulated,10,5
ycgL,1140,307,-1.8927232636819247,-833,Downregulated,10,5
pliG,753,330,-1.1901838404261125,-423,Downregulated,10,5
ycgJ,283,188,-0.5900693911542451,-95,Downregulated,10,5
minC,5471,1875,-1.5449139601119741,-3596,Downregulated,10,5
minD,10017,2326,-2.1065274973110535,-7691,Downregulated,10,5
minE,1105,154,-2.8430441135838924,-951,Downregulated,10,5
ymgG,2792,521,-2.421943663931144,-2271,Downregulated,10,5
ymgD,4200,527,-2.9945144609162706,-3673,Downregulated,10,5
pdeG,39,1012,4.697591355832062,973,Upregulated,10,5
ymgC,1,16,4.0,15,Upregulated,10,5
ariR,4,20,2.321928094887362,16,Upregulated,10,5
ymgA,14,70,2.321928094887362,56,Upregulated,10,5
ycgZ,12,93,2.9541963103868754,81,Upregulated,10,5
bluF,89,724,3.0241124561168076,635,Upregulated,10,5
bluR,790,774,-0.029519086920054966,-16,Downregulated,10,5
ycgX,43,95,1.14359085362885,52,Upregulated,10,5
iraM,20,12,-0.7369655941662062,-8,Unchanged,10,5
mcrA,310,312,0.00927781358801065,2,Unchanged,10,5
pinE,11,477,5.4384138373682145,466,Upregulated,10,5
stfE,6,238,5.309855262586788,232,Upregulated,10,5
tfaE,22,367,4.060204634205916,345,Upregulated,10,5
tfaP,20,100,2.321928094887362,80,Upregulated,10,5
ycfK,16,424,4.727920454563199,408,Upregulated,10,5
ymfQ,13,575,5.466978427690646,562,Upregulated,10,5
jayE,48,667,3.796580450463429,619,Upregulated,10,5
beeE,27,319,3.562525111601401,292,Upregulated,10,5
ymfR,2,55,4.78135971352466,53,Upregulated,10,5
ymfM,33,267,3.0163018123291008,234,Upregulated,10,5
ymfL,69,438,2.666262602823004,369,Upregulated,10,5
ymfT,10,37,1.8875252707415875,27,Upregulated,10,5
ymfK,716,489,-0.5501251223120228,-227,Downregulated,10,5
ymfJ,44,184,2.0641303374197157,140,Upregulated,10,5
ymfI,474,126,-1.9114633253983428,-348,Downregulated,10,5
xisE,23,91,1.9842326841416833,68,Upregulated,10,5
intE,215,887,2.0445974447116035,672,Upregulated,10,5
lit,1333,669,-0.9945986644475123,-664,Downregulated,10,5
ymfE,310,184,-0.7525624492172248,-126,Downregulated,10,5
ymfD,123,188,0.6120743463383976,65,Upregulated,10,5
icd,15230,10430,-0.5461767839675266,-4800,Downregulated,10,5
rluE,640,966,0.5939512839484107,326,Upregulated,10,5
nudJ,504,685,0.44268025434797265,181,Upregulated,10,5
mnmA,4975,3828,-0.37810569583234804,-1147,Downregulated,10,5
hflD,1842,1528,-0.2696285180555868,-314,Downregulated,10,5
purB,11656,5235,-1.1548113402463418,-6421,Downregulated,10,5
phoP,4041,1957,-1.0460685955566553,-2084,Downregulated,10,5
phoQ,3668,3544,-0.049615035040036094,-124,Downregulated,10,5
roxA,5382,3228,-0.737501812362637,-2154,Downregulated,10,5
pepT,7856,2870,-1.452744192751643,-4986,Downregulated,10,5
potA,1398,2112,0.5952454739830171,714,Upregulated,10,5
potB,497,1040,1.0652657714661684,543,Upregulated,10,5
potC,524,981,0.9046863246817884,457,Upregulated,10,5
potD,3991,2167,-0.8810511254175981,-1824,Downregulated,10,5
ymfA,25,331,3.726831217032493,306,Upregulated,10,5
ycfZ,16,513,5.002815015607054,497,Upregulated,10,5
cobB,2059,1628,-0.3388431303660072,-431,Downregulated,10,5
nagK,1770,1892,0.09616272836903554,122,Upregulated,10,5
lolE,1665,2640,0.6650157522871913,975,Upregulated,10,5
lolD,730,1559,1.0946525589304053,829,Upregulated,10,5
lolC,932,2228,1.2573473726857516,1296,Upregulated,10,5
ycfT,92,1180,3.6810091881921907,1088,Upregulated,10,5
mfd,9569,9917,0.0515355907211584,348,Upregulated,10,5
ldtC,113,1452,3.683646775580563,1339,Upregulated,10,5
bhsA,272,1060,1.962385708200222,788,Upregulated,10,5
comR,320,957,1.5804470195986633,637,Upregulated,10,5
ycfJ,2616,1481,-0.8207909002092348,-1135,Downregulated,10,5
ndh,344,2117,2.621540799305491,1773,Upregulated,10,5
ycfP,4143,1870,-1.147637550204208,-2273,Downregulated,10,5
nagZ,2421,2115,-0.19494541599162438,-306,Downregulated,10,5
thiK,1191,1306,0.13298148368231688,115,Upregulated,10,5
lpoB,6500,1840,-1.8207339518588042,-4660,Downregulated,10,5
ycfL,3788,660,-2.5208984012225693,-3128,Downregulated,10,5
hinT,2215,717,-1.6272616747404758,-1498,Downregulated,10,5
fhuE,179,3044,4.087936866239289,2865,Upregulated,10,5
ptsG,40519,13391,-1.5973348683281345,-27128,Downregulated,10,5
ycfH,1022,1136,0.15256763856706065,114,Upregulated,10,5
holB,1198,2101,0.8104482538842603,903,Upregulated,10,5
tmk,837,1353,0.6928623114261934,516,Upregulated,10,5
mltG,863,1745,1.0157945719180597,882,Upregulated,10,5
pabC,698,1272,0.865799729074703,574,Upregulated,10,5
fabF,19103,5762,-1.7291576561718742,-13341,Downregulated,10,5
acpP,10587,1385,-2.9343359545643297,-9202,Downregulated,10,5
fabG,18276,3711,-2.3000704415109223,-14565,Downregulated,10,5
fabD,11227,3515,-1.6753758780002472,-7712,Downregulated,10,5
fabH,5416,3740,-0.5341894687999977,-1676,Downregulated,10,5
plsX,4789,3040,-0.6556531119050533,-1749,Downregulated,10,5
rpmF,1189,227,-2.3889845124547406,-962,Downregulated,10,5
yceD,13505,3007,-2.1670968668223263,-10498,Downregulated,10,5
yceF,1923,1187,-0.6960388276979906,-736,Downregulated,10,5
rluC,2826,1957,-0.5301177097071355,-869,Downregulated,10,5
yceQ,20,211,3.399171093819823,191,Upregulated,10,5
rne,18565,14960,-0.31147513996710374,-3605,Downregulated,10,5
flgL,901,1871,1.0542105474272454,970,Upregulated,10,5
flgK,870,3114,1.8396816383429462,2244,Upregulated,10,5
flgJ,445,1679,1.91572498908327,1234,Upregulated,10,5
flgI,756,2196,1.538419914784126,1440,Upregulated,10,5
flgH,689,1203,0.8040607544717852,514,Upregulated,10,5
flgG,2137,1575,-0.4402350793851699,-562,Downregulated,10,5
flgF,2175,1749,-0.31448511170180043,-426,Downregulated,10,5
flgE,4559,2179,-1.065051212748858,-2380,Downregulated,10,5
flgD,2647,1170,-1.1778496650246317,-1477,Downregulated,10,5
flgC,1173,455,-1.36626456294245,-718,Downregulated,10,5
flgB,1528,545,-1.4873164083714598,-983,Downregulated,10,5
flgA,978,906,-0.11032341490599867,-72,Downregulated,10,5
flgM,296,325,0.13484254228686715,29,Upregulated,10,5
flgN,360,428,0.24961389007147222,68,Upregulated,10,5
murJ,456,2851,2.644362309773211,2395,Upregulated,10,5
yceM,1690,1981,0.2292056337199397,291,Upregulated,10,5
yceH,1595,1226,-0.37959744496145026,-369,Downregulated,10,5
rimJ,1083,1019,-0.08787919144251333,-64,Downregulated,10,5
mdtH,180,1996,3.471042909007586,1816,Upregulated,10,5
grxB,9658,3604,-1.422125452359117,-6054,Downregulated,10,5
yceB,2884,1121,-1.3632848864353957,-1763,Downregulated,10,5
pyrC,18327,1994,-3.2002333314032056,-16333,Downregulated,10,5
dinI,1134,222,-2.3527890585921227,-912,Downregulated,10,5
bssS,560,174,-1.6863395210962382,-386,Downregulated,10,5
solA,2910,2255,-0.36789171965290285,-655,Downregulated,10,5
yceO,4,5,0.32192809488736235,1,Unchanged,10,5
yceJ,23,574,4.6413449706186745,551,Upregulated,10,5
yceI,120,606,2.3362833878644325,486,Upregulated,10,5
trhO,392,1377,1.812603000019756,985,Upregulated,10,5
lpxL,1470,2069,0.49311749013628287,599,Upregulated,10,5
mdtG,254,1616,2.6695267959796287,1362,Upregulated,10,5
msyB,1443,353,-2.0313312112200177,-1090,Downregulated,10,5
yceK,152,139,-0.12898644072007803,-13,Downregulated,10,5
opgH,7957,6686,-0.25108124403954035,-1271,Downregulated,10,5
opgG,10984,4937,-1.1536969804060038,-6047,Downregulated,10,5
opgC,246,1016,2.046170181432926,770,Upregulated,10,5
clsC,1044,2250,1.1078032895345151,1206,Upregulated,10,5
ymdB,428,591,0.4655473337763855,163,Upregulated,10,5
ymdA,66,241,1.868495216871508,175,Upregulated,10,5
csgC,10,153,3.9354597478052895,143,Upregulated,10,5
csgA,338,470,0.4756375102828154,132,Upregulated,10,5
csgB,12,181,3.914883386362049,169,Upregulated,10,5
csgD,125,394,1.6562675347942892,269,Upregulated,10,5
csgE,18,157,3.1246957474493144,139,Upregulated,10,5
csgF,16,249,3.960001932068081,233,Upregulated,10,5
csgG,166,1174,2.8221772617631276,1008,Upregulated,10,5
ycdZ,596,750,0.33157826492108156,154,Upregulated,10,5
ycdY,1768,1062,-0.735334508587278,-706,Downregulated,10,5
ycdX,3393,1942,-0.8050182292917843,-1451,Downregulated,10,5
ghrA,3850,3169,-0.28083078608739237,-681,Downregulated,10,5
ycdU,19,889,5.548112095386185,870,Upregulated,10,5
ymdE,3,111,5.20945336562895,108,Upregulated,10,5
insE4,99,112,0.17799830197799443,13,Upregulated,10,5
insF4,24,606,4.658211482751795,582,Upregulated,10,5
dgcT,939,1005,0.09799843841251649,66,Upregulated,10,5
pgaA,2502,3834,0.6157685475023308,1332,Upregulated,10,5
pgaB,1215,2453,1.0135909200644588,1238,Upregulated,10,5
pgaC,838,1786,1.0917099314218714,948,Upregulated,10,5
pgaD,207,334,0.690217334974727,127,Upregulated,10,5
phoH,67,1740,4.6987824002783185,1673,Upregulated,10,5
efeB,142,2756,4.278613053199609,2614,Upregulated,10,5
efeO,80,2367,4.8869158958472525,2287,Upregulated,10,5
putP,897,3399,1.9219304716224106,2502,Upregulated,10,5
putA,510,10181,4.319238215713851,9671,Upregulated,10,5
rutR,426,1339,1.6522306250984724,913,Upregulated,10,5
rutA,14,2489,7.473995592923432,2475,Upregulated,10,5
rutB,19,1458,6.261847490883352,1439,Upregulated,10,5
rutC,8,493,5.945443836377912,485,Upregulated,10,5
rutD,27,1888,6.1277555471983725,1861,Upregulated,10,5
rutE,21,1117,5.733096047704555,1096,Upregulated,10,5
rutF,18,865,5.586631321081775,847,Upregulated,10,5
rutG,202,2970,3.8780357329363335,2768,Upregulated,10,5
wrbA,8996,2543,-1.8227521990877107,-6453,Downregulated,10,5
yccJ,2763,528,-2.3876257274540382,-2235,Downregulated,10,5
agp,2559,3336,0.38253914140521716,777,Upregulated,10,5
yccE,76,289,1.9269981690570934,213,Upregulated,10,5
cbpA,11798,2480,-2.2501302885543626,-9318,Downregulated,10,5
cbpM,2625,546,-2.265344566520995,-2079,Downregulated,10,5
torD,6279,2503,-1.3268765212885334,-3776,Downregulated,10,5
torA,54276,16650,-1.7047922245065805,-37626,Downregulated,10,5
torC,17968,4504,-1.9961511003203716,-13464,Downregulated,10,5
torR,540,1436,1.4110244367722204,896,Upregulated,10,5
torT,516,2121,2.039301650107301,1605,Upregulated,10,5
torS,859,6052,2.816681951078274,5193,Upregulated,10,5
yccM,233,1706,2.87221578666401,1473,Upregulated,10,5
ymcE,1,39,5.285402218862249,38,Upregulated,10,5
cspG,21,106,2.335603031784439,85,Upregulated,10,5
cspH,2,103,5.6865005271832185,101,Upregulated,10,5
insB4,177,924,2.3841434913330604,747,Upregulated,10,5
gfcA,51,291,2.5124500009367883,240,Upregulated,10,5
gfcB,26,667,4.681103233043493,641,Upregulated,10,5
gfcC,37,1072,4.856635824828823,1035,Upregulated,10,5
gfcD,132,3691,4.805401902887155,3559,Upregulated,10,5
gfcE,118,1885,3.9977057587941855,1767,Upregulated,10,5
etp,62,444,2.840219555963231,382,Upregulated,10,5
etk,886,4143,2.2252972164241887,3257,Upregulated,10,5
appA,2363,2466,0.06155317042899224,103,Upregulated,10,5
appB,3375,2654,-0.3467191314553622,-721,Downregulated,10,5
appC,4239,3418,-0.31057156937895625,-821,Downregulated,10,5
hyaF,2995,1647,-0.8627154479497933,-1348,Downregulated,10,5
hyaE,1064,691,-0.622740535112931,-373,Downregulated,10,5
hyaD,3274,1419,-1.2061797324136019,-1855,Downregulated,10,5
hyaC,2700,1413,-0.934197941604254,-1287,Downregulated,10,5
hyaB,5664,4366,-0.37550913509220635,-1298,Downregulated,10,5
hyaA,4584,2836,-0.6927495115173888,-1748,Downregulated,10,5
yccA,4779,2897,-0.7221490829760625,-1882,Downregulated,10,5
tusE,572,379,-0.5938172986072977,-193,Downregulated,10,5
yccX,84,235,1.4841995237862393,151,Upregulated,10,5
rlmI,2482,2324,-0.09489304672582782,-158,Downregulated,10,5
hspQ,1831,1012,-0.8554225011030269,-819,Downregulated,10,5
yccU,1754,893,-0.9739166673235102,-861,Downregulated,10,5
yccT,122,1112,3.1882037351606214,990,Upregulated,10,5
mgsA,2306,1255,-0.8777051488136377,-1051,Downregulated,10,5
helD,4108,5220,0.34561362513905175,1112,Upregulated,10,5
yccF,698,628,-0.15246247731802526,-70,Downregulated,10,5
yccS,1818,3991,1.1343980793171646,2173,Upregulated,10,5
sxy,419,915,1.1268214994720533,496,Upregulated,10,5
sulA,2741,985,-1.4765066984820365,-1756,Downregulated,10,5
ompA,206754,45709,-2.1773650792051917,-161045,Downregulated,10,5
matP,515,603,0.22758556982950404,88,Upregulated,10,5
ycbZ,1931,3540,0.8744011960197096,1609,Upregulated,10,5
fabA,2426,1815,-0.41861000223739725,-611,Downregulated,10,5
rmf,19615,7006,-1.485294442162395,-12609,Downregulated,10,5
pqiC,610,825,0.43558487668292956,215,Upregulated,10,5
pqiB,1559,2700,0.7923384792404085,1141,Upregulated,10,5
pqiA,542,1941,1.8404353613597921,1399,Upregulated,10,5
uup,3146,4285,0.4457765335841755,1139,Upregulated,10,5
rlmL,3709,4931,0.41084998499810926,1222,Upregulated,10,5
ycbX,752,1959,1.3813128305899496,1207,Upregulated,10,5
zapC,1360,927,-0.5529654075121709,-433,Downregulated,10,5
pyrD,20107,1467,-3.7767570689213334,-18640,Downregulated,10,5
ycbF,119,638,2.422594850456926,519,Upregulated,10,5
ycbV,62,596,3.2649722100752863,534,Upregulated,10,5
ycbU,35,429,3.615550820554579,394,Upregulated,10,5
elfG,161,1108,2.782825287934571,947,Upregulated,10,5
elfC,175,3411,4.2847679277810755,3236,Upregulated,10,5
elfD,15,502,5.064652958342253,487,Upregulated,10,5
elfA,176,372,1.0797271924707341,196,Upregulated,10,5
ssuE,12,733,5.932706887412656,721,Upregulated,10,5
ssuA,32,1397,5.448116305409463,1365,Upregulated,10,5
ssuD,83,1896,4.513703817551335,1813,Upregulated,10,5
ssuC,44,1243,4.820178962415188,1199,Upregulated,10,5
ssuB,152,1146,2.9144638153133196,994,Upregulated,10,5
pepN,6759,6278,-0.10650478537446889,-481,Downregulated,10,5
pncB,13139,4036,-1.702857397782121,-9103,Downregulated,10,5
asnS,17274,8045,-1.1024378686737821,-9229,Downregulated,10,5
ompF,11716,2336,-2.3263679189993494,-9380,Downregulated,10,5
aspC,14428,5594,-1.3669191693113787,-8834,Downregulated,10,5
gloC,4344,1939,-1.1637112996975691,-2405,Downregulated,10,5
mepK,4820,1575,-1.6136813178426828,-3245,Downregulated,10,5
ldtD,2920,3868,0.4056194257094617,948,Upregulated,10,5
mukB,11670,10981,-0.08779511969410014,-689,Downregulated,10,5
mukE,1015,1166,0.200088061127958,151,Upregulated,10,5
mukF,1656,2238,0.43450736347706875,582,Upregulated,10,5
cmoM,1597,1617,0.017955366062429045,20,Upregulated,10,5
elyC,359,876,1.2869470257781221,517,Upregulated,10,5
ycbJ,1854,1882,0.021625384103005865,28,Upregulated,10,5
kdsB,3176,1899,-0.7419710069934603,-1277,Downregulated,10,5
ycaR,149,117,-0.34880380087875706,-32,Downregulated,10,5
ycaQ,281,1606,2.5148298572963883,1325,Upregulated,10,5
lpxK,596,1728,1.5357189817013068,1132,Upregulated,10,5
msbA,2833,3545,0.32345502574878005,712,Upregulated,10,5
ycaI,267,2883,3.4326591898073526,2616,Upregulated,10,5
ihfB,4169,543,-2.9406772690040275,-3626,Downregulated,10,5
rpsA,111197,26814,-2.0520595102282333,-84383,Downregulated,10,5
cmk,2341,1341,-0.8038156972075388,-1000,Downregulated,10,5
ycaL,158,728,2.2040138920215933,570,Upregulated,10,5
aroA,7840,2877,-1.4462884332632837,-4963,Downregulated,10,5
serC,40422,7489,-2.432295710382022,-32933,Downregulated,10,5
ycaP,358,629,0.8131004296150328,271,Upregulated,10,5
ycaO,1024,2488,1.2807707701306026,1464,Upregulated,10,5
focA,3653,2876,-0.3450180779227205,-777,Downregulated,10,5
pflA,2310,1267,-0.8664763271626105,-1043,Downregulated,10,5
ycaK,94,385,2.0341257839046265,291,Upregulated,10,5
ycaN,239,852,1.8338428122450898,613,Upregulated,10,5
ycaM,49,1510,4.945622990097233,1461,Upregulated,10,5
ycaD,1249,1714,0.45659363250454255,465,Upregulated,10,5
ycaC,1162,602,-0.9487746766448268,-560,Downregulated,10,5
dmsC,4717,1628,-1.53476890126335,-3089,Downregulated,10,5
dmsB,2469,936,-1.3993464015593775,-1533,Downregulated,10,5
dmsA,11621,4690,-1.3090743917468417,-6931,Downregulated,10,5
serS,19894,6684,-1.5735497432391965,-13210,Downregulated,10,5
rarA,1869,2732,0.5476909145449325,863,Upregulated,10,5
lolA,1526,1013,-0.5911207880333923,-513,Downregulated,10,5
ftsK,12158,10309,-0.23800152960157073,-1849,Downregulated,10,5
lrp,6467,1136,-2.509133775543195,-5331,Downregulated,10,5
trxB,5474,2431,-1.1710455413362275,-3043,Downregulated,10,5
cydD,2062,4856,1.2357240888875736,2794,Upregulated,10,5
cydC,2670,4215,0.6586928892545283,1545,Upregulated,10,5
aat,858,1389,0.694997046481847,531,Upregulated,10,5
infA,2058,307,-2.744932421523789,-1751,Downregulated,10,5
clpA,29579,21566,-0.4558146645997842,-8013,Downregulated,10,5
clpS,455,516,0.18150452033719547,61,Upregulated,10,5
cspD,1176,315,-1.9004643264490857,-861,Downregulated,10,5
macB,1094,5070,2.212373009098146,3976,Upregulated,10,5
macA,728,2767,1.9263122884112582,2039,Upregulated,10,5
ybjX,13740,3962,-1.794081218815976,-9778,Downregulated,10,5
ybjD,921,3715,2.012089149334623,2794,Upregulated,10,5
aqpZ,356,1476,2.0517435750939983,1120,Upregulated,10,5
lysO,1426,1720,0.2704345831455723,294,Upregulated,10,5
hcp,293,3690,3.6546482465255106,3397,Upregulated,10,5
hcr,312,1329,2.090723170413926,1017,Upregulated,10,5
poxB,4689,3931,-0.2543839152967266,-758,Downregulated,10,5
ltaE,3682,2458,-0.5830047109772448,-1224,Downregulated,10,5
ybjT,2111,2893,0.45463974458244355,782,Upregulated,10,5
ybjS,1614,1890,0.22774565583065481,276,Upregulated,10,5
amiD,1618,2348,0.5372208006800746,730,Upregulated,10,5
ybjQ,562,618,0.13703670768344833,56,Upregulated,10,5
ybjP,2106,1071,-0.9755469562754611,-1035,Downregulated,10,5
artP,2060,2361,0.1967537041580618,301,Upregulated,10,5
artI,3090,2655,-0.21889497710022102,-435,Downregulated,10,5
artQ,1630,1697,0.05811460042422344,67,Upregulated,10,5
artM,1040,1367,0.3944297145776055,327,Upregulated,10,5
artJ,1695,3465,1.0315700790008697,1770,Upregulated,10,5
rlmC,472,1874,1.9892621882973456,1402,Upregulated,10,5
ybjO,201,559,1.4756527816642615,358,Upregulated,10,5
potI,121,1291,3.415410048032596,1170,Upregulated,10,5
potH,31,1317,5.408843319869639,1286,Upregulated,10,5
potG,98,1611,4.03903093459136,1513,Upregulated,10,5
potF,141,1450,3.362285832503503,1309,Upregulated,10,5
ybjN,1262,543,-1.2166878071781875,-719,Downregulated,10,5
rimK,1282,1613,0.3313501765369017,331,Upregulated,10,5
nfsA,1198,1319,0.1388166564627591,121,Upregulated,10,5
ybjC,343,322,-0.09114788805819528,-21,Downregulated,10,5
grxA,159,112,-0.5055280332267513,-47,Downregulated,10,5
ybjM,592,506,-0.22645979093463967,-86,Downregulated,10,5
ybjL,2238,4070,0.8628187581772154,1832,Upregulated,10,5
rcdA,210,735,1.8073549220576042,525,Upregulated,10,5
ybjJ,517,2100,2.02215314223855,1583,Upregulated,10,5
ybjI,819,1106,0.4334160285936985,287,Upregulated,10,5
ybjH,149,235,0.6573484261028382,86,Upregulated,10,5
mdfA,472,1748,1.8888464201387571,1276,Upregulated,10,5
ybjG,2358,1221,-0.9495005179923595,-1137,Downregulated,10,5
deoR,1256,1179,-0.09127274591186439,-77,Downregulated,10,5
dacC,4569,2970,-0.6214155115203204,-1599,Downregulated,10,5
gstB,3048,1360,-1.1642562513556203,-1688,Downregulated,10,5
yliI,463,2480,2.4212560220140014,2017,Upregulated,10,5
bssR,10383,6662,-0.6401960882122527,-3721,Downregulated,10,5
rimO,1654,2378,0.5237894805743811,724,Upregulated,10,5
dgcI,654,1152,0.8167781759442299,498,Upregulated,10,5
pdeI,1556,2375,0.6100854531194805,819,Upregulated,10,5
gsiD,251,1506,2.584962500721156,1255,Upregulated,10,5
gsiC,385,1878,2.2862667120715106,1493,Upregulated,10,5
gsiB,1239,3863,1.6405454900913297,2624,Upregulated,10,5
gsiA,2083,6300,1.5966889892339944,4217,Upregulated,10,5
iaaA,1443,4880,1.7578098479590505,3437,Upregulated,10,5
moeA,2189,3195,0.5455439766534106,1006,Upregulated,10,5
moeB,916,1774,0.9535865062041199,858,Upregulated,10,5
fsaA,155,869,2.4870879615401624,714,Upregulated,10,5
ybiY,30,1492,5.636141224646719,1462,Upregulated,10,5
ybiW,265,4667,4.138431202513582,4402,Upregulated,10,5
ybiV,444,1088,1.2930469749002333,644,Upregulated,10,5
ybiU,96,2480,4.6911619045530815,2384,Upregulated,10,5
ybiT,3661,5084,0.4737262567004134,1423,Upregulated,10,5
ldtB,3104,1894,-0.7126922267187425,-1210,Downregulated,10,5
ybiR,287,1990,2.7936457887553234,1703,Upregulated,10,5
mntR,583,1156,0.9875736093001823,573,Upregulated,10,5
yliL,2,188,6.554588851677638,186,Upregulated,10,5
opgE,265,2432,3.198078963993024,2167,Upregulated,10,5
ompX,48807,9662,-2.3366943190254443,-39145,Downregulated,10,5
rhtA,180,1640,3.187627003175771,1460,Upregulated,10,5
dps,14671,2135,-2.7806592359214415,-12536,Downregulated,10,5
glnH,9754,1919,-2.3456392608404877,-7835,Downregulated,10,5
glnP,3277,1272,-1.3652770022584044,-2005,Downregulated,10,5
glnQ,3497,1503,-1.2182727867813519,-1994,Downregulated,10,5
ybiO,672,4518,2.749151132614324,3846,Upregulated,10,5
rlmF,1442,1794,0.3151087256784386,352,Upregulated,10,5
mcbA,69,224,1.698830465279435,155,Upregulated,10,5
fiu,70,4128,5.881944238478288,4058,Upregulated,10,5
ybiX,67,1146,4.096302138299133,1079,Upregulated,10,5
ybiI,51,281,2.4620009782494305,230,Upregulated,10,5
ybiJ,100,250,1.3219280948873624,150,Upregulated,10,5
hcxB,9217,4083,-1.1746676831554574,-5134,Downregulated,10,5
ybiB,2844,2333,-0.2857351576352161,-511,Downregulated,10,5
dinG,1871,6136,1.7134889242621494,4265,Upregulated,10,5
ybiA,112,859,2.9391593990808595,747,Upregulated,10,5
rhlE,751,3454,2.2013832700146523,2703,Upregulated,10,5
cecR,562,1703,1.5994363994576164,1141,Upregulated,10,5
ybhG,1149,2752,1.2601016720559846,1603,Upregulated,10,5
ybhF,2044,5108,1.3213633287651025,3064,Upregulated,10,5
ybhS,629,2785,2.146545405348105,2156,Upregulated,10,5
ybhR,485,2499,2.365294249012214,2014,Upregulated,10,5
ybhQ,351,663,0.9175378398080271,312,Upregulated,10,5
ybhP,600,1332,1.1505596765753814,732,Upregulated,10,5
clsB,877,2672,1.607271260029319,1795,Upregulated,10,5
ybhN,286,1777,2.6353566292502886,1491,Upregulated,10,5
ybhM,64,618,3.2714630279043746,554,Upregulated,10,5
ybhL,3891,1918,-1.0205382599547248,-1973,Downregulated,10,5
moaE,1752,887,-0.9819967653001095,-865,Downregulated,10,5
moaD,260,212,-0.2944473584652553,-48,Downregulated,10,5
moaC,2860,1422,-1.0080936820463364,-1438,Downregulated,10,5
moaB,3256,1582,-1.0413510997934552,-1674,Downregulated,10,5
moaA,3302,2657,-0.31354189242275143,-645,Downregulated,10,5
ybhK,1102,1725,0.6464721379817361,623,Upregulated,10,5
uvrB,5067,7051,0.4766960517334962,1984,Upregulated,10,5
bioD,627,1115,0.8305063620056281,488,Upregulated,10,5
bioC,584,1616,1.4683869238717775,1032,Upregulated,10,5
bioF,1223,3169,1.373603255854847,1946,Upregulated,10,5
bioB,1832,3375,0.8814679987286117,1543,Upregulated,10,5
bioA,1022,4147,2.02067285096834,3125,Upregulated,10,5
ybhB,1312,862,-0.6060079455289856,-450,Downregulated,10,5
ybhC,4620,3395,-0.44448127717132574,-1225,Downregulated,10,5
ybhJ,126,4432,5.136462242549272,4306,Upregulated,10,5
ybhI,19,1969,6.6953198824579685,1950,Upregulated,10,5
ybhH,9,1233,7.098032082960526,1224,Upregulated,10,5
ybhD,21,919,5.4516036285102745,898,Upregulated,10,5
pgl,5304,2024,-1.3898714854182777,-3280,Downregulated,10,5
ybhA,1185,1124,-0.07624502356469538,-61,Downregulated,10,5
modC,548,2934,2.420621072712863,2386,Upregulated,10,5
modB,333,1743,2.387978487054423,1410,Upregulated,10,5
modA,403,3138,2.96099360844013,2735,Upregulated,10,5
acrZ,112,12,-3.222392421336448,-100,Downregulated,10,5
modE,525,1642,1.6450647992243197,1117,Upregulated,10,5
modF,666,3309,2.3128012092412766,2643,Upregulated,10,5
galE,2865,2524,-0.18282322866171827,-341,Downregulated,10,5
galT,2229,2268,0.025024023682476366,39,Upregulated,10,5
galK,3675,3084,-0.2529414846960549,-591,Downregulated,10,5
galM,9684,3637,-1.4128541535433197,-6047,Downregulated,10,5
gpmA,6870,3083,-1.1559752095982874,-3787,Downregulated,10,5
aroG,13069,6744,-0.9544723133417239,-6325,Downregulated,10,5
ybgS,686,346,-0.9874365385360876,-340,Downregulated,10,5
zitB,773,1333,0.7861364611641258,560,Upregulated,10,5
pnuC,10328,1578,-2.710391795293732,-8750,Downregulated,10,5
nadA,15773,2695,-2.5490999064830935,-13078,Downregulated,10,5
cpoB,8513,2280,-1.9006338060429238,-6233,Downregulated,10,5
pal,12885,2556,-2.3337327957999876,-10329,Downregulated,10,5
tolB,13827,4672,-1.5653759941777878,-9155,Downregulated,10,5
tolA,2665,2547,-0.06533657337234353,-118,Downregulated,10,5
tolR,476,489,0.03887289164429008,13,Upregulated,10,5
tolQ,1786,1210,-0.5617250329592661,-576,Downregulated,10,5
ybgC,891,449,-0.9887099867807749,-442,Downregulated,10,5
ybgE,1043,406,-1.3611875253345895,-637,Downregulated,10,5
cydB,10697,6818,-0.6497857413838689,-3879,Downregulated,10,5
cydA,15778,9944,-0.6660161411773403,-5834,Downregulated,10,5
mngB,695,3651,2.3932067858240145,2956,Upregulated,10,5
mngA,36,3044,6.4018276420612334,3008,Upregulated,10,5
mngR,443,965,1.1232222436004242,522,Upregulated,10,5
sucD,2502,2196,-0.1882037351606212,-306,Downregulated,10,5
sucC,3330,3138,-0.08567682499052688,-192,Downregulated,10,5
sucB,4106,3606,-0.18733423067626032,-500,Downregulated,10,5
sucA,5375,7546,0.4894473454459246,2171,Upregulated,10,5
sdhB,312,1019,1.7075361173035655,707,Upregulated,10,5
sdhA,571,3693,2.693230611842771,3122,Upregulated,10,5
sdhD,45,388,3.108059745857453,343,Upregulated,10,5
sdhC,57,509,3.1586318319109536,452,Upregulated,10,5
gltA,4843,10211,1.076151253402954,5368,Upregulated,10,5
ybgD,12,709,5.88467931651836,697,Upregulated,10,5
ybgQ,17,4222,7.956248022096816,4205,Upregulated,10,5
ybgP,16,969,5.920352855415081,953,Upregulated,10,5
ybgO,33,1253,5.246776579963407,1220,Upregulated,10,5
abrB,589,2139,1.8605969433345837,1550,Upregulated,10,5
nei,1068,1807,0.7586848591770456,739,Upregulated,10,5
pxpA,1773,2091,0.23800052569089059,318,Upregulated,10,5
pxpC,3778,3246,-0.2189597018403983,-532,Downregulated,10,5
pxpB,2126,1999,-0.0888631247864771,-127,Downregulated,10,5
ybgI,2940,2890,-0.024746662335685607,-50,Downregulated,10,5
dtpD,1059,3729,1.8160862077813047,2670,Upregulated,10,5
phr,887,2930,1.7238946550085463,2043,Upregulated,10,5
ybgA,438,770,0.8139275759810903,332,Upregulated,10,5
ybfD,63,563,3.1597111885803133,500,Upregulated,10,5
ybfL,66,1104,4.064130337419716,1038,Upregulated,10,5
ybfC,106,337,1.6686843266186593,231,Upregulated,10,5
ybfO,136,2421,4.153924522748597,2285,Upregulated,10,5
ybfB,20,18,-0.15200309344504995,-2,Unchanged,10,5
rhsC,1471,10618,2.8516428948689008,9147,Upregulated,10,5
ybfA,2277,251,-3.1813750221858506,-2026,Downregulated,10,5
kdpA,42,4335,6.689498855330437,4293,Upregulated,10,5
kdpB,220,6069,4.78588339175478,5849,Upregulated,10,5
kdpC,133,1235,3.2150128909708506,1102,Upregulated,10,5
kdpD,1830,8244,2.1715008563678513,6414,Upregulated,10,5
kdpE,187,1476,2.9805825461727595,1289,Upregulated,10,5
speF,70,4158,5.892391025913404,4088,Upregulated,10,5
potE,315,2476,2.9745875808269857,2161,Upregulated,10,5
ybfG,20,713,5.155830171556525,693,Upregulated,10,5
ybfP,47,438,3.220198207923536,391,Upregulated,10,5
pgm,13779,5872,-1.2305473160988876,-7907,Downregulated,10,5
seqA,2579,1436,-0.8447560239661627,-1143,Downregulated,10,5
ybfF,1322,1348,0.028098319674166743,26,Upregulated,10,5
ybfE,227,286,0.3333228494874745,59,Upregulated,10,5
fldA,3509,1495,-1.2309144633166993,-2014,Downregulated,10,5
fur,3036,1227,-1.3070365417525613,-1809,Downregulated,10,5
chiQ,33,320,3.277533975528909,287,Upregulated,10,5
chiP,92,2127,4.531042361903659,2035,Upregulated,10,5
glnS,4970,4363,-0.18792537807314874,-607,Downregulated,10,5
nagE,1753,3834,1.1290243409086127,2081,Upregulated,10,5
nagB,1465,985,-0.5727050349658716,-480,Downregulated,10,5
nagA,2314,2567,0.1496944314679285,253,Upregulated,10,5
nagC,2087,3113,0.5768749763093446,1026,Upregulated,10,5
umpH,2473,1850,-0.4187369689862633,-623,Downregulated,10,5
asnB,11711,4559,-1.3610749582311916,-7152,Downregulated,10,5
ubiF,1014,2940,1.5357585027203864,1926,Upregulated,10,5
miaB,5129,4111,-0.31918819941338006,-1018,Downregulated,10,5
ybeZ,4419,3751,-0.2364446680955357,-668,Downregulated,10,5
ybeY,1362,1208,-0.17310624868699223,-154,Downregulated,10,5
ybeX,5542,3226,-0.7806602723257742,-2316,Downregulated,10,5
lnt,1961,3240,0.724404277579838,1279,Upregulated,10,5
insH3,5086,3668,-0.471537823095052,-1418,Downregulated,10,5
gltI,2328,1803,-0.3686916614759422,-525,Downregulated,10,5
gltJ,234,934,1.9969140201262574,700,Upregulated,10,5
gltK,302,1044,1.7895012572448055,742,Upregulated,10,5
gltL,326,1234,1.9203985249183404,908,Upregulated,10,5
rihA,1101,1559,0.5018064591334157,458,Upregulated,10,5
hscC,143,2390,4.062923566089721,2247,Upregulated,10,5
djlC,182,1910,3.391562282724415,1728,Upregulated,10,5
ybeU,39,685,4.134557958985641,646,Upregulated,10,5
ybeT,1,392,8.614709844115207,391,Upregulated,10,5
djlB,51,1784,5.128474557948809,1733,Upregulated,10,5
ybeR,15,675,5.491853096329675,660,Upregulated,10,5
ybeQ,62,1100,4.149091498025147,1038,Upregulated,10,5
ybeL,2112,889,-1.2483545105286835,-1223,Downregulated,10,5
leuS,17258,8851,-0.9633529152638997,-8407,Downregulated,10,5
lptE,2392,1202,-0.9927804934869194,-1190,Downregulated,10,5
holA,1720,1713,-0.0058834135054613625,-7,Unchanged,10,5
nadD,594,764,0.3631097072349828,170,Upregulated,10,5
cobC,294,735,1.3219280948873624,441,Upregulated,10,5
rsfS,744,401,-0.8917003846531112,-343,Downregulated,10,5
rlmH,927,984,0.0860889767137092,57,Upregulated,10,5
mrdA,1735,3095,0.8350037466360037,1360,Upregulated,10,5
mrdB,1123,1828,0.7029081426574686,705,Upregulated,10,5
rlpA,3505,2300,-0.607780583066248,-1205,Downregulated,10,5
dacA,5294,2078,-1.3491625405911867,-3216,Downregulated,10,5
ybeD,867,346,-1.3252599555851103,-521,Downregulated,10,5
lipB,1228,1057,-0.2163351839874963,-171,Downregulated,10,5
ybeF,39,933,4.580331051989511,894,Upregulated,10,5
lipA,2513,2007,-0.32437005451803846,-506,Downregulated,10,5
tatE,377,151,-1.3200159739435855,-226,Downregulated,10,5
crcB,508,397,-0.355689489629208,-111,Downregulated,10,5
cspE,9436,734,-3.68432345039625,-8702,Downregulated,10,5
pagP,592,510,-0.2150999287700918,-82,Downregulated,10,5
dcuC,806,2157,1.4201744326324868,1351,Upregulated,10,5
dpiA,1051,838,-0.3267405202628268,-213,Downregulated,10,5
dpiB,1865,2775,0.5733121409822306,910,Upregulated,10,5
citC,6544,1529,-2.097584341580944,-5015,Downregulated,10,5
citD,3627,280,-3.6952780130253133,-3347,Downregulated,10,5
citE,17565,1522,-3.5286633126061884,-16043,Downregulated,10,5
citF,35674,3061,-3.5427980392116187,-32613,Downregulated,10,5
citX,8881,920,-3.2710163668036967,-7961,Downregulated,10,5
citG,2388,1148,-1.0566801945891173,-1240,Downregulated,10,5
citT,14439,2193,-2.718993112012435,-12246,Downregulated,10,5
rna,806,1711,1.085988015961446,905,Upregulated,10,5
rnk,886,704,-0.33173126991772117,-182,Downregulated,10,5
ybdR,1588,2099,0.40249125414919645,511,Upregulated,10,5
uspG,5319,1062,-2.324371270815691,-4257,Downregulated,10,5
ahpF,5126,6331,0.30459991693185695,1205,Upregulated,10,5
ahpC,18400,7356,-1.3227123814197999,-11044,Downregulated,10,5
dsbG,491,1101,1.1650195392496758,610,Upregulated,10,5
ybdO,29,625,4.429731384421878,596,Upregulated,10,5
ybdN,47,2228,5.566944665662394,2181,Upregulated,10,5
ybdM,134,1080,3.0107264065930583,946,Upregulated,10,5
ybdL,1558,2395,0.6203304225618733,837,Upregulated,10,5
hcxA,1912,3369,0.8172379051410089,1457,Upregulated,10,5
cstA,571,6499,3.508655097282057,5928,Upregulated,10,5
entH,42,745,4.148779192570764,703,Upregulated,10,5
entA,100,1547,3.951401291674311,1447,Upregulated,10,5
entB,95,2072,4.446952679355606,1977,Upregulated,10,5
entE,47,4299,6.515196543305664,4252,Upregulated,10,5
entC,21,3096,7.20387233336565,3075,Upregulated,10,5
fepB,66,2470,5.225901207113586,2404,Upregulated,10,5
entS,14,3182,7.828363198273443,3168,Upregulated,10,5
fepD,43,2669,5.955818835439868,2626,Upregulated,10,5
fepG,48,2789,5.860569718307156,2741,Upregulated,10,5
fepC,48,1976,5.363404730863522,1928,Upregulated,10,5
fepE,14,1776,6.987060944292502,1762,Upregulated,10,5
entF,399,9184,4.524661990453342,8785,Upregulated,10,5
fes,15,2305,7.263660439708182,2290,Upregulated,10,5
fepA,159,4194,4.721228190812237,4035,Upregulated,10,5
entD,21,678,5.012824040357583,657,Upregulated,10,5
insL2,1964,1840,-0.09408916337031785,-124,Downregulated,10,5
ybdK,648,1957,1.5945780377421792,1309,Upregulated,10,5
ybdJ,47,147,1.645083493158727,100,Upregulated,10,5
ybdF,259,368,0.506753668370459,109,Upregulated,10,5
nfsB,3393,1642,-1.047107302933172,-1751,Downregulated,10,5
ybdG,4126,2928,-0.49482826760244225,-1198,Downregulated,10,5
pheP,1564,2811,0.8458429410729909,1247,Upregulated,10,5
cusA,287,6000,4.3858398587075555,5713,Upregulated,10,5
cusB,79,1771,4.486567748574811,1692,Upregulated,10,5
cusF,13,279,4.423681593688095,266,Upregulated,10,5
cusC,25,2003,6.324090516037983,1978,Upregulated,10,5
cusR,556,1128,1.020610279675286,572,Upregulated,10,5
cusS,545,2203,2.015141360036594,1658,Upregulated,10,5
nfrB,321,4022,3.647267879183049,3701,Upregulated,10,5
nfrA,834,5608,2.7493670605659597,4774,Upregulated,10,5
ybcH,181,1260,2.7993621313040737,1079,Upregulated,10,5
envY,58,650,3.4863149127882447,592,Upregulated,10,5
ompT,109949,15187,-2.855925665843311,-94762,Downregulated,10,5
appY,1342,73,-4.200344397320166,-1269,Downregulated,10,5
tfaX,2,53,4.727920454563199,51,Upregulated,10,5
ybcY,27,384,3.8300749985576874,357,Upregulated,10,5
tfaD,18,478,4.7309418065384365,460,Upregulated,10,5
nohD,39,819,4.392317422778761,780,Upregulated,10,5
ybcW,157,55,-1.5132610353669675,-102,Downregulated,10,5
ybcV,12,13,0.11547721741993588,1,Unchanged,10,5
borD,4813,257,-4.227096158770994,-4556,Downregulated,10,5
rzpD,83,548,2.722992651613602,465,Upregulated,10,5
rrrD,51,414,3.0210616155278296,363,Upregulated,10,5
essD,7,45,2.6844981742720706,38,Upregulated,10,5
insH2,5183,3326,-0.6399992250974303,-1857,Downregulated,10,5
quuD,11,242,4.459431618637297,231,Upregulated,10,5
rusA,8,352,5.459431618637297,344,Upregulated,10,5
ybcO,4,226,5.820178962415188,222,Upregulated,10,5
ninE,1,27,4.754887502163468,26,Upregulated,10,5
ybcN,7,410,5.872125177447842,403,Upregulated,10,5
ybcM,646,288,-1.1654653532516126,-358,Downregulated,10,5
ybcL,132,378,1.5178483048626192,246,Upregulated,10,5
ybcK,25,446,4.15704371014558,421,Upregulated,10,5
emrE,116,87,-0.4150374992788438,-29,Downregulated,10,5
renD,1519,5201,1.775667168094117,3682,Upregulated,10,5
insF3,23,685,4.896398221790876,662,Upregulated,10,5
insE3,132,128,-0.044394119358453395,-4,Unchanged,10,5
exoD,4,276,6.108524456778169,272,Upregulated,10,5
intD,767,1675,1.1268626127295636,908,Upregulated,10,5
fimZ,18,192,3.415037499278844,174,Upregulated,10,5
sfmF,4,395,6.625708843064465,391,Upregulated,10,5
sfmH,23,939,5.351419391596762,916,Upregulated,10,5
sfmD,114,3380,4.889917517004805,3266,Upregulated,10,5
sfmC,4,543,7.084808387804362,539,Upregulated,10,5
sfmA,28,390,3.7999753916920067,362,Upregulated,10,5
folD,4243,2476,-0.7770733640764715,-1767,Downregulated,10,5
ybcJ,447,229,-0.964927233086374,-218,Downregulated,10,5
ybcI,74,938,3.6639907468864266,864,Upregulated,10,5
cysS,3271,3113,-0.07142618261359868,-158,Downregulated,10,5
ppiB,10047,2164,-2.2149923776010567,-7883,Downregulated,10,5
lpxH,1036,1731,0.7405817216800848,695,Upregulated,10,5
purE,2789,2029,-0.4589790692716531,-760,Downregulated,10,5
purK,5606,4585,-0.2900500105500771,-1021,Downregulated,10,5
ybcF,43,1744,5.341919570074828,1701,Upregulated,10,5
ylbF,64,1818,4.828136484194107,1754,Upregulated,10,5
fdrA,18,3604,7.645458294371227,3586,Upregulated,10,5
allD,25,1896,6.244887059123535,1871,Upregulated,10,5
allC,153,2715,4.149348639999072,2562,Upregulated,10,5
allE,386,1246,1.6906313157559214,860,Upregulated,10,5
glxK,132,2210,4.06543653492034,2078,Upregulated,10,5
ybbY,37,2610,6.140380725828297,2573,Upregulated,10,5
allB,87,3142,5.174523969445468,3055,Upregulated,10,5
ybbW,10,2416,7.916476644437717,2406,Upregulated,10,5
glxR,34,1684,5.630213581816057,1650,Upregulated,10,5
hyi,25,857,5.099295204337775,832,Upregulated,10,5
gcl,150,3592,4.581752944245266,3442,Upregulated,10,5
allR,4566,2143,-1.091299009548154,-2423,Downregulated,10,5
allA,92,849,3.2060587874960254,757,Upregulated,10,5
allS,46,1785,5.278146402859449,1739,Upregulated,10,5
selU,435,2561,2.5576199468613776,2126,Upregulated,10,5
ylbG,161,616,1.9358696625802845,455,Upregulated,10,5
ybbD,2,191,6.577428828035749,189,Upregulated,10,5
ylbH,25,603,4.59215800212536,578,Upregulated,10,5
ybbC,37,51,0.4629719763425457,14,Upregulated,10,5
rhsD,795,9827,3.6277242903545646,9032,Upregulated,10,5
ybbP,851,7405,3.1212686984902476,6554,Upregulated,10,5
ybbA,447,2034,2.1859729426741823,1587,Upregulated,10,5
tesA,654,1539,1.2346306908301277,885,Upregulated,10,5
ybbO,1202,2456,1.030873664658994,1254,Upregulated,10,5
cnoX,4477,3871,-0.20982601061123315,-606,Downregulated,10,5
fetB,459,1370,1.577609834434081,911,Upregulated,10,5
fetA,512,1093,1.0940776856719046,581,Upregulated,10,5
qmcA,2072,2847,0.4584184900557117,775,Upregulated,10,5
ybbJ,542,944,0.8004940080079697,402,Upregulated,10,5
cueR,905,855,-0.08199337219730746,-50,Downregulated,10,5
ybaT,4897,3296,-0.5711819535255476,-1601,Downregulated,10,5
glsA,2707,2125,-0.3492320463025373,-582,Downregulated,10,5
copA,8910,9491,0.09113467014986153,581,Upregulated,10,5
ybaQ,782,588,-0.411352452470988,-194,Downregulated,10,5
ybaP,910,2226,1.290515142255901,1316,Upregulated,10,5
ybaK,821,1051,0.3563085421843737,230,Upregulated,10,5
ushA,3058,4611,0.5924912590511229,1553,Upregulated,10,5
fsr,250,1988,2.991317756900199,1738,Upregulated,10,5
ybaL,2669,5400,1.016660101796227,2731,Upregulated,10,5
gsk,2047,3102,0.5996875840126802,1055,Upregulated,10,5
aes,122,2060,4.0776912845076945,1938,Upregulated,10,5
hemH,478,2308,2.271560700664734,1830,Upregulated,10,5
adk,9547,2153,-2.1486991398140236,-7394,Downregulated,10,5
htpG,15235,12864,-0.24405018839491935,-2371,Downregulated,10,5
recR,3471,2292,-0.5987443210717411,-1179,Downregulated,10,5
ybaB,2425,1321,-0.8763542807150246,-1104,Downregulated,10,5
dnaX,3164,6854,1.1151965920463824,3690,Upregulated,10,5
apt,1522,1568,0.042957200611662895,46,Upregulated,10,5
ybaN,54,681,3.6566234858486024,627,Upregulated,10,5
priC,592,1368,1.2083991492569481,776,Upregulated,10,5
ybaM,23,51,1.1488633859144828,28,Upregulated,10,5
mscK,2849,9773,1.7783458699855794,6924,Upregulated,10,5
acrR,308,768,1.3181759600262548,460,Upregulated,10,5
acrA,3209,3909,0.28467579500748336,700,Upregulated,10,5
acrB,11104,11074,-0.0039030460478649926,-30,Downregulated,10,5
tomB,118,224,0.9247118726957629,106,Upregulated,10,5
hha,160,201,0.32912359629156634,41,Upregulated,10,5
maa,325,1088,1.7431669333345226,763,Upregulated,10,5
ylaC,190,787,2.0503642171765386,597,Upregulated,10,5
pdeB,384,2214,2.527477006060396,1830,Upregulated,10,5
ybaA,67,429,2.678744647041773,362,Upregulated,10,5
ffs,2,6,1.584962500721156,4,Unchanged,10,5
ybaZ,192,492,1.3575520046180838,300,Upregulated,10,5
ybaY,1105,817,-0.4356383861331104,-288,Downregulated,10,5
tesB,784,1422,0.858995905504207,638,Upregulated,10,5
amtB,390,2511,2.686715999521889,2121,Upregulated,10,5
glnK,18,403,4.484711027085655,385,Upregulated,10,5
mdlB,374,3164,3.080639424585155,2790,Upregulated,10,5
mdlA,487,3202,2.7169796304339147,2715,Upregulated,10,5
decR,226,560,1.3091040545297787,334,Upregulated,10,5
cof,159,1119,2.815111365692039,960,Upregulated,10,5
ybaE,248,2614,3.397847115408558,2366,Upregulated,10,5
queC,529,1094,1.048273110678531,565,Upregulated,10,5
fadM,61,288,2.239187663879426,227,Upregulated,10,5
ybaV,164,414,1.3359349528812416,250,Upregulated,10,5
ppiD,6756,4998,-0.434818426714682,-1758,Downregulated,10,5
hupB,11231,888,-3.6607829031649928,-10343,Downregulated,10,5
lon,16664,12308,-0.4371383957071021,-4356,Downregulated,10,5
clpX,17133,7366,-1.2178244880777658,-9767,Downregulated,10,5
clpP,7476,2654,-1.4940981983749648,-4822,Downregulated,10,5
tig,23630,7237,-1.7071559525913556,-16393,Downregulated,10,5
bolA,1498,280,-2.4195388915137848,-1218,Downregulated,10,5
yajG,2246,1235,-0.8628468859285612,-1011,Downregulated,10,5
ampG,1180,2203,0.9006826354516795,1023,Upregulated,10,5
cyoA,90,1251,3.797012977836145,1161,Upregulated,10,5
cyoB,324,2943,3.1832218240557704,2619,Upregulated,10,5
cyoC,88,694,2.9793602339409637,606,Upregulated,10,5
cyoD,81,308,1.9269365378102767,227,Upregulated,10,5
cyoE,338,1303,1.9467419322859503,965,Upregulated,10,5
yajR,608,2110,1.7950997701509621,1502,Upregulated,10,5
yajQ,6016,2713,-1.1489155193957714,-3303,Downregulated,10,5
panE,1748,1690,-0.04868193833105162,-58,Downregulated,10,5
yajL,1432,1063,-0.4298898957331517,-369,Downregulated,10,5
thiI,3164,2925,-0.11331297511466266,-239,Downregulated,10,5
xseB,1026,373,-1.4597831953518163,-653,Downregulated,10,5
ispA,3515,2312,-0.6043832914592188,-1203,Downregulated,10,5
dxs,3729,4300,0.2055478627031816,571,Upregulated,10,5
yajO,1791,1975,0.1410873159658665,184,Upregulated,10,5
pgpA,1451,1277,-0.18428899436402066,-174,Downregulated,10,5
thiL,1102,1679,0.6074780063658725,577,Upregulated,10,5
nusB,2820,1084,-1.3793304059322844,-1736,Downregulated,10,5
ribE,1881,906,-1.05391689347696,-975,Downregulated,10,5
ribD,2395,2657,0.14977257186696405,262,Upregulated,10,5
nrdR,1299,1060,-0.29333716599731957,-239,Downregulated,10,5
yajI,404,570,0.4966066263003092,166,Upregulated,10,5
tsx,8516,2793,-1.608360376172344,-5723,Downregulated,10,5
yajD,677,317,-1.0946729934355894,-360,Downregulated,10,5
secF,3967,2681,-0.5652771781627194,-1286,Downregulated,10,5
secD,7855,5854,-0.42418852977280813,-2001,Downregulated,10,5
yajC,2403,817,-1.556428664984183,-1586,Downregulated,10,5
tgt,2831,2499,-0.17996084781904326,-332,Downregulated,10,5
queA,838,2284,1.4465405016634911,1446,Upregulated,10,5
acpH,310,697,1.1688904405941856,387,Upregulated,10,5
malZ,1538,3263,1.0851434841300376,1725,Upregulated,10,5
proY,1340,2392,0.8359843888529702,1052,Upregulated,10,5
brnQ,6619,3029,-1.1277716926731132,-3590,Downregulated,10,5
phoR,294,2701,3.199605579672603,2407,Upregulated,10,5
phoB,410,1412,1.7840442737657343,1002,Upregulated,10,5
sbcD,800,2094,1.3881895371560837,1294,Upregulated,10,5
sbcC,1553,6714,2.112114707310249,5161,Upregulated,10,5
araJ,324,2030,2.647414009187914,1706,Upregulated,10,5
mak,828,1859,1.1668240974201562,1031,Upregulated,10,5
rdgC,3510,2217,-0.662862260324616,-1293,Downregulated,10,5
ykiA,42,218,2.375866901998166,176,Upregulated,10,5
ppnP,1151,423,-1.4441582650122806,-728,Downregulated,10,5
aroM,322,1160,1.8489922119003175,838,Upregulated,10,5
yaiA,130,174,0.4205756828202737,44,Upregulated,10,5
aroL,673,1756,1.3836144349250412,1083,Upregulated,10,5
yaiI,301,773,1.3607049271651455,472,Upregulated,10,5
proC,2679,1822,-0.5561716220403283,-857,Downregulated,10,5
dgcC,77,1721,4.482244841345302,1644,Upregulated,10,5
psiF,173,295,0.7699429166124789,122,Upregulated,10,5
phoA,803,3799,2.242147819147708,2996,Upregulated,10,5
iraP,1126,493,-1.191547275702318,-633,Downregulated,10,5
ddlA,3671,2020,-0.8618178214603903,-1651,Downregulated,10,5
yaiZ,47,160,1.767339243209725,113,Upregulated,10,5
yaiY,485,422,-0.20074174836730485,-63,Downregulated,10,5
yaiW,1193,2233,0.9043892081272454,1040,Upregulated,10,5
sbmA,416,2326,2.4831956633321264,1910,Upregulated,10,5
ampH,937,2269,1.2759356560131505,1332,Upregulated,10,5
iprA,15,310,4.369233809665719,295,Upregulated,10,5
insE2,79,80,0.01814734671025952,1,Unchanged,10,5
insF2,23,556,4.595379116666495,533,Upregulated,10,5
hemB,2960,2919,-0.020122965014044487,-41,Downregulated,10,5
tauD,64,1482,4.533329732305834,1418,Upregulated,10,5
tauC,34,1582,5.5400710432224525,1548,Upregulated,10,5
tauB,40,1135,4.826548487290915,1095,Upregulated,10,5
tauA,20,2129,6.734032139564932,2109,Upregulated,10,5
yaiS,7,580,6.372554167957331,573,Upregulated,10,5
yaiP,61,1842,4.91632000852845,1781,Upregulated,10,5
insD1,465,1296,1.478763096889231,831,Upregulated,10,5
insC1,425,206,-1.0448185038418458,-219,Downregulated,10,5
yaiO,70,1135,4.019193565233311,1065,Upregulated,10,5
frmR,32,571,4.157346935362843,539,Upregulated,10,5
frmA,348,3853,3.4688229748108217,3505,Upregulated,10,5
frmB,57,1424,4.642843416801656,1367,Upregulated,10,5
yaiL,674,815,0.27405146793658136,141,Upregulated,10,5
mhpT,143,2410,4.074946094338935,2267,Upregulated,10,5
mhpE,61,2177,5.15738835462532,2116,Upregulated,10,5
mhpF,51,1802,5.142957953842043,1751,Upregulated,10,5
mhpD,39,1386,5.151309323274965,1347,Upregulated,10,5
mhpC,33,1868,5.822884620351209,1835,Upregulated,10,5
mhpB,12,1865,7.279997414421444,1853,Upregulated,10,5
mhpA,22,3827,7.442566567031198,3805,Upregulated,10,5
mhpR,50,1819,5.185073637876762,1769,Upregulated,10,5
lacI,971,2684,1.4668414707809911,1713,Upregulated,10,5
lacZ,38115,24033,-0.6653421271462036,-14082,Downregulated,10,5
lacY,2799,2464,-0.18390923087801353,-335,Downregulated,10,5
lacA,2089,1009,-1.0498863179607512,-1080,Downregulated,10,5
cynX,109,3069,4.815368605689558,2960,Upregulated,10,5
cynS,55,731,3.732367882427778,676,Upregulated,10,5
cynT,44,1523,5.113268607849995,1479,Upregulated,10,5
cynR,204,2122,3.378783598943269,1918,Upregulated,10,5
codA,13627,3555,-1.9385465211399973,-10072,Downregulated,10,5
codB,16339,3201,-2.351725106555469,-13138,Downregulated,10,5
prpE,84,5617,6.06326666479985,5533,Upregulated,10,5
prpD,41,4370,6.735865559769877,4329,Upregulated,10,5
prpC,27,2690,6.638502955280518,2663,Upregulated,10,5
prpB,11,2420,7.78135971352466,2409,Upregulated,10,5
prpR,36,3530,6.61552746671623,3494,Upregulated,10,5
yahO,750,152,-2.302819271939658,-598,Downregulated,10,5
yahN,85,1264,3.8943898120394014,1179,Upregulated,10,5
yahM,12,170,3.8244284354165456,158,Upregulated,10,5
yahL,23,627,4.768759676745026,604,Upregulated,10,5
yahK,1614,2520,0.6427831551094985,906,Upregulated,10,5
yahJ,1002,3537,1.8196437105057104,2535,Upregulated,10,5
yahI,47,2160,5.522226745373193,2113,Upregulated,10,5
yahG,92,3747,5.3479583062721,3655,Upregulated,10,5
yahF,68,3626,5.7367003684938185,3558,Upregulated,10,5
yahE,35,1183,5.078951341394822,1148,Upregulated,10,5
yahD,81,639,2.9798221180623696,558,Upregulated,10,5
yahC,23,879,5.2561573990863915,856,Upregulated,10,5
yahB,192,1467,2.9336906549522337,1275,Upregulated,10,5
pdeL,2092,2088,-0.0027611396770568656,-4,Unchanged,10,5
betT,318,4523,3.8301813253470556,4205,Upregulated,10,5
betI,305,1482,2.280664299855585,1177,Upregulated,10,5
betB,866,4573,2.400701989080239,3707,Upregulated,10,5
betA,494,4160,3.074000581443777,3666,Upregulated,10,5
ykgH,5,283,5.82273014794452,278,Upregulated,10,5
ykgG,153,1321,3.110026908554176,1168,Upregulated,10,5
ykgF,427,2914,2.770692902444022,2487,Upregulated,10,5
ykgE,77,1192,3.95238197976726,1115,Upregulated,10,5
rclR,71,1419,4.320911754555869,1348,Upregulated,10,5
rclA,543,1676,1.62599804589499,1133,Upregulated,10,5
rclB,6,40,2.736965594166206,34,Upregulated,10,5
rclC,43,599,3.8001474380866878,556,Upregulated,10,5
ykgA,164,648,1.982297998266541,484,Upregulated,10,5
insF1,30,351,3.548436624696042,321,Upregulated,10,5
insE1,70,89,0.34645041402143123,19,Upregulated,10,5
eaeH,10,1059,6.726558779104974,1049,Upregulated,10,5
ykgM,6,105,4.129283016944966,99,Upregulated,10,5
ykgL,11,35,1.669851398307669,24,Upregulated,10,5
ecpR,193,312,0.6929451815941678,119,Upregulated,10,5
ecpA,1126,873,-0.36715326845078944,-253,Downregulated,10,5
ecpB,193,1083,2.4883604903402468,890,Upregulated,10,5
ecpC,469,4713,3.328985853499976,4244,Upregulated,10,5
ecpD,431,2405,2.480277119568306,1974,Upregulated,10,5
ecpE,195,1016,2.381354373022555,821,Upregulated,10,5
ykgJ,80,326,2.0268000593437154,246,Upregulated,10,5
yagU,7525,1179,-2.674127863554664,-6346,Downregulated,10,5
paoA,153,1570,3.3591610010863375,1417,Upregulated,10,5
paoB,175,2281,3.7042396194798086,2106,Upregulated,10,5
paoC,476,5693,3.5801556210832026,5217,Upregulated,10,5
paoD,214,2674,3.643316763692206,2460,Upregulated,10,5
intF,2685,3552,0.4037094934773309,867,Upregulated,10,5
yagN,1014,572,-0.8259706002249511,-442,Downregulated,10,5
yagM,18,256,3.8300749985576874,238,Upregulated,10,5
yagL,29,285,3.296837113924532,256,Upregulated,10,5
yagK,133,768,2.5296800652199667,635,Upregulated,10,5
yagJ,170,1756,3.3686861933976564,1586,Upregulated,10,5
insA3,35,320,3.192645077942396,285,Upregulated,10,5
insB3,86,1523,4.146435471785194,1437,Upregulated,10,5
argF,1092,5038,2.2058782658143885,3946,Upregulated,10,5
xynR,739,2431,1.7179036238825778,1692,Upregulated,10,5
yagH,1344,5885,2.130509277147046,4541,Upregulated,10,5
yagG,917,4804,2.3892425121105796,3887,Upregulated,10,5
yagF,553,6133,3.4712415654059843,5580,Upregulated,10,5
yagE,247,2714,3.457837773834177,2467,Upregulated,10,5
yagA,24,3061,6.994824828805835,3037,Upregulated,10,5
yagB,140,454,1.6972654703459484,314,Upregulated,10,5
insA2,49,420,3.0995356735509145,371,Upregulated,10,5
insB2,137,1026,2.9047829326465275,889,Upregulated,10,5
afuB,13,723,5.797412118810025,710,Upregulated,10,5
afuC,73,2857,5.290460762056354,2784,Upregulated,10,5
mmuM,922,2421,1.3927644235695986,1499,Upregulated,10,5
mmuP,690,3402,2.3017148739978537,2712,Upregulated,10,5
insH1,1717,3867,1.171324725080673,2150,Upregulated,10,5
ykfC,398,2407,2.596395805930848,2009,Upregulated,10,5
insI1,38,36,-0.07800251200127321,-2,Unchanged,10,5
perR,105,1528,3.8631833103696263,1423,Upregulated,10,5
ykfA,98,1401,3.83753139631561,1303,Upregulated,10,5
yafZ,13,1392,6.742503777707636,1379,Upregulated,10,5
yafY,26,405,3.9613383796308947,379,Upregulated,10,5
ykfB,199,666,1.7427537465276133,467,Upregulated,10,5
ykfF,25,264,3.400537929583729,239,Upregulated,10,5
yafX,193,841,2.123504952987064,648,Upregulated,10,5
ykfG,30,753,4.649615459063409,723,Upregulated,10,5
yafW,29,438,3.9168060644736014,409,Upregulated,10,5
ykfI,13,288,4.46948528330122,275,Upregulated,10,5
proA,4837,3447,-0.48877123907859327,-1390,Downregulated,10,5
proB,4802,3678,-0.3847139238184788,-1124,Downregulated,10,5
phoE,29,1090,5.232131424536717,1061,Upregulated,10,5
crl,1340,5219,1.961540401275384,3879,Upregulated,10,5
frsA,2630,2974,0.1773418478727541,344,Upregulated,10,5
gpt,2604,538,-2.2750513706090114,-2066,Downregulated,10,5
pepD,16229,5064,-1.6802247966312664,-11165,Downregulated,10,5
prfH,13,644,5.630477159973525,631,Upregulated,10,5
ykfJ,1,74,6.20945336562895,73,Upregulated,10,5
yafP,55,337,2.6152450676571988,282,Upregulated,10,5
yafO,81,303,1.9033239805883262,222,Upregulated,10,5
yafN,129,210,0.7030182622428686,81,Upregulated,10,5
dinB,1003,2105,1.0694986273415776,1102,Upregulated,10,5
lafU,62,898,3.8563753243542718,836,Upregulated,10,5
lfhA,70,2642,5.238131734301861,2572,Upregulated,10,5
rayT,213,419,0.9760968134735133,206,Upregulated,10,5
yafL,92,957,3.3788131584290126,865,Upregulated,10,5
dinJ,620,294,-1.0764520604378731,-326,Downregulated,10,5
yafQ,299,177,-0.7563961241151075,-122,Downregulated,10,5
ldtF,1510,934,-0.6930540945027793,-576,Downregulated,10,5
yafJ,1260,1166,-0.11185594518678231,-94,Downregulated,10,5
gmhA,3326,1753,-0.923962172527731,-1573,Downregulated,10,5
fadE,380,4336,3.512293433022924,3956,Upregulated,10,5
ivy,29038,2907,-3.3203391141626644,-26131,Downregulated,10,5
yafV,755,1097,0.5390149761907516,342,Upregulated,10,5
yafU,2,115,5.845490050944375,113,Upregulated,10,5
yafT,39,546,3.807354922057604,507,Upregulated,10,5
dnaQ,1774,1192,-0.5736217738389024,-582,Downregulated,10,5
rnhA,404,533,0.39978024000738116,129,Upregulated,10,5
yafS,498,701,0.4932687019425422,203,Upregulated,10,5
gloB,457,575,0.33136779077366796,118,Upregulated,10,5
mltD,6965,2992,-1.2190131776009787,-3973,Downregulated,10,5
yafE,268,588,1.133583154378592,320,Upregulated,10,5
yafD,2492,1788,-0.4789573318406841,-704,Downregulated,10,5
yafC,561,1334,1.2496859905757922,773,Upregulated,10,5
dkgB,225,648,1.5260688116675876,423,Upregulated,10,5
gmhB,710,586,-0.2769183599697965,-124,Downregulated,10,5
metN,10879,2560,-2.0873302345090456,-8319,Downregulated,10,5
metI,4930,1454,-1.7615603773456796,-3476,Downregulated,10,5
metQ,21292,2202,-3.273425097361117,-19090,Downregulated,10,5
rcsF,1432,673,-1.0893530826539393,-759,Downregulated,10,5
trmO,1062,1145,0.10856383218015271,83,Upregulated,10,5
proS,10167,4531,-1.1659926466917614,-5636,Downregulated,10,5
yaeF,61,896,3.876617584494718,835,Upregulated,10,5
nlpE,768,1121,0.5456080620842706,353,Upregulated,10,5
arfB,333,619,0.8944172321430025,286,Upregulated,10,5
yaeQ,566,989,0.8051684679272285,423,Upregulated,10,5
rof,1094,336,-1.7030796000137962,-758,Downregulated,10,5
tilS,1674,2348,0.4881328805597085,674,Upregulated,10,5
yaeR,330,418,0.3410369178350669,88,Upregulated,10,5
ldcC,1860,3413,0.8757377931034717,1553,Upregulated,10,5
accA,5631,2604,-1.112661702386395,-3027,Downregulated,10,5
dnaE,6065,7506,0.30753664487910326,1441,Upregulated,10,5
rnhB,1058,1287,0.282672426106676,229,Upregulated,10,5
lpxB,3900,3379,-0.20687777347317152,-521,Downregulated,10,5
lpxA,5579,3083,-0.8556716619409007,-2496,Downregulated,10,5
fabZ,3247,1462,-1.1511640733336508,-1785,Downregulated,10,5
lpxD,22317,4821,-2.2107387686637288,-17496,Downregulated,10,5
skp,13479,2175,-2.6316261616211416,-11304,Downregulated,10,5
bamA,23333,8136,-1.5199802269520264,-15197,Downregulated,10,5
rseP,7681,3889,-0.9818949148622766,-3792,Downregulated,10,5
cdsA,3120,1808,-0.7871513513344228,-1312,Downregulated,10,5
uppS,3244,1321,-1.2961433529704454,-1923,Downregulated,10,5
dxr,1423,2224,0.644221126197025,801,Upregulated,10,5
frr,9176,2046,-2.1650592462704963,-7130,Downregulated,10,5
pyrH,6446,2314,-1.4780153239520553,-4132,Downregulated,10,5
tsf,26993,6595,-2.033140762144993,-20398,Downregulated,10,5
rpsB,49068,9015,-2.4443830719278177,-40053,Downregulated,10,5
map,3894,1640,-1.2475570692148488,-2254,Downregulated,10,5
glnD,3717,4862,0.3874112051669712,1145,Upregulated,10,5
dapD,9718,3613,-1.4274621776848422,-6105,Downregulated,10,5
yaeI,218,969,2.152168530638155,751,Upregulated,10,5
yaeH,1102,437,-1.3344190390705593,-665,Downregulated,10,5
cdaR,234,1737,2.8920173191269885,1503,Upregulated,10,5
degP,8840,7139,-0.3083243676423581,-1701,Downregulated,10,5
dgt,1210,2212,0.8703443380727502,1002,Upregulated,10,5
mtn,2775,2447,-0.18147367004544102,-328,Downregulated,10,5
btuF,455,1461,1.6830177277174398,1006,Upregulated,10,5
yadS,192,945,2.299208018387279,753,Upregulated,10,5
erpA,1638,749,-1.1288977331822576,-889,Downregulated,10,5
clcA,1423,3073,1.1107121050664799,1650,Upregulated,10,5
hemL,6309,4937,-0.35377670571183883,-1372,Downregulated,10,5
fhuB,289,4831,4.063180454931398,4542,Upregulated,10,5
fhuD,183,1865,3.349260076858558,1682,Upregulated,10,5
fhuC,240,1911,2.993221467368938,1671,Upregulated,10,5
fhuA,812,4226,2.3797411347497643,3414,Upregulated,10,5
mrcB,3223,6379,0.9849260901198685,3156,Upregulated,10,5
hrpB,2277,6513,1.516187935199678,4236,Upregulated,10,5
thpR,338,842,1.3167969867842118,504,Upregulated,10,5
sfsA,796,1123,0.4965175918569524,327,Upregulated,10,5
dksA,5898,1898,-1.6357458300406276,-4000,Downregulated,10,5
gluQ,257,1532,2.575576032731079,1275,Upregulated,10,5
pcnB,7003,4320,-0.6969417750889682,-2683,Downregulated,10,5
folK,364,621,0.7706548180217851,257,Upregulated,10,5
yadN,7,534,6.25334100962995,527,Upregulated,10,5
yadV,8,686,6.422064766172812,678,Upregulated,10,5
htrE,90,2363,4.714550817644172,2273,Upregulated,10,5
yadM,45,400,3.15200309344505,355,Upregulated,10,5
yadL,68,365,2.4242898125170402,297,Upregulated,10,5
yadK,19,312,4.037474705418663,293,Upregulated,10,5
yadC,68,607,3.1580898650053424,539,Upregulated,10,5
panB,7600,4583,-0.7297071328439977,-3017,Downregulated,10,5
panC,9902,4616,-1.1010767253166782,-5286,Downregulated,10,5
rpnC,118,1048,3.150779952175609,930,Upregulated,10,5
panD,3277,590,-2.4735888132935564,-2687,Downregulated,10,5
yadE,379,1857,2.2927040617643293,1478,Upregulated,10,5
yadI,187,516,1.4643327955356173,329,Upregulated,10,5
yadH,773,1126,0.5426665081553823,353,Upregulated,10,5
yadG,974,1747,0.8428859308344173,773,Upregulated,10,5
can,1783,1054,-0.7584318359877802,-729,Downregulated,10,5
hpt,1728,1087,-0.6687512771361593,-641,Downregulated,10,5
gcd,365,4715,3.6912894017950793,4350,Upregulated,10,5
cueO,1526,2906,0.9292797407983108,1380,Upregulated,10,5
yacC,374,449,0.26367717485351017,75,Upregulated,10,5
speE,3965,2539,-0.6430604709438351,-1426,Downregulated,10,5
speD,5051,1945,-1.3767988865576484,-3106,Downregulated,10,5
yacL,367,499,0.44325975249404775,132,Upregulated,10,5
acnB,11551,12248,0.08452843305444614,697,Upregulated,10,5
yacH,108,3410,4.980668521748067,3302,Upregulated,10,5
lpd,4924,9621,0.9663560926783457,4697,Upregulated,10,5
aceF,3333,15117,2.1812786395806607,11784,Upregulated,10,5
aceE,4427,20500,2.2112226311823053,16073,Upregulated,10,5
pdhR,214,3051,3.833599478177509,2837,Upregulated,10,5
aroP,1341,3309,1.303086054408065,1968,Upregulated,10,5
ampE,966,1616,0.7423321039160216,650,Upregulated,10,5
ampD,585,977,0.7399219374976185,392,Upregulated,10,5
nadC,880,1755,0.9958956016672635,875,Upregulated,10,5
ppdD,6,668,6.798741791752896,662,Upregulated,10,5
hofB,207,2662,3.6848078984125667,2455,Upregulated,10,5
hofC,144,2558,4.150875547439325,2414,Upregulated,10,5
guaC,8293,2263,-1.8736575077294848,-6030,Downregulated,10,5
coaE,500,1018,1.0257375614136082,518,Upregulated,10,5
zapD,1011,1439,0.5092835948372834,428,Upregulated,10,5
yacG,75,157,1.0658020583957462,82,Upregulated,10,5
mutT,74,281,1.9249729545919763,207,Upregulated,10,5
secA,8479,11743,0.46983499204021323,3264,Upregulated,10,5
secM,1363,1227,-0.15165031314230443,-136,Downregulated,10,5
lpxC,40225,24484,-0.716253147691607,-15741,Downregulated,10,5
ftsZ,22718,8607,-1.4002534575093086,-14111,Downregulated,10,5
ftsA,5696,4396,-0.37375776001716665,-1300,Downregulated,10,5
ftsQ,3490,2794,-0.3208950156875514,-696,Downregulated,10,5
ddlB,5291,3034,-0.8023193321603057,-2257,Downregulated,10,5
murC,6363,4643,-0.45464984068504954,-1720,Downregulated,10,5
murG,3622,2956,-0.2931402768040169,-666,Downregulated,10,5
ftsW,3563,3704,0.05599161512693684,141,Upregulated,10,5
murD,5300,4248,-0.31920859353377024,-1052,Downregulated,10,5
mraY,3504,2775,-0.3365150034763427,-729,Downregulated,10,5
murF,6004,4034,-0.573712893007727,-1970,Downregulated,10,5
murE,7043,4850,-0.5382053354274857,-2193,Downregulated,10,5
ftsI,3873,4417,0.18961533101180636,544,Upregulated,10,5
ftsL,783,608,-0.3649409838474552,-175,Downregulated,10,5
rsmH,5264,3646,-0.5298449276961072,-1618,Downregulated,10,5
mraZ,2814,1921,-0.5507648095710056,-893,Downregulated,10,5
cra,4031,3394,-0.24815121830841616,-637,Downregulated,10,5
ilvH,1567,1606,0.03546671304473432,39,Upregulated,10,5
ilvI,6468,6503,0.007785744966595214,35,Upregulated,10,5
leuO,356,1323,1.8938639153122792,967,Upregulated,10,5
leuL,1,1,0.0,0,Unchanged,10,5
leuA,9070,4953,-0.8727999297814705,-4117,Downregulated,10,5
leuB,9512,3489,-1.4469351175512815,-6023,Downregulated,10,5
leuC,13063,5585,-1.225857073092109,-7478,Downregulated,10,5
leuD,4945,1867,-1.4052485934202712,-3078,Downregulated,10,5
setA,654,2432,1.894780687945503,1778,Upregulated,10,5
sgrR,629,4527,2.8474233843685504,3898,Upregulated,10,5
thiB,676,2262,1.7425037777076362,1586,Upregulated,10,5
thiP,254,3743,3.8812946461277957,3489,Upregulated,10,5
thiQ,147,1537,3.3862291048544066,1390,Upregulated,10,5
yabI,336,1797,2.4190572707311815,1461,Upregulated,10,5
araC,558,2223,1.9941709211978025,1665,Upregulated,10,5
araB,96,4012,5.385143389891025,3916,Upregulated,10,5
araA,169,3659,4.436354264056903,3490,Upregulated,10,5
araD,34,1458,5.422312163076597,1424,Upregulated,10,5
polB,1148,4883,2.0886451359617757,3735,Upregulated,10,5
rapA,1702,6270,1.8812344060034387,4568,Upregulated,10,5
rluA,323,1135,1.8130862274843524,812,Upregulated,10,5
djlA,683,1745,1.353269552806924,1062,Upregulated,10,5
lptD,15687,8100,-0.9535756629086479,-7587,Downregulated,10,5
surA,9386,5589,-0.7479202853654693,-3797,Downregulated,10,5
pdxA,2187,2558,0.22606304383354378,371,Upregulated,10,5
rsmA,3304,2135,-0.6299776169115925,-1169,Downregulated,10,5
apaG,1093,832,-0.3936379675308125,-261,Downregulated,10,5
apaH,1602,1895,0.2423237006497438,293,Upregulated,10,5
folA,663,764,0.2045637679231608,101,Upregulated,10,5
kefC,818,4462,2.4475177653023916,3644,Upregulated,10,5
kefF,220,912,2.0515303006400822,692,Upregulated,10,5
yaaU,31,2853,6.524067721194845,2822,Upregulated,10,5
fixX,5,294,5.877744249949002,289,Upregulated,10,5
fixC,46,2992,6.023332503830623,2946,Upregulated,10,5
fixB,59,2155,5.190829104614619,2096,Upregulated,10,5
fixA,58,1677,4.853685978436774,1619,Upregulated,10,5
caiT,36,2922,6.3428154613611865,2886,Upregulated,10,5
caiA,466,2368,2.3452672209746694,1902,Upregulated,10,5
caiB,244,2260,3.211369719739664,2016,Upregulated,10,5
caiC,312,2861,3.196901563460935,2549,Upregulated,10,5
caiD,56,1653,4.883516087234709,1597,Upregulated,10,5
caiE,49,1168,4.575114714764809,1119,Upregulated,10,5
caiF,2125,1004,-1.0817035719616543,-1121,Downregulated,10,5
carB,87261,11084,-2.976858390979492,-76177,Downregulated,10,5
carA,39642,3752,-3.4012980175830543,-35890,Downregulated,10,5
dapB,2670,1893,-0.4961653308712111,-777,Downregulated,10,5
rihC,369,2201,2.576466423831161,1832,Upregulated,10,5
ispH,3204,3048,-0.0720112449153881,-156,Downregulated,10,5
fkpB,1220,1102,-0.14675692387909103,-118,Downregulated,10,5
lspA,2428,1585,-0.6152855812289125,-843,Downregulated,10,5
ileS,26188,16243,-0.6890877684242107,-9945,Downregulated,10,5
ribF,5326,3097,-0.7821810455359511,-2229,Downregulated,10,5
yaaY,16,143,3.1598713367783895,127,Upregulated,10,5
rpsT,3080,393,-2.9703291333236574,-2687,Downregulated,10,5
insA1,18,180,3.321928094887362,162,Upregulated,10,5
insB1,37,444,3.584962500721156,407,Upregulated,10,5
nhaR,999,1918,0.9410461372257125,919,Upregulated,10,5
nhaA,4014,5155,0.36093181089285364,1141,Upregulated,10,5
mokC,20,112,2.4854268271702415,92,Upregulated,10,5
insL1,1370,2634,0.9430794524086253,1264,Upregulated,10,5
dnaJ,4436,7278,0.7142826856799565,2842,Upregulated,10,5
dnaK,59018,42708,-0.4666486929157538,-16310,Downregulated,10,5
yaaI,10,571,5.83541884047548,561,Upregulated,10,5
yaaW,51,1140,4.482392767080609,1089,Upregulated,10,5
satP,321,1268,1.981909543017104,947,Upregulated,10,5
mog,716,1296,0.8560342256203683,580,Upregulated,10,5
talB,30807,7264,-2.0844220911612354,-23543,Downregulated,10,5
yaaJ,622,2970,2.255476445557526,2348,Upregulated,10,5
yaaA,1210,1732,0.5174318825647681,522,Upregulated,10,5
yaaX,114,320,1.4890380807226207,206,Upregulated,10,5
thrC,8008,11992,0.5825584091118661,3984,Upregulated,10,5
thrB,5969,11160,0.9027758682667467,5191,Upregulated,10,5
thrA,18297,38832,1.0856388918640891,20535,Upregulated,10,5
thrL,1,1,0.0,0,Unchanged,10,5
sokX,1,1,0.0,0,Unchanged,100,5
sokE,1,1,0.0,0,Unchanged,100,5
fnrS,1,2,1.0,1,Unchanged,100,5
mgrR,1,1,0.0,0,Unchanged,100,5
yrdF,2,5,1.3219280948873624,3,Unchanged,100,5
yneO,1069,5385,2.3326844917110794,4316,Upregulated,100,5
aaaE,138,1397,3.339591848631294,1259,Upregulated,100,5
oweE,13,123,3.2420747871981477,110,Upregulated,100,5
sroH,2,16,3.0,14,Unchanged,100,5
eyeA,1,1,0.0,0,Unchanged,100,5
rzoQ,2,22,3.4594316186372973,20,Unchanged,100,5
ykgS,29,83,1.5170584362193527,54,Unchanged,100,5
shoB,1,1,0.0,0,Unchanged,100,5
yshB,4,2,-1.0,-2,Unchanged,100,5
yrbN,1,1,0.0,0,Unchanged,100,5
yqfG,1,1,0.0,0,Unchanged,100,5
yqeL,1,1,0.0,0,Unchanged,100,5
yqcG,1,1,0.0,0,Unchanged,100,5
ypdK,1,1,0.0,0,Unchanged,100,5
yohP,1,1,0.0,0,Unchanged,100,5
yoeI,1,1,0.0,0,Unchanged,100,5
yobI,1,1,0.0,0,Unchanged,100,5
yoaK,1,1,0.0,0,Unchanged,100,5
yoaJ,1,1,0.0,0,Unchanged,100,5
ynbG,1,1,0.0,0,Unchanged,100,5
ymjD,1,1,0.0,0,Unchanged,100,5
ymiB,1,1,0.0,0,Unchanged,100,5
ykgR,1,1,0.0,0,Unchanged,100,5
yjeV,1,1,0.0,0,Unchanged,100,5
ilvX,1,1,0.0,0,Unchanged,100,5
ibsB,1,1,0.0,0,Unchanged,100,5
ibsA,1,1,0.0,0,Unchanged,100,5
ibsE,1,1,0.0,0,Unchanged,100,5
ibsC,1,1,0.0,0,Unchanged,100,5
ibsD,1,1,0.0,0,Unchanged,100,5
azuC,1,1,0.0,0,Unchanged,100,5
sgrT,5,10,1.0,5,Unchanged,100,5
yfcU,353,3690,3.385880727676578,3337,Upregulated,100,5
yhiL,32,433,3.758223214726725,401,Upregulated,100,5
yghX,317,1052,1.730579959152895,735,Upregulated,100,5
yjhZ,2,70,5.129283016944966,68,Unchanged,100,5
yjhY,311,271,-0.19862172877673107,-40,Unchanged,100,5
ythA,1,1,0.0,0,Unchanged,100,5
yjdQ,1,12,3.584962500721156,11,Unchanged,100,5
yicT,1,8,3.0,7,Unchanged,100,5
yibU,1,47,5.554588851677638,46,Unchanged,100,5
yibW,3,83,4.7900769306257684,80,Unchanged,100,5
yibS,3,105,5.129283016944966,102,Upregulated,100,5
ysaD,1,79,6.303780748177103,78,Unchanged,100,5
ysaC,1,1,0.0,0,Unchanged,100,5
mokA,1,15,3.9068905956085187,14,Unchanged,100,5
yrdE,18,203,3.495410915742864,185,Upregulated,100,5
psaA,1,1,0.0,0,Unchanged,100,5
ypjI,5,176,5.137503523749935,171,Upregulated,100,5
pawZ,1,1,0.0,0,Unchanged,100,5
yoeD,1,4,2.0,3,Unchanged,100,5
yoeH,27,18,-0.5849625007211563,-9,Unchanged,100,5
yoeG,160,321,1.0045013922349408,161,Upregulated,100,5
yeeH,1,1,0.0,0,Unchanged,100,5
ttcC,1,1,0.0,0,Unchanged,100,5
uof,1,1,0.0,0,Unchanged,100,5
ybfI,1,14,3.807354922057604,13,Unchanged,100,5
aaaD,6,264,5.459431618637297,258,Upregulated,100,5
xisD,77,169,1.1340928955872829,92,Unchanged,100,5
ylbI,1,1,0.0,0,Unchanged,100,5
ykgQ,1,1,0.0,0,Unchanged,100,5
ykgP,1,1,0.0,0,Unchanged,100,5
ykfK,2,92,5.523561956057013,90,Unchanged,100,5
ykfL,8,186,4.539158811108031,178,Upregulated,100,5
ykfN,1,1,0.0,0,Unchanged,100,5
symR,1,1,0.0,0,Unchanged,100,5
ryjB,1,1,0.0,0,Unchanged,100,5
insO,334,3978,3.5741232683596915,3644,Upregulated,100,5
ytcA,1,290,8.179909090014934,289,Upregulated,100,5
yjbS,1,7,2.807354922057604,6,Unchanged,100,5
yjbT,8,164,4.357552004618084,156,Upregulated,100,5
tisB,1,1,0.0,0,Unchanged,100,5
istR,1,21,4.392317422778761,20,Unchanged,100,5
yibV,3,94,4.9696263509564815,91,Unchanged,100,5
sokA,1,1,0.0,0,Unchanged,100,5
dinQ,2,7,1.8073549220576042,5,Unchanged,100,5
yrhD,1,2,1.0,1,Unchanged,100,5
sibE,3,3,0.0,0,Unchanged,100,5
ryfD,13,3,-2.115477217419936,-10,Unchanged,100,5
ohsC,1,1,0.0,0,Unchanged,100,5
ypfM,1,1,0.0,0,Unchanged,100,5
yojO,1,13,3.700439718141092,12,Unchanged,100,5
rseX,1,1,0.0,0,Unchanged,100,5
cydH,1,1,0.0,0,Unchanged,100,5
ydgU,1,1,0.0,0,Unchanged,100,5
mgtS,1,1,0.0,0,Unchanged,100,5
yncL,1,1,0.0,0,Unchanged,100,5
rydC,1,1,0.0,0,Unchanged,100,5
yciZ,212,57,-1.8950304403984575,-155,Downregulated,100,5
yciY,161,39,-2.0455146592523685,-122,Downregulated,100,5
ymgJ,6,8,0.41503749927884376,2,Unchanged,100,5
ymgI,1,3,1.584962500721156,2,Unchanged,100,5
appX,1,1,0.0,0,Unchanged,100,5
ybfK,1,97,6.599912842187128,96,Unchanged,100,5
ylcI,30,66,1.1375035237499351,36,Unchanged,100,5
ylcH,1,3,1.584962500721156,2,Unchanged,100,5
insN,1725,3383,0.9717068152410945,1658,Upregulated,100,5
ykfM,6,7,0.22239242133644802,1,Unchanged,100,5
chiX,1,1,0.0,0,Unchanged,100,5
yoeA,384,2481,2.6917435191712746,2097,Upregulated,100,5
ybeM,368,1091,1.5678734302665942,723,Upregulated,100,5
yaiT,548,5158,3.234563974828687,4610,Upregulated,100,5
yncK,14,232,4.050626073069968,218,Upregulated,100,5
sgrS,52,86,0.7258250365610057,34,Unchanged,100,5
insB7,37,824,4.477047161554268,787,Upregulated,100,5
yjgX,499,1673,1.745325724701092,1174,Upregulated,100,5
insZ,103,1383,3.7470849139672757,1280,Upregulated,100,5
ylbE,82,3030,5.20755007374223,2948,Upregulated,100,5
lomR,148,2885,4.284902237903895,2737,Upregulated,100,5
yhcE,1924,8506,2.144372055855722,6582,Upregulated,100,5
ytjA,336,72,-2.222392421336448,-264,Downregulated,100,5
yjjZ,6,136,4.502500340529183,130,Upregulated,100,5
topAI,23,98,2.0911478880581953,75,Unchanged,100,5
sgcB,7,172,4.618909832644494,165,Upregulated,100,5
insM,19,45,1.2439255828860891,26,Unchanged,100,5
ghoT,2,6,1.584962500721156,4,Unchanged,100,5
yifL,297,143,-1.0544477840223765,-154,Downregulated,100,5
yidD,474,222,-1.0943273825481532,-252,Downregulated,100,5
ysdC,69,1626,4.558587085296859,1557,Upregulated,100,5
yicS,31,198,2.6751603096927346,167,Upregulated,100,5
yibT,231,122,-0.9210117038531713,-109,Downregulated,100,5
ysaB,34,230,2.7580272096940357,196,Upregulated,100,5
yrhC,7,137,4.290677160902923,130,Upregulated,100,5
yheV,29,32,0.14201900487242786,3,Unchanged,100,5
arfA,59,39,-0.5972408304995929,-20,Unchanged,100,5
ypjJ,1,78,6.285402218862249,77,Unchanged,100,5
ypfN,80,151,0.9164766444377165,71,Unchanged,100,5
ypeB,91,111,0.28662122615140984,20,Unchanged,100,5
ypdJ,1,1,0.0,0,Unchanged,100,5
arnE,34,305,3.1652025911999093,271,Upregulated,100,5
ypaA,50,53,0.08406426478847455,3,Unchanged,100,5
yohO,1,1,0.0,0,Unchanged,100,5
yehK,1,94,6.554588851677638,93,Unchanged,100,5
yoeB,153,170,0.15200309344505006,17,Unchanged,100,5
yoeF,1,10,3.321928094887362,9,Unchanged,100,5
yecJ,185,148,-0.3219280948873623,-37,Unchanged,100,5
yobH,203,65,-1.6429681041567217,-138,Downregulated,100,5
yniD,1,2,1.0,1,Unchanged,100,5
ynfO,16,90,2.4918530963296748,74,Unchanged,100,5
hicA,39,37,-0.07594885323329863,-2,Unchanged,100,5
ydbJ,957,354,-1.4347695644030283,-603,Downregulated,100,5
rzoR,4,5,0.32192809488736235,1,Unchanged,100,5
ydaF,2,31,3.9541963103868754,29,Unchanged,100,5
ydaE,3,9,1.584962500721156,6,Unchanged,100,5
ymjC,2,3,0.5849625007211562,1,Unchanged,100,5
ymjB,29,1743,5.909375858998113,1714,Upregulated,100,5
yciX,30,29,-0.0489096004809464,-1,Unchanged,100,5
ymiA,3,11,1.874469117916141,8,Unchanged,100,5
ycgI,32,227,2.826548487290915,195,Upregulated,100,5
ymgF,9,22,1.289506617194985,13,Unchanged,100,5
icdC,3,27,3.169925001442312,24,Unchanged,100,5
ymdF,130,61,-1.0916304754655681,-69,Unchanged,100,5
gnsA,44,57,0.37345839552744436,13,Unchanged,100,5
insA4,7,262,5.226068079479846,255,Upregulated,100,5
cydX,8,4,-1.0,-4,Unchanged,100,5
ybfQ,10,66,2.722466024471091,56,Unchanged,100,5
kdpF,1,1,0.0,0,Unchanged,100,5
ybdD,18,71,1.9798221180623699,53,Unchanged,100,5
ybdZ,2,133,6.05528243550119,131,Upregulated,100,5
rzoD,5,9,0.8479969065549501,4,Unchanged,100,5
ylcG,1,6,2.584962500721156,5,Unchanged,100,5
peaD,2,231,6.851749041416057,229,Upregulated,100,5
ykgO,1,6,2.584962500721156,5,Unchanged,100,5
insX,130,242,0.89649542424614,112,Upregulated,100,5
ykfH,7,152,4.4405725913859815,145,Upregulated,100,5
yafF,3,90,4.906890595608519,87,Unchanged,100,5
yeiW,4,202,5.658211482751795,198,Upregulated,100,5
torI,13,29,1.15754127698648,16,Unchanged,100,5
yfaS,364,7694,4.401723474097919,7330,Upregulated,100,5
yehH,240,5701,4.570108690524543,5461,Upregulated,100,5
yeeL,51,389,2.931201003014696,338,Upregulated,100,5
yedS,262,791,1.5941108829353414,529,Upregulated,100,5
yedN,29,211,2.863118193579613,182,Upregulated,100,5
arpB,68,987,3.8594434332060583,919,Upregulated,100,5
gapC,14295,3808,-1.9084052362105168,-10487,Downregulated,100,5
ydbA,5237,15549,1.5700092896565043,10312,Upregulated,100,5
ycgH,586,1826,1.639714195561974,1240,Upregulated,100,5
efeU,20,1857,6.536830005048058,1837,Upregulated,100,5
ilvG,7954,14887,0.9043005867860018,6933,Upregulated,100,5
yjdP,165,637,1.9488273480104847,472,Upregulated,100,5
yjiV,1271,5318,2.0649197468527087,4047,Upregulated,100,5
ytfR,175,2691,3.9427155638080884,2516,Upregulated,100,5
cpxP,1372,2510,0.8714068826653221,1138,Upregulated,100,5
tatD,906,1419,0.6472916340143162,513,Upregulated,100,5
yigE,43,1044,4.601641241867787,1001,Upregulated,100,5
wecF,834,1273,0.6101131304566944,439,Upregulated,100,5
hdfR,1225,1064,-0.20328359838874335,-161,Downregulated,100,5
dgoR,326,1708,2.389364105389413,1382,Upregulated,100,5
dgoD,115,2334,4.343098794762973,2219,Upregulated,100,5
dgoA,39,973,4.6408937759188635,934,Upregulated,100,5
gntU,350,3078,3.1365664044958814,2728,Upregulated,100,5
rtcA,332,2851,3.102212892591028,2519,Upregulated,100,5
frlC,64,1370,4.419960177847889,1306,Upregulated,100,5
smf,493,951,0.9478576944826519,458,Upregulated,100,5
yhdP,3334,6050,0.8596810380629025,2716,Upregulated,100,5
tdcG,127,1768,3.799217872619266,1641,Upregulated,100,5
cyuA,278,2229,3.003239828536245,1951,Upregulated,100,5
ygiQ,1439,3832,1.4130309689958824,2393,Upregulated,100,5
glcE,78,2695,5.11066733877762,2617,Upregulated,100,5
glcF,301,3146,3.3856832786559847,2845,Upregulated,100,5
yghJ,7703,8990,0.2229006904246339,1287,Upregulated,100,5
yggP,89,1558,4.129746087095271,1469,Upregulated,100,5
ghxQ,238,1659,2.8012804076479196,1421,Upregulated,100,5
ygcU,68,1934,4.829909238226501,1866,Upregulated,100,5
ygaQ,17,946,5.798233532089056,929,Upregulated,100,5
yfjD,652,1551,1.2502548168050134,899,Upregulated,100,5
araH,277,1225,2.1448238678407443,948,Upregulated,100,5
ryjA,1,16,4.0,15,Unchanged,100,5
oxyS,1,1,0.0,0,Unchanged,100,5
csrC,64712,3906,-4.0502694117477835,-60806,Downregulated,100,5
glmZ,2821,925,-1.608681395181897,-1896,Downregulated,100,5
hokA,1,3,1.584962500721156,2,Unchanged,100,5
rdlD,1,1,0.0,0,Unchanged,100,5
ldrD,1,1,0.0,0,Unchanged,100,5
gadY,1,1,0.0,0,Unchanged,100,5
ryhB,1,1,0.0,0,Unchanged,100,5
arcZ,1,1,0.0,0,Unchanged,100,5
sraG,1,19,4.247927513443585,18,Unchanged,100,5
sibD,3,12,2.0,9,Unchanged,100,5
sibC,1,7,2.807354922057604,6,Unchanged,100,5
omrB,1,1,0.0,0,Unchanged,100,5
omrA,1,1,0.0,0,Unchanged,100,5
gcvB,1042,50,-4.381283372503783,-992,Downregulated,100,5
micA,1,1,0.0,0,Unchanged,100,5
glmY,101,54,-0.9033239805883261,-47,Unchanged,100,5
ryfA,185,389,1.0722448844698798,204,Upregulated,100,5
micF,1,1,0.0,0,Unchanged,100,5
cyaR,1,1,0.0,0,Unchanged,100,5
sibB,1,6,2.584962500721156,5,Unchanged,100,5
sibA,2,10,2.321928094887362,8,Unchanged,100,5
isrC,35,18,-0.9593580155026542,-17,Unchanged,100,5
sdsR,1,1,0.0,0,Unchanged,100,5
ryeA,331,240,-0.46379681119869925,-91,Unchanged,100,5
rprA,1,1,0.0,0,Unchanged,100,5
rydB,1,1,0.0,0,Unchanged,100,5
sokB,1,1,0.0,0,Unchanged,100,5
hokB,6,11,0.874469117916141,5,Unchanged,100,5
micC,1,1,0.0,0,Unchanged,100,5
mcaS,1,13,3.700439718141092,12,Unchanged,100,5
rttR,15,132,3.137503523749935,117,Upregulated,100,5
rdlC,1,1,0.0,0,Unchanged,100,5
ldrC,1,1,0.0,0,Unchanged,100,5
rdlB,1,1,0.0,0,Unchanged,100,5
ldrB,1,3,1.584962500721156,2,Unchanged,100,5
rdlA,1,1,0.0,0,Unchanged,100,5
ldrA,2,1,-1.0,-1,Unchanged,100,5
sraB,2,14,2.807354922057604,12,Unchanged,100,5
rybB,1,1,0.0,0,Unchanged,100,5
rybA,1,1,0.0,0,Unchanged,100,5
hokE,3,18,2.584962500721156,15,Unchanged,100,5
tff,75,8,-3.228818690495881,-67,Unchanged,100,5
sokC,1,1,0.0,0,Unchanged,100,5
hokC,1,10,3.321928094887362,9,Unchanged,100,5
ecnB,30,24,-0.3219280948873623,-6,Unchanged,100,5
ecnA,2,3,0.5849625007211562,1,Unchanged,100,5
blr,16,3,-2.415037499278844,-13,Unchanged,100,5
csrB,623178,260368,-1.2590921550619776,-362810,Downregulated,100,5
thiS,6,71,3.564784618783526,65,Unchanged,100,5
yaeP,974,316,-1.6239972139052394,-658,Downregulated,100,5
yjtD,303,1091,1.8482614028506563,788,Upregulated,100,5
yjjY,1,12,3.584962500721156,11,Unchanged,100,5
arcA,18961,3232,-2.55253595053786,-15729,Downregulated,100,5
creD,132,2359,4.159565583881009,2227,Upregulated,100,5
creC,331,3081,3.2184955602321335,2750,Upregulated,100,5
creB,419,1320,1.6555157805464642,901,Upregulated,100,5
creA,590,815,0.4660851048692364,225,Upregulated,100,5
rob,3855,2200,-0.8092273363903748,-1655,Downregulated,100,5
ytjC,1339,1457,0.12184491674020201,118,Upregulated,100,5
yjjX,410,1130,1.4626269577971038,720,Upregulated,100,5
trpR,367,545,0.5704761668210759,178,Upregulated,100,5
slt,3688,5047,0.4525874308690885,1359,Upregulated,100,5
ettA,10993,4743,-1.2127133793175484,-6250,Downregulated,100,5
nadR,1902,2532,0.4127601585677778,630,Upregulated,100,5
radA,2676,3891,0.5400628643313947,1215,Upregulated,100,5
serB,1260,2385,0.920565532505595,1125,Upregulated,100,5
ytjB,442,1204,1.4457171173682706,762,Upregulated,100,5
lplA,857,2361,1.4620309321161429,1504,Upregulated,100,5
yjjJ,688,2642,1.9411499965447296,1954,Upregulated,100,5
deoD,7557,3615,-1.0638179756169173,-3942,Downregulated,100,5
deoB,10766,7437,-0.5336896532115522,-3329,Downregulated,100,5
deoA,4885,6684,0.4523531712054403,1799,Upregulated,100,5
deoC,2561,3892,0.6038044571836431,1331,Upregulated,100,5
yjjI,5004,5258,0.0714323524522261,254,Upregulated,100,5
yjjW,1294,2319,0.841665202653496,1025,Upregulated,100,5
yjjV,529,1681,1.6679800971221417,1152,Upregulated,100,5
yjjU,1517,2120,0.48284317920352815,603,Upregulated,100,5
osmY,3816,1635,-1.2227705356200667,-2181,Downregulated,100,5
prfC,3488,3339,-0.06298394671381069,-149,Downregulated,100,5
yjjG,1035,1347,0.3801190830756155,312,Upregulated,100,5
rimI,804,829,0.04417660031682193,25,Unchanged,100,5
holD,946,872,-0.11751204856246883,-74,Unchanged,100,5
rsmC,1525,2059,0.4331345872946432,534,Upregulated,100,5
fhuF,67,1197,4.15911824648573,1130,Upregulated,100,5
bglJ,25,477,4.2539892662307865,452,Upregulated,100,5
yjjQ,17,629,5.20945336562895,612,Upregulated,100,5
yjjP,456,1375,1.5923258891346426,919,Upregulated,100,5
yjjB,206,646,1.6488898275107065,440,Upregulated,100,5
dnaT,209,718,1.7804809017421686,509,Upregulated,100,5
dnaC,465,1575,1.7600492072792475,1110,Upregulated,100,5
yjjA,498,897,0.8489622428511803,399,Upregulated,100,5
opgB,2212,5627,1.3470145778228502,3415,Upregulated,100,5
lgoD,25,2008,6.327687364176048,1983,Upregulated,100,5
lgoR,244,1756,2.847339791972472,1512,Upregulated,100,5
lgoT,158,3325,4.395357877098811,3167,Upregulated,100,5
tsr,315,4676,3.8918511961443776,4361,Upregulated,100,5
btsT,618,7336,3.5693148956906797,6718,Upregulated,100,5
yjiX,29,104,1.84245872301352,75,Unchanged,100,5
yjiA,1004,2341,1.2213656651612408,1337,Upregulated,100,5
mrr,878,1767,1.0090091950162585,889,Upregulated,100,5
hsdR,5342,8841,0.7268295852100465,3499,Upregulated,100,5
hsdM,1239,2944,1.2486014839164112,1705,Upregulated,100,5
hsdS,698,1184,0.7623701394192975,486,Upregulated,100,5
symE,93,322,1.7917580670065856,229,Upregulated,100,5
mcrB,870,1119,0.36312273024030334,249,Upregulated,100,5
mcrC,279,477,0.773724144176324,198,Upregulated,100,5
yjiT,3658,2524,-0.5353431647661675,-1134,Downregulated,100,5
yjiS,2,38,4.247927513443585,36,Unchanged,100,5
yjiR,298,2529,3.0851828012010767,2231,Upregulated,100,5
mdtM,575,2213,1.944369589969274,1638,Upregulated,100,5
yjiN,588,2484,2.078777113384117,1896,Upregulated,100,5
yjiM,4315,3389,-0.34850092258232307,-926,Downregulated,100,5
yjiL,1152,1680,0.5443205162238102,528,Upregulated,100,5
yjiK,240,1022,2.090288885329103,782,Upregulated,100,5
yjiJ,100,2147,4.424250286084049,2047,Upregulated,100,5
kptA,173,822,2.2483663560449583,649,Upregulated,100,5
yjiH,20255,4357,-2.2168710666586313,-15898,Downregulated,100,5
yjiG,11863,2271,-2.3850692838713368,-9592,Downregulated,100,5
iadA,53248,9915,-2.425042661024882,-43333,Downregulated,100,5
hypT,7998,3191,-1.3256306725308171,-4807,Downregulated,100,5
iraD,753,575,-0.3890879088401906,-178,Downregulated,100,5
yjiC,34,450,3.7263183499666974,416,Upregulated,100,5
uxuR,769,1481,0.9455161373270212,712,Upregulated,100,5
uxuB,221,3413,3.9489221397074337,3192,Upregulated,100,5
uxuA,200,2027,3.341274183692174,1827,Upregulated,100,5
gntP,123,2064,4.068712750084014,1941,Upregulated,100,5
fimH,225,1241,2.4635062089133197,1016,Upregulated,100,5
fimG,119,676,2.5060616729742407,557,Upregulated,100,5
fimF,73,604,3.0485801804450614,531,Upregulated,100,5
fimD,455,3930,3.1105908620599103,3475,Upregulated,100,5
fimC,251,746,1.5714882663044658,495,Upregulated,100,5
fimI,604,797,0.4000311746653929,193,Upregulated,100,5
fimA,5131,1171,-2.131498949690201,-3960,Downregulated,100,5
fimE,36,611,4.085103568376417,575,Upregulated,100,5
fimB,453,521,0.20177232223227326,68,Unchanged,100,5
nanC,13,540,5.376375878909739,527,Upregulated,100,5
nanM,473,1073,1.1817379874171268,600,Upregulated,100,5
nanS,134,1239,3.2088712816828293,1105,Upregulated,100,5
yjhR,61,1303,4.416884031005248,1242,Upregulated,100,5
yjhQ,164,818,2.3184050283236655,654,Upregulated,100,5
yjhP,281,1574,2.4857935052865603,1293,Upregulated,100,5
sgcX,106,1900,4.163863248655111,1794,Upregulated,100,5
sgcC,109,2384,4.450984195685235,2275,Upregulated,100,5
sgcQ,91,1421,3.964896199044084,1330,Upregulated,100,5
sgcA,87,645,2.890211854461888,558,Upregulated,100,5
sgcE,126,1200,3.2515387669959646,1074,Upregulated,100,5
sgcR,141,1365,3.275133883408421,1224,Upregulated,100,5
yjhI,52,650,3.643856189774725,598,Upregulated,100,5
yjhH,117,1553,3.7304773948038967,1436,Upregulated,100,5
yjhG,585,4332,2.8885247131375604,3747,Upregulated,100,5
yjhF,68,2459,5.176393178345743,2391,Upregulated,100,5
yjhU,1749,2834,0.6963094689963659,1085,Upregulated,100,5
insA7,35,295,3.0752881273042374,260,Upregulated,100,5
fecI,59,1258,4.414273157517448,1199,Upregulated,100,5
fecR,50,2024,5.339137384919585,1974,Upregulated,100,5
fecA,161,6076,5.2379892763874665,5915,Upregulated,100,5
fecB,171,2314,3.758320634221592,2143,Upregulated,100,5
fecC,87,2035,4.547869583304881,1948,Upregulated,100,5
fecD,71,1658,4.545481171991068,1587,Upregulated,100,5
fecE,143,1471,3.3627101944764406,1328,Upregulated,100,5
yjhV,7,388,5.792557920129523,381,Upregulated,100,5
insI3,26,13,-1.0,-13,Unchanged,100,5
yjhE,4,173,5.434628227636725,169,Upregulated,100,5
yjhD,16,125,2.965784284662087,109,Upregulated,100,5
nanY,303,814,1.425711000793296,511,Upregulated,100,5
nanX,73,541,2.889660224946798,468,Upregulated,100,5
insG,539,2030,1.9131225493200332,1491,Upregulated,100,5
yjgZ,2,370,7.531381460516312,368,Upregulated,100,5
insD6,314,333,0.08475761817963527,19,Unchanged,100,5
insC6,297,262,-0.18089611926331556,-35,Unchanged,100,5
intB,473,1343,1.5055472160880472,870,Upregulated,100,5
ahr,1429,1372,-0.0587254349230041,-57,Unchanged,100,5
idnK,61,375,2.620009447820357,314,Upregulated,100,5
idnD,92,1218,3.7267364618493195,1126,Upregulated,100,5
idnO,86,678,2.978876708434246,592,Upregulated,100,5
idnT,135,1472,3.4467463590061818,1337,Upregulated,100,5
idnR,316,1169,1.8872784663545534,853,Upregulated,100,5
yjgR,999,2404,1.2668803129187671,1405,Upregulated,100,5
lptG,1926,2552,0.4060206259214101,626,Upregulated,100,5
lptF,1531,2441,0.6729980122813661,910,Upregulated,100,5
pepA,14790,6269,-1.238314817550709,-8521,Downregulated,100,5
holC,1329,781,-0.7669466511341951,-548,Downregulated,100,5
valS,23802,10327,-1.204661592068277,-13475,Downregulated,100,5
yjgN,38,420,3.466318004222537,382,Upregulated,100,5
yjgM,397,541,0.4464895866838575,144,Upregulated,100,5
rraB,3370,1086,-1.6337244882648594,-2284,Downregulated,100,5
argI,736,3290,2.160309912565591,2554,Upregulated,100,5
yjgL,292,252,-0.21254463538010074,-40,Unchanged,100,5
tabA,1081,416,-1.377711089593558,-665,Downregulated,100,5
bdcR,178,385,1.112981204615866,207,Upregulated,100,5
bdcA,106,792,2.9014361655164103,686,Upregulated,100,5
yjgH,120,294,1.292781749227846,174,Upregulated,100,5
pyrL,186,20,-3.217230716220669,-166,Downregulated,100,5
pyrB,140918,1708,-6.366404119239856,-139210,Downregulated,100,5
pyrI,71072,608,-6.869066164103395,-70464,Downregulated,100,5
ridA,34381,897,-5.26035971204243,-33484,Downregulated,100,5
mgtA,1319,4158,1.6564451936068254,2839,Upregulated,100,5
treR,678,1218,0.8451569547699884,540,Upregulated,100,5
treB,191,2014,3.398419139971036,1823,Upregulated,100,5
treC,173,2259,3.7068403277563595,2086,Upregulated,100,5
nrdD,2249,4026,0.8400635111435228,1777,Upregulated,100,5
nrdG,148,440,1.5719063478957098,292,Upregulated,100,5
cybC,227,432,0.9283390148725535,205,Upregulated,100,5
tldE,3937,2957,-0.41296246903871686,-980,Downregulated,100,5
yjgA,957,820,-0.22289501498057954,-137,Downregulated,100,5
mpl,4487,3051,-0.5564690040976888,-1436,Downregulated,100,5
fbp,5724,2020,-1.5026683790875106,-3704,Downregulated,100,5
yjfF,105,1226,3.5454977460246586,1121,Upregulated,100,5
ytfT,94,1494,3.9903755811115995,1400,Upregulated,100,5
ytfQ,214,1326,2.631398073711441,1112,Upregulated,100,5
ppa,8657,1608,-2.4285997529658547,-7049,Downregulated,100,5
chpB,91,412,2.178705886984522,321,Upregulated,100,5
chpS,81,184,1.183711953172388,103,Upregulated,100,5
ytfP,1536,413,-1.894964529301711,-1123,Downregulated,100,5
tamB,4177,7508,0.8459615066680816,3331,Upregulated,100,5
tamA,2349,3583,0.6091213301985393,1234,Upregulated,100,5
msrA,1422,1071,-0.4089629848691594,-351,Downregulated,100,5
ytfL,468,2004,2.0983020736118037,1536,Upregulated,100,5
ytfK,137,44,-1.6386004643232295,-93,Unchanged,100,5
ytfJ,73,630,3.1093834595072614,557,Upregulated,100,5
ytfI,28,283,3.337303320774278,255,Upregulated,100,5
cysQ,975,1065,0.12737930647622742,90,Unchanged,100,5
cpdB,1721,2884,0.7448240672006189,1163,Upregulated,100,5
ytfH,43,368,3.0972972013549147,325,Upregulated,100,5
qorB,346,1323,1.934969118641952,977,Upregulated,100,5
ytfF,77,1433,4.2180363535672445,1356,Upregulated,100,5
ytfE,87,834,3.2609600775959353,747,Upregulated,100,5
cycA,2479,2784,0.16740093976200615,305,Upregulated,100,5
fklB,5501,1399,-1.9752979404805746,-4102,Downregulated,100,5
ytfB,1143,1018,-0.16708784213878292,-125,Downregulated,100,5
ytfA,5,159,4.990954860396993,154,Upregulated,100,5
yjfZ,28,551,4.298553586513553,523,Upregulated,100,5
rplI,15234,2078,-2.87402724146445,-13156,Downregulated,100,5
rpsR,2683,578,-2.2147056567598424,-2105,Downregulated,100,5
priB,5540,925,-2.582360705532876,-4615,Downregulated,100,5
rpsF,13785,2732,-2.3350698786074626,-11053,Downregulated,100,5
yjfY,23,146,2.666262602823004,123,Upregulated,100,5
ulaF,109,1035,3.247230727609761,926,Upregulated,100,5
ulaE,192,1468,2.9346737521220567,1276,Upregulated,100,5
ulaD,166,1103,2.732177644244458,937,Upregulated,100,5
ulaC,45,499,3.471042909007586,454,Upregulated,100,5
ulaB,14,287,4.357552004618084,273,Upregulated,100,5
ulaA,43,2279,5.727920454563199,2236,Upregulated,100,5
ulaG,75,1749,4.543495883425772,1674,Upregulated,100,5
ulaR,443,1254,1.5011587442470207,811,Upregulated,100,5
yjfP,243,1078,2.1493289591467244,835,Upregulated,100,5
bsmA,77,285,1.8880315683572026,208,Upregulated,100,5
yjfN,41,141,1.78199934778071,100,Unchanged,100,5
aidB,5102,2629,-0.9565487569844264,-2473,Downregulated,100,5
yjfC,41,1601,5.287205587898173,1560,Upregulated,100,5
yjfM,17,759,5.480493234165127,742,Upregulated,100,5
yjfL,6,290,5.594946589293778,284,Upregulated,100,5
yjfK,13,675,5.698303973797101,662,Upregulated,100,5
yjfJ,41,1164,4.8273233382902,1123,Upregulated,100,5
yjfI,12,106,3.142957953842043,94,Unchanged,100,5
rlmB,1045,1441,0.46356739320650253,396,Upregulated,100,5
rnr,10457,8416,-0.31326240762558943,-2041,Downregulated,100,5
nsrR,295,477,0.6932743117563079,182,Upregulated,100,5
purA,23089,18152,-0.3470771762571141,-4937,Downregulated,100,5
yjeT,5,104,4.37851162325373,99,Unchanged,100,5
hflC,6891,3677,-0.9061841808957836,-3214,Downregulated,100,5
hflK,9808,6222,-0.6565805841563997,-3586,Downregulated,100,5
hflX,7991,5306,-0.5907513788716409,-2685,Downregulated,100,5
hfq,4476,1251,-1.839128246810574,-3225,Downregulated,100,5
miaA,10145,7422,-0.45088895894649533,-2723,Downregulated,100,5
mutL,2299,5565,1.2753752215111418,3266,Upregulated,100,5
amiB,1778,3773,1.0854567759803395,1995,Upregulated,100,5
tsaE,552,824,0.5779760704050493,272,Upregulated,100,5
nnr,2667,4200,0.6551715030025589,1533,Upregulated,100,5
queG,779,2929,1.9107129598176977,2150,Upregulated,100,5
orn,1620,1054,-0.6201189461347726,-566,Downregulated,100,5
rsgA,2150,2617,0.28357726457121224,467,Upregulated,100,5
psd,3235,3212,-0.010293819362555372,-23,Unchanged,100,5
mscM,1887,6836,1.857057974075694,4949,Upregulated,100,5
yjeO,23,256,3.476438043942987,233,Upregulated,100,5
yjeN,28,239,3.0935118859231445,211,Upregulated,100,5
yjeM,151,1858,3.6211300470575742,1707,Upregulated,100,5
epmA,421,1287,1.6121199151543057,866,Upregulated,100,5
frdA,38764,8131,-2.253212748243349,-30633,Downregulated,100,5
frdB,10822,2048,-2.4016795259824515,-8774,Downregulated,100,5
frdC,4966,751,-2.725199448662569,-4215,Downregulated,100,5
frdD,5398,836,-2.690850129385969,-4562,Downregulated,100,5
ampC,749,1332,0.8305564586125112,583,Upregulated,100,5
blc,259,528,1.0275858316718995,269,Upregulated,100,5
gdx,132,288,1.1255308820838588,156,Upregulated,100,5
efp,7060,1073,-2.7180181074020204,-5987,Downregulated,100,5
epmB,1192,1594,0.41926739352831016,402,Upregulated,100,5
yjeJ,98,792,3.014646775964401,694,Upregulated,100,5
yjeI,2567,945,-1.4416970614669833,-1622,Downregulated,100,5
groL,60572,25188,-1.2659144754207468,-35384,Downregulated,100,5
groS,4494,1107,-2.0213449023983547,-3387,Downregulated,100,5
yjeH,732,1696,1.2122206162791567,964,Upregulated,100,5
fxsA,574,839,0.5476200737641356,265,Upregulated,100,5
aspA,7847,3180,-1.3031144346913133,-4667,Downregulated,100,5
dcuA,11019,3961,-1.4760566955481942,-7058,Downregulated,100,5
cutA,328,248,-0.4033556942312085,-80,Unchanged,100,5
dsbD,2441,2656,0.12178285156577087,215,Upregulated,100,5
yjdC,1807,825,-1.1311304817314214,-982,Downregulated,100,5
cadC,251,870,1.7933280367853186,619,Upregulated,100,5
cadB,32,1087,5.086136225027309,1055,Upregulated,100,5
cadA,78,2308,4.887025289783234,2230,Upregulated,100,5
dtpC,250,1637,2.7110543218120666,1387,Upregulated,100,5
lysU,3428,2158,-0.6676722446244828,-1270,Downregulated,100,5
ghoS,46,65,0.4988058569714417,19,Unchanged,100,5
yjdJ,160,156,-0.03652587602511404,-4,Unchanged,100,5
yjdI,58,102,0.8144443468439234,44,Unchanged,100,5
dcuS,1229,2441,0.9899873794084922,1212,Upregulated,100,5
dcuR,766,929,0.2783342044576957,163,Upregulated,100,5
dcuB,9416,4483,-1.070649820987756,-4933,Downregulated,100,5
fumB,16430,6852,-1.2617354237534377,-9578,Downregulated,100,5
yjdF,122,849,2.798883405990152,727,Upregulated,100,5
melB,163,1347,3.0468059812312256,1184,Upregulated,100,5
melA,196,1969,3.3285375517863454,1773,Upregulated,100,5
melR,202,1317,2.7048281475047196,1115,Upregulated,100,5
adiA,168,3617,4.428260459877014,3449,Upregulated,100,5
adiY,269,467,0.7958163771530377,198,Upregulated,100,5
adiC,127,1957,3.945743353854638,1830,Upregulated,100,5
eptA,83,2242,4.755531131458502,2159,Upregulated,100,5
basR,363,1064,1.551456697505439,701,Upregulated,100,5
basS,231,1723,2.8989579448088905,1492,Upregulated,100,5
proP,7138,11464,0.6835187082131229,4326,Upregulated,100,5
rdcB,118,2059,4.125085065270413,1941,Upregulated,100,5
rdcA,329,5157,3.970372556463976,4828,Upregulated,100,5
yjdM,620,485,-0.3542834681997476,-135,Downregulated,100,5
yjdN,279,1028,1.8815032373646905,749,Upregulated,100,5
phnC,5,1596,8.318316841334983,1591,Upregulated,100,5
phnD,10,2957,8.207990433232961,2947,Upregulated,100,5
phnF,12,1817,7.242380203512959,1805,Upregulated,100,5
phnG,4,1004,7.971543553950772,1000,Upregulated,100,5
phnH,2,1362,9.411510988012072,1360,Upregulated,100,5
phnI,4,2328,9.184875342908283,2324,Upregulated,100,5
phnJ,12,2435,7.664743556248548,2423,Upregulated,100,5
phnK,15,1614,6.749534267669262,1599,Upregulated,100,5
phnL,40,2108,5.719731056749852,2068,Upregulated,100,5
phnM,29,3408,6.876728625098266,3379,Upregulated,100,5
phnN,33,1465,5.472290829951157,1432,Upregulated,100,5
phnO,153,1071,2.807354922057604,918,Upregulated,100,5
phnP,181,1876,3.373598225432171,1695,Upregulated,100,5
rpiB,45,889,4.304186512500095,844,Upregulated,100,5
alsR,590,1545,1.3888199785425335,955,Upregulated,100,5
alsB,88,1801,4.355150847268979,1713,Upregulated,100,5
alsA,24,2769,6.850186837645774,2745,Upregulated,100,5
alsC,25,2036,6.34766565630097,2011,Upregulated,100,5
alsE,43,1228,4.835830090668082,1185,Upregulated,100,5
alsK,110,1821,4.0491554934521785,1711,Upregulated,100,5
yjcS,27,3694,7.09608064881897,3667,Upregulated,100,5
mdtN,13,1986,7.255210189387282,1973,Upregulated,100,5
mdtO,55,4169,6.24412594328373,4114,Upregulated,100,5
mdtP,42,3298,6.295058260658707,3256,Upregulated,100,5
fdhF,4319,4771,0.14359436977728296,452,Upregulated,100,5
yjcO,696,1490,1.0981531195007956,794,Upregulated,100,5
gltP,6078,5245,-0.21265390205766438,-833,Downregulated,100,5
nrfG,73,1005,3.7831552271862736,932,Upregulated,100,5
nrfF,53,582,3.4569548883450847,529,Upregulated,100,5
nrfE,331,3870,3.547430444224555,3539,Upregulated,100,5
nrfD,2101,2167,0.04462299142062747,66,Unchanged,100,5
nrfC,1432,1468,0.035820475578956346,36,Unchanged,100,5
nrfB,1324,871,-0.604158498208353,-453,Downregulated,100,5
nrfA,7611,3380,-1.1710627736155488,-4231,Downregulated,100,5
acs,65,4302,6.0484239963946065,4237,Upregulated,100,5
yjcH,5,271,5.760220946466509,266,Upregulated,100,5
actP,86,3293,5.25892204189325,3207,Upregulated,100,5
yjcF,11,168,3.932885804141463,157,Upregulated,100,5
yjcE,1302,4311,1.7272931140128571,3009,Upregulated,100,5
ghxP,2213,3334,0.5912506531854052,1121,Upregulated,100,5
soxR,143,614,2.10222350859179,471,Upregulated,100,5
soxS,84,345,2.038135128886771,261,Upregulated,100,5
pdeC,217,2160,3.3152643646063513,1943,Upregulated,100,5
yjcB,58,378,2.7042614290935005,320,Upregulated,100,5
ssb,1912,1466,-0.3831974198469366,-446,Downregulated,100,5
uvrA,5169,8394,0.6994732609398051,3225,Upregulated,100,5
yjbR,2674,610,-2.132118317643104,-2064,Downregulated,100,5
yjbQ,4184,979,-2.0955020866432466,-3205,Downregulated,100,5
aphA,502,1096,1.1264885290097546,594,Upregulated,100,5
tyrB,1916,2412,0.33213234616390447,496,Upregulated,100,5
alr,2452,2474,0.012886521285588268,22,Unchanged,100,5
dnaB,4407,3311,-0.41252988588043665,-1096,Downregulated,100,5
qorA,3702,2050,-0.8526809854777657,-1652,Downregulated,100,5
pspG,511,477,-0.09933402493210979,-34,Unchanged,100,5
dusA,1120,1642,0.5519553948328383,522,Upregulated,100,5
yjbM,14,219,3.967432137543569,205,Upregulated,100,5
yjbL,3,4,0.41503749927884376,1,Unchanged,100,5
zur,717,777,0.11594147970580533,60,Unchanged,100,5
yjbJ,1018,58,-4.1335408509481235,-960,Downregulated,100,5
dinF,680,1930,1.504994196017741,1250,Upregulated,100,5
lexA,4786,1260,-1.92539666315122,-3526,Downregulated,100,5
dgkA,506,514,0.02263097449956785,8,Unchanged,100,5
plsB,7820,5034,-0.6354633910337353,-2786,Downregulated,100,5
ubiA,776,1208,0.6384918971379513,432,Upregulated,100,5
ubiC,444,734,0.7252203864931068,290,Upregulated,100,5
yjbI,18,224,3.6374299206152916,206,Upregulated,100,5
malM,606,1216,1.0047535299706345,610,Upregulated,100,5
lamB,1703,1893,0.15259597602516287,190,Upregulated,100,5
malK,892,1622,0.8626582042969683,730,Upregulated,100,5
malE,3388,2359,-0.5222584560927361,-1029,Downregulated,100,5
malF,1100,2518,1.1947747593069946,1418,Upregulated,100,5
malG,644,1494,1.2140475546746203,850,Upregulated,100,5
xylE,1738,4744,1.4486759277316035,3006,Upregulated,100,5
psiE,269,421,0.6462140605097719,152,Upregulated,100,5
yjbH,366,3374,3.2045444200035234,3008,Upregulated,100,5
yjbG,73,1306,4.161114622666413,1233,Upregulated,100,5
yjbF,90,934,3.3754256433799874,844,Upregulated,100,5
yjbE,250,121,-1.0469210473874926,-129,Downregulated,100,5
pgi,21407,9183,-1.2210451783558893,-12224,Downregulated,100,5
lysC,6664,3490,-0.9331613642685329,-3174,Downregulated,100,5
yjbD,238,190,-0.3249621549769956,-48,Unchanged,100,5
rluF,494,1309,1.4058821503605632,815,Upregulated,100,5
pepE,2509,1372,-0.8708319892363603,-1137,Downregulated,100,5
yjbB,443,2954,2.737291222209771,2511,Upregulated,100,5
metH,13700,9762,-0.4889272363415674,-3938,Downregulated,100,5
iclR,1078,1486,0.4630769377860907,408,Upregulated,100,5
arpA,24,1138,5.567322341585426,1114,Upregulated,100,5
aceK,4932,4807,-0.03703599626494348,-125,Downregulated,100,5
aceA,39373,30142,-0.38543149521528347,-9231,Downregulated,100,5
aceB,48476,32756,-0.5655114666724081,-15720,Downregulated,100,5
metA,6858,1375,-2.31835628563625,-5483,Downregulated,100,5
yjaB,112,468,2.0630097975258006,356,Upregulated,100,5
yjaA,13,288,4.46948528330122,275,Upregulated,100,5
purH,11038,4174,-1.4029762850318608,-6864,Downregulated,100,5
purD,6179,2666,-1.2126965930140288,-3513,Downregulated,100,5
zraR,567,2598,2.1959807905056525,2031,Upregulated,100,5
zraS,213,2435,3.5149964367438664,2222,Upregulated,100,5
zraP,319,591,0.8896017064126631,272,Upregulated,100,5
yjaH,570,1236,1.1166449188522707,666,Upregulated,100,5
hupA,5686,487,-3.5454204215951854,-5199,Downregulated,100,5
yjaG,1224,1253,0.033782856629208644,29,Unchanged,100,5
nfi,1213,1625,0.42186016768266893,412,Upregulated,100,5
hemE,3464,2625,-0.40012150728587764,-839,Downregulated,100,5
nudC,1125,1230,0.12873331412220274,105,Upregulated,100,5
rsd,379,476,0.32876372513685176,97,Unchanged,100,5
thiC,591,3711,2.6505779655199935,3120,Upregulated,100,5
thiE,139,918,2.7234092706903006,779,Upregulated,100,5
thiF,187,906,2.276472780158598,719,Upregulated,100,5
thiG,156,1144,2.8744691179161412,988,Upregulated,100,5
thiH,228,1708,2.9052022454557487,1480,Upregulated,100,5
yjaZ,84,404,2.2658940599730344,320,Upregulated,100,5
rpoC,116263,31573,-1.880628786716989,-84690,Downregulated,100,5
rpoB,100349,30032,-1.7404537796026385,-70317,Downregulated,100,5
rplL,47998,10674,-2.1688733758491825,-37324,Downregulated,100,5
rplJ,38001,8268,-2.2004270898396565,-29733,Downregulated,100,5
rplA,44628,10175,-2.132920359292172,-34453,Downregulated,100,5
rplK,16587,2793,-2.5701654987930755,-13794,Downregulated,100,5
nusG,7247,1625,-2.156944176181562,-5622,Downregulated,100,5
secE,4402,956,-2.203076621910809,-3446,Downregulated,100,5
tufB,124091,9085,-3.771768159629583,-115006,Downregulated,100,5
coaA,1280,570,-1.1671099858352583,-710,Downregulated,100,5
birA,972,1054,0.11684664803143371,82,Unchanged,100,5
murB,1710,1051,-0.7022336558110819,-659,Downregulated,100,5
murI,1263,1275,0.01364260795866807,12,Unchanged,100,5
btuB,5171,2278,-1.1826755577752772,-2893,Downregulated,100,5
trmA,2850,1745,-0.7077348828424518,-1105,Downregulated,100,5
yijD,1185,541,-1.1311865599588062,-644,Downregulated,100,5
fabR,1822,1364,-0.41767931477787823,-458,Downregulated,100,5
sthA,1523,3118,1.0337049862104926,1595,Upregulated,100,5
oxyR,3882,2868,-0.436755094011759,-1014,Downregulated,100,5
argH,2694,6244,1.2127206865156057,3550,Upregulated,100,5
argB,873,2858,1.7109523574663763,1985,Upregulated,100,5
argC,1060,4182,1.9801287971390178,3122,Upregulated,100,5
argE,1712,2751,0.6842734379150636,1039,Upregulated,100,5
ppc,57960,21570,-1.4260314183964753,-36390,Downregulated,100,5
eptC,2362,2543,0.10652249729294909,181,Upregulated,100,5
yijO,313,1320,2.0763033673131974,1007,Upregulated,100,5
frwD,15,370,4.624490864907794,355,Upregulated,100,5
pflC,71,1403,4.3045521741152175,1332,Upregulated,100,5
pflD,215,3525,4.0352146925840575,3310,Upregulated,100,5
frwB,15,292,4.282933963271499,277,Upregulated,100,5
frwC,24,1926,6.3264294871223035,1902,Upregulated,100,5
ptsA,64,5236,6.354249381945241,5172,Upregulated,100,5
fsaB,58,1113,4.262256882214388,1055,Upregulated,100,5
gldA,4373,3057,-0.5165067961942377,-1316,Downregulated,100,5
yijF,41,1245,4.924378022337359,1204,Upregulated,100,5
yijE,232,2071,3.15813084309294,1839,Upregulated,100,5
katG,12988,8272,-0.6508711989711533,-4716,Downregulated,100,5
metF,9695,1797,-2.431650489484213,-7898,Downregulated,100,5
metL,6845,6356,-0.10693141679674281,-489,Downregulated,100,5
metB,3035,2976,-0.028321990035013005,-59,Unchanged,100,5
metJ,1479,629,-1.2334901302197785,-850,Downregulated,100,5
yiiX,291,1184,2.024578022720666,893,Upregulated,100,5
rpmE,2756,248,-3.474163862317416,-2508,Downregulated,100,5
priA,1969,5388,1.4522867395607493,3419,Upregulated,100,5
cytR,1719,2338,0.4437053850535952,619,Upregulated,100,5
ftsN,3531,2793,-0.33826124747965053,-738,Downregulated,100,5
hslV,1400,1369,-0.03230438057442922,-31,Unchanged,100,5
hslU,6710,4604,-0.5434249329553156,-2106,Downregulated,100,5
menA,336,1485,2.143929792909368,1149,Upregulated,100,5
rraA,3976,1609,-1.30515343083884,-2367,Downregulated,100,5
zapB,2193,353,-2.6351657234024133,-1840,Downregulated,100,5
glpF,859,2218,1.3685293290232465,1359,Upregulated,100,5
glpK,3569,5846,0.71192992775703,2277,Upregulated,100,5
glpX,1094,1723,0.6553099634323917,629,Upregulated,100,5
fpr,1073,1284,0.2589951263657812,211,Upregulated,100,5
uspD,2255,405,-2.4771336203707564,-1850,Downregulated,100,5
yiiS,752,232,-1.6966078565500653,-520,Downregulated,100,5
yiiR,154,406,1.3985493764902748,252,Upregulated,100,5
yiiQ,930,718,-0.3732468721723423,-212,Downregulated,100,5
tpiA,23875,4031,-2.566291044846756,-19844,Downregulated,100,5
cdh,263,737,1.4866018198027673,474,Upregulated,100,5
sbp,188,1385,2.8810814092589134,1197,Upregulated,100,5
pfkA,23466,6406,-1.873076238679418,-17060,Downregulated,100,5
fieF,1262,1614,0.3549286682952314,352,Upregulated,100,5
cpxR,3536,1738,-1.0246901925770315,-1798,Downregulated,100,5
cpxA,5040,3645,-0.4675049191729794,-1395,Downregulated,100,5
yiiM,550,882,0.6813470371454985,332,Upregulated,100,5
kdgT,125,1308,3.3873625408359955,1183,Upregulated,100,5
sodA,141,699,2.3095972929766426,558,Upregulated,100,5
rhaT,82,1367,4.059245522987976,1285,Upregulated,100,5
rhaR,66,853,3.6920078119598365,787,Upregulated,100,5
rhaS,56,951,4.085946608802959,895,Upregulated,100,5
rhaB,29,1677,5.853685978436774,1648,Upregulated,100,5
rhaA,52,1817,5.1269029860930235,1765,Upregulated,100,5
rhaD,20,1098,5.778734244117836,1078,Upregulated,100,5
rhaM,6,192,5.0,186,Upregulated,100,5
frvA,4,396,6.6293566200796095,392,Upregulated,100,5
frvB,43,1811,5.39630607624807,1768,Upregulated,100,5
frvX,155,1366,3.139617363015853,1211,Upregulated,100,5
frvR,66,1954,4.887820632609932,1888,Upregulated,100,5
yiiG,38,1003,4.7221783771685955,965,Upregulated,100,5
fdhD,786,1084,0.4637635390952651,298,Upregulated,100,5
fdoG,2541,8206,1.6912827788391802,5665,Upregulated,100,5
fdoH,474,1652,1.8012547225211863,1178,Upregulated,100,5
fdoI,222,822,1.888578717331577,600,Upregulated,100,5
fdhE,1278,1682,0.3962898693081497,404,Upregulated,100,5
yiiF,26,65,1.3219280948873624,39,Unchanged,100,5
yiiE,2,97,5.599912842187128,95,Unchanged,100,5
fabY,2113,1982,-0.09233580474845246,-131,Downregulated,100,5
dtd,706,729,0.046250631055756906,23,Unchanged,100,5
yihY,840,1367,0.7025520099399374,527,Upregulated,100,5
yihX,974,1073,0.13965639867417973,99,Unchanged,100,5
csqR,594,1412,1.2492052524704145,818,Upregulated,100,5
yihV,218,1613,2.887346398378716,1395,Upregulated,100,5
yihU,85,1370,4.010569241710187,1285,Upregulated,100,5
yihT,130,1527,3.5541165337683966,1397,Upregulated,100,5
yihS,193,1833,3.2475340332718052,1640,Upregulated,100,5
yihR,26,1212,5.542734265331859,1186,Upregulated,100,5
yihQ,73,2759,5.240105182473256,2686,Upregulated,100,5
yihP,59,1762,4.900355159558573,1703,Upregulated,100,5
yihO,49,1320,4.751612370130608,1271,Upregulated,100,5
ompL,23,310,3.7525624492172245,287,Upregulated,100,5
yihN,30,1034,5.107129874706416,1004,Upregulated,100,5
yihM,202,784,1.9564983613634135,582,Upregulated,100,5
yihL,123,686,2.479550260833572,563,Upregulated,100,5
bipA,15404,6513,-1.241910896460685,-8891,Downregulated,100,5
glnA,37650,4026,-3.2252307875253132,-33624,Downregulated,100,5
glnL,2170,1207,-0.8462693665768202,-963,Downregulated,100,5
glnG,2812,1939,-0.5362837909657429,-873,Downregulated,100,5
hemN,3168,2152,-0.5578942575229855,-1016,Downregulated,100,5
yihI,1747,591,-1.563649572739227,-1156,Downregulated,100,5
yihA,1405,982,-0.5167752007935955,-423,Downregulated,100,5
spf,1,1,0.0,0,Unchanged,100,5
polA,6942,4346,-0.6756631906473631,-2596,Downregulated,100,5
yihG,94,663,2.81827620843495,569,Upregulated,100,5
yihF,73,909,3.6383119253140896,836,Upregulated,100,5
dsbA,3208,1199,-1.4198424830406966,-2009,Downregulated,100,5
srkA,1460,1400,-0.060541541935050854,-60,Unchanged,100,5
yihD,1200,263,-2.1898997012035784,-937,Downregulated,100,5
mobA,482,536,0.15319985422781088,54,Unchanged,100,5
mobB,199,411,1.046369963138034,212,Upregulated,100,5
hemG,824,961,0.22189209359053216,137,Upregulated,100,5
trkH,2179,2871,0.39788713409127496,692,Upregulated,100,5
yigZ,910,988,0.11864449649861893,78,Unchanged,100,5
pepQ,7192,4804,-0.5821568698088132,-2388,Downregulated,100,5
fadB,83,4238,5.674128441025245,4155,Upregulated,100,5
fadA,113,1989,4.137648598418556,1876,Upregulated,100,5
fre,2208,2326,0.07511092469504942,118,Upregulated,100,5
ubiD,3612,3922,0.11879164271129077,310,Upregulated,100,5
rfaH,413,538,0.38146439113717884,125,Upregulated,100,5
tatC,2151,1476,-0.5433148033626648,-675,Downregulated,100,5
tatB,2415,1601,-0.5930498812068785,-814,Downregulated,100,5
tatA,1202,482,-1.318331844481224,-720,Downregulated,100,5
ubiB,2176,2923,0.4257712725557133,747,Upregulated,100,5
ubiJ,1465,1552,0.08322789287751733,87,Unchanged,100,5
ubiE,2522,1969,-0.3571051644266662,-553,Downregulated,100,5
rmuC,764,2777,1.8618826337830974,2013,Upregulated,100,5
udp,4338,3195,-0.44121412183791714,-1143,Downregulated,100,5
ysgA,990,1785,0.85042364394949,795,Upregulated,100,5
metE,151815,8934,-4.086864277642487,-142881,Downregulated,100,5
metR,1649,1797,0.12399901007247463,148,Upregulated,100,5
bioP,168,1461,3.120423040024738,1293,Upregulated,100,5
yigL,1041,1303,0.3238670152687173,262,Upregulated,100,5
pldB,1659,1719,0.05125565852219775,60,Unchanged,100,5
rhtB,317,927,1.5480864984861236,610,Upregulated,100,5
rhtC,1200,1291,0.1054545948113099,91,Unchanged,100,5
recQ,2236,4352,0.9607583684071493,2116,Upregulated,100,5
pldA,1157,1401,0.2760680913233281,244,Upregulated,100,5
yigI,35,564,4.010268335453827,529,Upregulated,100,5
rarD,35,1308,5.223863808553117,1273,Upregulated,100,5
yigG,19,41,1.1096244911744981,22,Unchanged,100,5
yigF,51,39,-0.38702312310924736,-12,Unchanged,100,5
corA,1730,1625,-0.09033231972090777,-105,Downregulated,100,5
uvrD,4390,4846,0.1425734650286259,456,Upregulated,100,5
yigB,1270,1401,0.14162845877128982,131,Upregulated,100,5
xerC,1449,1497,0.04701662650148736,48,Unchanged,100,5
yigA,1139,1302,0.19296170145752364,163,Upregulated,100,5
dapF,2502,1799,-0.4758866029143375,-703,Downregulated,100,5
cyaY,526,360,-0.5470658929626278,-166,Downregulated,100,5
cyaA,19913,8497,-1.228685117159587,-11416,Downregulated,100,5
hemC,4656,3040,-0.6150197345773359,-1616,Downregulated,100,5
hemD,2000,1464,-0.4500844463780446,-536,Downregulated,100,5
hemX,3758,2514,-0.5799804169995477,-1244,Downregulated,100,5
hemY,3585,2489,-0.5264068886082314,-1096,Downregulated,100,5
aslA,190,1831,3.268560467466389,1641,Upregulated,100,5
aslB,67,1339,4.320851054866538,1272,Upregulated,100,5
yifK,1189,1944,0.7092795038601252,755,Upregulated,100,5
rffM,364,754,1.0506260730699681,390,Upregulated,100,5
wzyE,423,1677,1.9871531204443966,1254,Upregulated,100,5
wzxE,861,1705,0.9856865965146908,844,Upregulated,100,5
wecE,1198,1202,0.004808987922399752,4,Unchanged,100,5
rffC,535,801,0.5822633511202008,266,Upregulated,100,5
rffH,1371,1245,-0.1390828288237825,-126,Downregulated,100,5
rffG,1148,1197,0.06030051026781422,49,Unchanged,100,5
wecC,1649,1850,0.1659338719662074,201,Upregulated,100,5
wecB,1558,1501,-0.05377125644098082,-57,Unchanged,100,5
wzzE,1756,1541,-0.1884259830205729,-215,Downregulated,100,5
rfe,2529,1782,-0.5050697001413166,-747,Downregulated,100,5
rho,16327,6259,-1.3832556462639225,-10068,Downregulated,100,5
trxA,4974,1611,-1.6264500135103377,-3363,Downregulated,100,5
rhlB,9617,4307,-1.1589035953510602,-5310,Downregulated,100,5
gpp,4838,3572,-0.437678688858702,-1266,Downregulated,100,5
rep,2378,3712,0.6424479953819163,1334,Upregulated,100,5
yifN,148,317,1.0988856645104577,169,Upregulated,100,5
ppiC,458,285,-0.68438567904484,-173,Downregulated,100,5
ilvC,6527,7258,0.15315201751530103,731,Upregulated,100,5
ilvY,298,1789,2.5857691515897465,1491,Upregulated,100,5
ilvA,2139,6251,1.5471505200137825,4112,Upregulated,100,5
ilvD,2843,7254,1.3513626462927524,4411,Upregulated,100,5
ilvE,2849,3534,0.31084641822776565,685,Upregulated,100,5
ilvM,57,152,1.4150374992788437,95,Unchanged,100,5
ilvL,5,1,-2.321928094887362,-4,Unchanged,100,5
yifB,119,1868,3.9724609764017185,1749,Upregulated,100,5
maoP,2495,247,-3.336456868639945,-2248,Downregulated,100,5
yieP,1498,800,-0.9049657186840264,-698,Downregulated,100,5
hsrA,532,1203,1.177138491674887,671,Upregulated,100,5
rbsR,261,826,1.6620919748495608,565,Upregulated,100,5
rbsK,955,894,-0.09522590173979334,-61,Unchanged,100,5
rbsB,965,1040,0.10798268087301181,75,Unchanged,100,5
rbsC,372,847,1.1870593482241671,475,Upregulated,100,5
rbsA,354,1341,1.9214879718214766,987,Upregulated,100,5
rbsD,178,276,0.6327910258117713,98,Unchanged,100,5
kup,1100,2089,0.9253089686550864,989,Upregulated,100,5
ravA,3473,2132,-0.7039749726229158,-1341,Downregulated,100,5
viaA,1679,1845,0.13601858601072842,166,Upregulated,100,5
asnA,9999,1668,-2.583664529386741,-8331,Downregulated,100,5
asnC,246,265,0.10733404411132155,19,Unchanged,100,5
mioC,1426,709,-1.008116449204372,-717,Downregulated,100,5
mnmG,5984,3809,-0.6516978873242968,-2175,Downregulated,100,5
rsmG,492,515,0.0659141167313407,23,Unchanged,100,5
atpI,2245,1032,-1.121272474205255,-1213,Downregulated,100,5
atpB,9110,2765,-1.7201715735673437,-6345,Downregulated,100,5
atpE,5496,1686,-1.7047774678760177,-3810,Downregulated,100,5
atpF,13857,5874,-1.2381997812453418,-7983,Downregulated,100,5
atpH,7853,2508,-1.6467065489612145,-5345,Downregulated,100,5
atpA,51387,15621,-1.7179166167467441,-35766,Downregulated,100,5
atpG,16560,4776,-1.7938279311218825,-11784,Downregulated,100,5
atpD,33969,10488,-1.6954791572393584,-23481,Downregulated,100,5
atpC,6559,1406,-2.2218792806442558,-5153,Downregulated,100,5
glmU,7570,2271,-1.7369655941662063,-5299,Downregulated,100,5
glmS,12007,3506,-1.7759778313677734,-8501,Downregulated,100,5
pstS,1038,2492,1.2634976246661211,1454,Upregulated,100,5
pstC,536,1468,1.4535470623854403,932,Upregulated,100,5
pstA,473,1526,1.6898428734951354,1053,Upregulated,100,5
pstB,650,1187,0.8688083117260899,537,Upregulated,100,5
phoU,715,840,0.23244608600037084,125,Upregulated,100,5
bglG,5,424,6.405992359675837,419,Upregulated,100,5
bglF,59,1846,4.967543788283933,1787,Upregulated,100,5
bglB,45,1355,4.9122240399115595,1310,Upregulated,100,5
bglH,41,1037,4.660648174195142,996,Upregulated,100,5
yieL,57,1066,4.225101708594434,1009,Upregulated,100,5
yieK,52,704,3.758991900496205,652,Upregulated,100,5
cbrC,123,406,1.7228214118459364,283,Upregulated,100,5
cbrB,41,199,2.279072615925565,158,Upregulated,100,5
yieH,349,562,0.6873430940112738,213,Upregulated,100,5
adeP,3864,2057,-0.9095533003108393,-1807,Downregulated,100,5
yieF,2244,796,-1.495232340065144,-1448,Downregulated,100,5
yieE,1616,1097,-0.5588636723486019,-519,Downregulated,100,5
yidZ,274,1110,2.0183118782769416,836,Upregulated,100,5
mdtL,89,1617,4.183370532507264,1528,Upregulated,100,5
tnaB,83,1333,4.005421633742048,1250,Upregulated,100,5
tnaA,470,1770,1.9130166984053603,1300,Upregulated,100,5
tnaC,1,1,0.0,0,Unchanged,100,5
mnmE,1854,3190,0.7829151800267009,1336,Upregulated,100,5
yidC,10512,5470,-0.9424244426424108,-5042,Downregulated,100,5
rnpA,2093,1162,-0.8489622428511804,-931,Downregulated,100,5
rpmH,189,26,-2.8618027060799807,-163,Downregulated,100,5
dnaA,5764,6098,0.08126581483500073,334,Upregulated,100,5
dnaN,3270,3696,0.17667412103061272,426,Upregulated,100,5
recF,909,2547,1.4864467600800875,1638,Upregulated,100,5
gyrB,7976,8286,0.05501041058101118,310,Upregulated,100,5
yidB,364,505,0.4723449374404608,141,Upregulated,100,5
yidA,1879,1853,-0.020102185392789726,-26,Unchanged,100,5
yidX,161,616,1.9358696625802845,455,Upregulated,100,5
dgoK,141,1492,3.4034804678564443,1351,Upregulated,100,5
dgoT,128,2796,4.449148645375437,2668,Upregulated,100,5
cbrA,60,1845,4.94251450533924,1785,Upregulated,100,5
yidR,743,2342,1.656306959962619,1599,Upregulated,100,5
yidQ,507,566,0.15881630582854173,59,Unchanged,100,5
ibpA,1901,1915,0.010585860163767334,14,Unchanged,100,5
ibpB,1602,1879,0.2300909190113455,277,Upregulated,100,5
yidE,1562,3542,1.181169758609935,1980,Upregulated,100,5
yidP,33,1110,5.0719498418790145,1077,Upregulated,100,5
glvC,49,3064,5.966490737809749,3015,Upregulated,100,5
yidL,84,792,3.237039197300849,708,Upregulated,100,5
yidK,33,3442,6.70463726268175,3409,Upregulated,100,5
yidJ,85,2930,5.1072940131719085,2845,Upregulated,100,5
yidI,157,881,2.4883774600287865,724,Upregulated,100,5
yidH,104,569,2.4518451241654895,465,Upregulated,100,5
yidG,69,634,3.199814573361238,565,Upregulated,100,5
yidF,118,977,3.049571702606544,859,Upregulated,100,5
emrD,362,2620,2.8555052093416076,2258,Upregulated,100,5
ivbL,2,1,-1.0,-1,Unchanged,100,5
ilvB,2579,4890,0.923022692050382,2311,Upregulated,100,5
ilvN,261,440,0.7534537169547751,179,Upregulated,100,5
uhpA,1530,1855,0.2778875339281514,325,Upregulated,100,5
uhpB,725,3971,2.4534494606221715,3246,Upregulated,100,5
uhpC,293,2916,3.3150181499046893,2623,Upregulated,100,5
uhpT,121,2792,4.528219988935057,2671,Upregulated,100,5
adeD,284,3768,3.729836130108101,3484,Upregulated,100,5
adeQ,29,2189,6.238075244053374,2160,Upregulated,100,5
yicN,133,757,2.508867054484542,624,Upregulated,100,5
nepI,74,2570,5.1180992784522905,2496,Upregulated,100,5
nlpA,741,1189,0.682203267439822,448,Upregulated,100,5
yicL,776,1500,0.9508339431961156,724,Upregulated,100,5
setC,33,1329,5.3317312699177215,1296,Upregulated,100,5
yicJ,417,2121,2.3466253320858916,1704,Upregulated,100,5
yicI,1128,3650,1.6941293962559485,2522,Upregulated,100,5
yicH,2902,3471,0.25830384576190163,569,Upregulated,100,5
xanP,2237,4150,0.8915460800625307,1913,Upregulated,100,5
gltS,1632,2468,0.5967013371779223,836,Upregulated,100,5
recG,2589,3699,0.514740335223884,1110,Upregulated,100,5
trmH,1288,1093,-0.23683919244271237,-195,Downregulated,100,5
spoT,8066,4697,-0.7801138121480885,-3369,Downregulated,100,5
rpoZ,1832,499,-1.8763077827596835,-1333,Downregulated,100,5
gmk,1941,875,-1.1494451959939727,-1066,Downregulated,100,5
ligB,164,2345,3.837820202784655,2181,Upregulated,100,5
yicG,59,579,3.294776488627395,520,Upregulated,100,5
dinD,187,612,1.7104933828050153,425,Upregulated,100,5
yicC,2695,1634,-0.7218772894941843,-1061,Downregulated,100,5
rph,1482,1167,-0.3447408865984856,-315,Downregulated,100,5
pyrE,218,712,1.7075491061894714,494,Upregulated,100,5
slmA,1552,783,-0.9870443448960871,-769,Downregulated,100,5
dut,2074,802,-1.3707417523583054,-1272,Downregulated,100,5
dfp,1410,2259,0.6799891081069284,849,Upregulated,100,5
yicR,125,535,2.097610796626422,410,Upregulated,100,5
rpmB,4413,578,-2.9326183494753075,-3835,Downregulated,100,5
rpmG,394,33,-3.5776577000979226,-361,Downregulated,100,5
mutM,346,964,1.4782611085932371,618,Upregulated,100,5
coaD,486,455,-0.09508976851972227,-31,Unchanged,100,5
waaA,1954,1881,-0.0549306184451902,-73,Unchanged,100,5
waaQ,1321,1036,-0.3506064635602737,-285,Downregulated,100,5
waaG,1122,1171,0.06166839989242229,49,Unchanged,100,5
waaP,522,600,0.2009126939259963,78,Unchanged,100,5
waaS,596,124,-2.2649722100752863,-472,Downregulated,100,5
waaB,819,655,-0.3223685452161959,-164,Downregulated,100,5
waaO,758,478,-0.6651872301903431,-280,Downregulated,100,5
waaJ,573,241,-1.2495019925269433,-332,Downregulated,100,5
waaY,324,199,-0.703225382340976,-125,Downregulated,100,5
waaZ,462,191,-1.2743202133803089,-271,Downregulated,100,5
waaU,601,230,-1.3857311297668102,-371,Downregulated,100,5
waaL,965,267,-1.8536892004678887,-698,Downregulated,100,5
waaC,1000,1429,0.5150059164337295,429,Upregulated,100,5
waaF,2318,1918,-0.273277845988341,-400,Downregulated,100,5
rfaD,5066,2415,-1.0688238879893655,-2651,Downregulated,100,5
htrL,436,534,0.29251160691062766,98,Unchanged,100,5
kbl,2767,2368,-0.2246535629810049,-399,Downregulated,100,5
tdh,2485,1837,-0.43589422533829897,-648,Downregulated,100,5
waaH,48,1252,4.705056346211462,1204,Upregulated,100,5
yibQ,874,1777,1.02373849652808,903,Upregulated,100,5
envC,2596,2798,0.10810557916561489,202,Upregulated,100,5
gpmM,25148,9653,-1.3813943842068739,-15495,Downregulated,100,5
yibN,1884,721,-1.3857278003719606,-1163,Downregulated,100,5
grxC,501,377,-0.4102460799265441,-124,Downregulated,100,5
secB,4683,1272,-1.8803343674147095,-3411,Downregulated,100,5
gpsA,6796,3582,-0.9239205151982594,-3214,Downregulated,100,5
cysE,2197,2354,0.09957945061516768,157,Upregulated,100,5
trmL,404,793,0.9729655729521837,389,Upregulated,100,5
lldD,149,2275,3.9324823095112595,2126,Upregulated,100,5
lldR,36,1328,5.205114429904612,1292,Upregulated,100,5
lldP,71,2903,5.35358173712198,2832,Upregulated,100,5
yibL,587,565,-0.05510963580750217,-22,Unchanged,100,5
mtlR,485,1057,1.123918724308193,572,Upregulated,100,5
mtlD,2605,3431,0.39734575339178413,826,Upregulated,100,5
mtlA,2167,4386,1.0172066585799198,2219,Upregulated,100,5
yibI,10,368,5.20163386116965,358,Upregulated,100,5
yibH,98,2041,4.380350622917511,1943,Upregulated,100,5
yibG,16,49,1.6147098441152081,33,Unchanged,100,5
yibJ,130,1063,3.03155806850265,933,Upregulated,100,5
yibA,450,424,-0.08586073665383794,-26,Unchanged,100,5
rhsA,366,10019,4.774751061072336,9653,Upregulated,100,5
yibF,208,1199,2.5271762252731316,991,Upregulated,100,5
selA,1966,3509,0.835796626061586,1543,Upregulated,100,5
selB,3610,4915,0.4451925794534096,1305,Upregulated,100,5
yiaY,28,1916,6.096526923678576,1888,Upregulated,100,5
aldB,438,3256,2.8940979246650738,2818,Upregulated,100,5
yiaW,9,268,4.89616418901546,259,Upregulated,100,5
yiaV,35,2012,5.845131572860561,1977,Upregulated,100,5
yiaU,248,1570,2.6623525333921143,1322,Upregulated,100,5
yiaT,41,1021,4.638215146259718,980,Upregulated,100,5
sgbE,76,1240,4.028196891830652,1164,Upregulated,100,5
sgbU,34,1839,5.7572429231615985,1805,Upregulated,100,5
sgbH,30,1274,5.408258966647782,1244,Upregulated,100,5
lyxK,57,3738,6.035160839580416,3681,Upregulated,100,5
yiaO,19,1897,6.64157644996789,1878,Upregulated,100,5
yiaN,5,1823,8.510170751151772,1818,Upregulated,100,5
yiaM,4,369,6.527477006060396,365,Upregulated,100,5
yiaL,4,501,6.968666793195208,497,Upregulated,100,5
yiaK,31,1747,5.816467582529884,1716,Upregulated,100,5
plaR,1332,1498,0.1694435413874888,166,Upregulated,100,5
ysaA,128,592,2.2094533656289497,464,Upregulated,100,5
avtA,4799,3973,-0.27250501962809504,-826,Downregulated,100,5
malS,638,3422,2.423211430724544,2784,Upregulated,100,5
bax,3282,3500,0.09277968320597837,218,Upregulated,100,5
xylR,869,1948,1.1645655952679421,1079,Upregulated,100,5
xylH,947,2923,1.6260134983376677,1976,Upregulated,100,5
xylG,1210,3135,1.3734583955274444,1925,Upregulated,100,5
xylF,2117,3345,0.659984941521234,1228,Upregulated,100,5
xylA,13390,26193,0.9680253467260126,12803,Upregulated,100,5
xylB,2209,6519,1.5612572565471643,4310,Upregulated,100,5
yiaB,29,203,2.807354922057604,174,Upregulated,100,5
yiaA,38,225,2.5658536777734517,187,Upregulated,100,5
wecH,152,1242,3.0305219447768956,1090,Upregulated,100,5
glyQ,3658,2820,-0.37535991246256056,-838,Downregulated,100,5
glyS,11607,7367,-0.6558459868776659,-4240,Downregulated,100,5
insK,34,542,3.994686200103532,508,Upregulated,100,5
insJ,54,442,3.033015057227963,388,Upregulated,100,5
cspA,215,104,-1.0477531314483681,-111,Downregulated,100,5
yiaG,504,202,-1.3190684407481217,-302,Downregulated,100,5
yiaF,4325,1494,-1.5335199846222123,-2831,Downregulated,100,5
ghrB,4650,2724,-0.7715040128706849,-1926,Downregulated,100,5
yiaD,712,957,0.4266416835196278,245,Upregulated,100,5
bisC,2467,4695,0.9283674422410138,2228,Upregulated,100,5
yiaC,184,610,1.7291034763932356,426,Upregulated,100,5
tag,423,891,1.074767768401972,468,Upregulated,100,5
yhjY,306,945,1.6267826764157833,639,Upregulated,100,5
yhjX,239,2161,3.1766165488787586,1922,Upregulated,100,5
eptB,570,3013,2.4021668485423593,2443,Upregulated,100,5
dppA,43323,15745,-1.4602393916424727,-27578,Downregulated,100,5
dppB,4233,3361,-0.33278994601041856,-872,Downregulated,100,5
dppC,3717,2966,-0.32562009040712725,-751,Downregulated,100,5
dppD,4792,3524,-0.44341398386837216,-1268,Downregulated,100,5
dppF,5587,3683,-0.6011924230542905,-1904,Downregulated,100,5
yhjV,149,2135,3.8408518340456914,1986,Upregulated,100,5
bcsG,551,3352,2.604897925128194,2801,Upregulated,100,5
bcsF,22,87,1.983511877211431,65,Unchanged,100,5
bcsE,1412,3250,1.2026996295319987,1838,Upregulated,100,5
yhjR,8,50,2.643856189774725,42,Unchanged,100,5
bcsQ,98,1274,3.700439718141092,1176,Upregulated,100,5
bcsA,220,6265,4.831739080684563,6045,Upregulated,100,5
bcsB,286,5746,4.328470940754134,5460,Upregulated,100,5
bcsZ,122,2522,4.369615222765334,2400,Upregulated,100,5
bcsC,901,9157,3.3452760114038442,8256,Upregulated,100,5
pdeK,1176,4903,2.0597767014493207,3727,Upregulated,100,5
dctA,854,3817,2.1601312115950675,2963,Upregulated,100,5
yhjJ,1582,3047,0.9456399002136937,1465,Upregulated,100,5
kdgK,2716,2589,-0.06908851434462052,-127,Downregulated,100,5
pdeH,154,1466,3.2508828474389104,1312,Upregulated,100,5
yhjG,561,4057,2.85434062659748,3496,Upregulated,100,5
yhjE,679,3384,2.3172460888752178,2705,Upregulated,100,5
yhjD,1063,1813,0.7702373282130534,750,Upregulated,100,5
rcdB,615,1504,1.2901462514510351,889,Upregulated,100,5
yhjB,72,636,3.142957953842043,564,Upregulated,100,5
treF,1655,3234,0.9664884617790815,1579,Upregulated,100,5
ccp,626,2106,1.7502708740930986,1480,Upregulated,100,5
gadA,84374,2314,-5.188337728783573,-82060,Downregulated,100,5
gadX,7380,635,-3.5387923192882305,-6745,Downregulated,100,5
gadW,1920,597,-1.6853034743437136,-1323,Downregulated,100,5
mdtF,23634,5264,-2.1666324285999576,-18370,Downregulated,100,5
mdtE,10863,1846,-2.5569481245515595,-9017,Downregulated,100,5
gadE,8655,52,-7.378878386112909,-8603,Downregulated,100,5
hdeD,19860,681,-4.866067014403665,-19179,Downregulated,100,5
hdeA,47430,300,-7.304693557471008,-47130,Downregulated,100,5
hdeB,21226,176,-6.914113284587107,-21050,Downregulated,100,5
yhiD,1758,442,-1.9918167957519726,-1316,Downregulated,100,5
dctR,778,294,-1.4039540001498274,-484,Downregulated,100,5
slp,18758,480,-5.288327798153594,-18278,Downregulated,100,5
insH11,2861,6302,1.1392902566943568,3441,Upregulated,100,5
yhiS,30,1163,5.276744785864699,1133,Upregulated,100,5
arsC,73,546,2.9029325820398353,473,Upregulated,100,5
arsB,114,2219,4.28280393803227,2105,Upregulated,100,5
arsR,52,495,3.25084499682588,443,Upregulated,100,5
gor,3774,2762,-0.4503811033423945,-1012,Downregulated,100,5
rlmJ,707,1402,0.9877042292012244,695,Upregulated,100,5
prlC,5483,5545,0.01622198675227321,62,Unchanged,100,5
rsmJ,413,1425,1.786748232520021,1012,Upregulated,100,5
dtpB,380,2238,2.5581387126454462,1858,Upregulated,100,5
uspA,13688,2505,-2.4500291564068424,-11183,Downregulated,100,5
uspB,357,352,-0.020348645391802367,-5,Unchanged,100,5
pitA,5346,3507,-0.6082224069902658,-1839,Downregulated,100,5
yhiN,643,2561,1.993816610269521,1918,Upregulated,100,5
yhiM,3659,1478,-1.3078031461929363,-2181,Downregulated,100,5
yhiJ,177,922,2.3810173903463405,745,Upregulated,100,5
yhiI,3338,4509,0.433823555274922,1171,Upregulated,100,5
rbbA,5282,9113,0.7868417659846224,3831,Upregulated,100,5
yhhJ,1056,3283,1.6364049152145272,2227,Upregulated,100,5
yhhI,45,1287,4.837943241891027,1242,Upregulated,100,5
yhhH,12,43,1.8413022539809418,31,Unchanged,100,5
rhsB,323,9201,4.832184597294251,8878,Upregulated,100,5
nikR,249,865,1.7965543904560062,616,Upregulated,100,5
nikE,172,2038,3.566673581463716,1866,Upregulated,100,5
nikD,159,1933,3.6037429669268803,1774,Upregulated,100,5
nikC,118,2243,4.248570855724431,2125,Upregulated,100,5
nikB,152,2281,3.907523217868552,2129,Upregulated,100,5
nikA,585,4397,2.9100110027418804,3812,Upregulated,100,5
acpT,303,1152,1.9267510179693614,849,Upregulated,100,5
yhhT,245,2363,3.269765974971276,2118,Upregulated,100,5
yhhS,753,3765,2.321928094887362,3012,Upregulated,100,5
dcrB,2236,1765,-0.3412520046846474,-471,Downregulated,100,5
yhhQ,321,1525,2.248164040215308,1204,Upregulated,100,5
tusA,421,386,-0.12521938579831574,-35,Unchanged,100,5
zntA,3321,8642,1.3797475080870254,5321,Upregulated,100,5
yhhN,1888,1916,0.021238796374339088,28,Unchanged,100,5
yhhM,339,570,0.7496766459157601,231,Upregulated,100,5
yhhL,50,302,2.594548549550354,252,Upregulated,100,5
rsmD,412,1156,1.4884251553174606,744,Upregulated,100,5
ftsY,2698,5500,1.0275412703511169,2802,Upregulated,100,5
ftsE,1354,2543,0.9093037231151095,1189,Upregulated,100,5
ftsX,2279,3607,0.6623984985222731,1328,Upregulated,100,5
rpoH,8677,7277,-0.2538525184568444,-1400,Downregulated,100,5
livJ,931,5040,2.436570660828485,4109,Upregulated,100,5
panZ,261,666,1.3514723705013778,405,Upregulated,100,5
livK,1281,3323,1.375215817350385,2042,Upregulated,100,5
livH,460,2082,2.178264302355042,1622,Upregulated,100,5
livM,750,3537,2.2375637183176758,2787,Upregulated,100,5
livG,384,1971,2.3597495603223297,1587,Upregulated,100,5
livF,367,1917,2.3849983688249377,1550,Upregulated,100,5
ugpB,66,3358,5.668992395578576,3292,Upregulated,100,5
ugpA,14,1800,7.006426269159433,1786,Upregulated,100,5
ugpE,16,1914,6.902375114486025,1898,Upregulated,100,5
ugpC,224,3157,3.816983623255381,2933,Upregulated,100,5
ugpQ,405,1696,2.0661423567912123,1291,Upregulated,100,5
yhhA,691,681,-0.02103091237618736,-10,Unchanged,100,5
ggt,726,4134,2.5094969354296968,3408,Upregulated,100,5
yrhB,29,196,2.756728848987636,167,Upregulated,100,5
insB6,27,582,4.429987840744816,555,Upregulated,100,5
insA6,19,138,2.8605969433345835,119,Upregulated,100,5
yrhA,64,1403,4.454299293619899,1339,Upregulated,100,5
yhhZ,7,378,5.754887502163468,371,Upregulated,100,5
yhhY,429,721,0.7490216117412769,292,Upregulated,100,5
yhhX,2696,2337,-0.20616276239903314,-359,Downregulated,100,5
yhhW,680,1364,1.0042369928864707,684,Upregulated,100,5
gntR,1344,2156,0.6818240399737453,812,Upregulated,100,5
gntK,215,998,2.2147031557478,783,Upregulated,100,5
yhgN,306,1086,1.8274205451117096,780,Upregulated,100,5
asd,23151,4703,-2.299421274271237,-18448,Downregulated,100,5
glgB,28851,8488,-1.7651247633993101,-20363,Downregulated,100,5
glgX,13428,6106,-1.13694494749077,-7322,Downregulated,100,5
glgC,8727,4002,-1.1247646299157215,-4725,Downregulated,100,5
glgA,10568,4664,-1.1800626780463312,-5904,Downregulated,100,5
glgP,16457,6670,-1.3029426996386781,-9787,Downregulated,100,5
yzgL,47,115,1.2909011992667379,68,Unchanged,100,5
glpD,30707,17890,-0.7794141839751701,-12817,Downregulated,100,5
glpE,324,612,0.9175378398080271,288,Upregulated,100,5
glpG,1232,2371,0.9444934067871066,1139,Upregulated,100,5
glpR,657,2284,1.7975973750405132,1627,Upregulated,100,5
rtcR,143,4617,5.0128686802709765,4474,Upregulated,100,5
rtcB,370,3291,3.152928850608037,2921,Upregulated,100,5
malT,10083,14588,0.5328571563069545,4505,Upregulated,100,5
malP,5521,6437,0.22145886771777157,916,Upregulated,100,5
malQ,4684,5326,0.18531135270939908,642,Upregulated,100,5
gntT,1015,3421,1.7529383766953612,2406,Upregulated,100,5
nfuA,2759,1924,-0.520036657583231,-835,Downregulated,100,5
yhgH,629,1596,1.3433287293430567,967,Upregulated,100,5
bioH,668,1764,1.4009305530834684,1096,Upregulated,100,5
rpnA,177,1433,3.0172173441791483,1256,Upregulated,100,5
feoC,56,215,1.9408379275318561,159,Upregulated,100,5
feoB,2414,5919,1.2939277806896936,3505,Upregulated,100,5
feoA,72,142,0.9798221180623697,70,Unchanged,100,5
yhgF,6540,7440,0.18601198560994894,900,Upregulated,100,5
greB,449,909,1.01756484945296,460,Upregulated,100,5
ompR,1923,2016,0.06813687616001932,93,Unchanged,100,5
envZ,1475,3630,1.299254593746547,2155,Upregulated,100,5
pck,8165,6843,-0.25482393841576373,-1322,Downregulated,100,5
yhgE,711,2977,2.065937756618621,2266,Upregulated,100,5
hslO,1596,2535,0.667525095668357,939,Upregulated,100,5
hslR,435,945,1.1192989283723445,510,Upregulated,100,5
yrfG,707,1153,0.705610392842373,446,Upregulated,100,5
igaA,1772,5675,1.6792417885106214,3903,Upregulated,100,5
nudE,580,1060,0.8699394594356271,480,Upregulated,100,5
mrcA,1704,6041,1.8258620510107209,4337,Upregulated,100,5
hofM,105,1517,3.852759852580911,1412,Upregulated,100,5
hofN,39,875,4.487736987857443,836,Upregulated,100,5
hofO,34,698,4.359620384959313,664,Upregulated,100,5
hofP,36,553,3.9412106687923947,517,Upregulated,100,5
hofQ,161,2253,3.806714720120811,2092,Upregulated,100,5
aroK,3467,1619,-1.0985848509002676,-1848,Downregulated,100,5
aroB,5938,3294,-0.8501365382603008,-2644,Downregulated,100,5
damX,6548,4044,-0.6952713245711387,-2504,Downregulated,100,5
dam,905,1159,0.3568908690359041,254,Upregulated,100,5
rpe,2973,1410,-1.0762243006214884,-1563,Downregulated,100,5
gph,2327,1466,-0.6665861072715368,-861,Downregulated,100,5
trpS,5478,2391,-1.1960351359937502,-3087,Downregulated,100,5
yhfZ,213,1677,2.976957353338508,1464,Upregulated,100,5
yhfY,42,335,2.9956998625663744,293,Upregulated,100,5
yhfX,59,2288,5.277228287416548,2229,Upregulated,100,5
yhfW,50,2553,5.674121632632394,2503,Upregulated,100,5
php,52,1707,5.036807624886646,1655,Upregulated,100,5
yhfU,23,377,4.034858757211651,354,Upregulated,100,5
yhfT,140,3035,4.438197784198078,2895,Upregulated,100,5
yhfS,110,2446,4.474848975002727,2336,Upregulated,100,5
frlR,517,1397,1.4340958350945283,880,Upregulated,100,5
frlD,136,1943,3.8366073443350053,1807,Upregulated,100,5
frlB,61,1723,4.819969648662062,1662,Upregulated,100,5
frlA,19,2478,7.027032958697016,2459,Upregulated,100,5
yhfL,5,10,1.0,5,Unchanged,100,5
cysG,1554,2510,0.6917008604304243,956,Upregulated,100,5
nirC,657,1034,0.6542709099926051,377,Upregulated,100,5
nirD,656,394,-0.7355001851617075,-262,Downregulated,100,5
nirB,10239,5867,-0.8033799231486566,-4372,Downregulated,100,5
tsgA,224,1621,2.8553134534599374,1397,Upregulated,100,5
ppiA,1448,1023,-0.5012554573378766,-425,Downregulated,100,5
yhfG,38,34,-0.1604646721932461,-4,Unchanged,100,5
fic,842,660,-0.3513542088205804,-182,Downregulated,100,5
pabA,146,719,2.300023401559281,573,Upregulated,100,5
argD,1848,6525,1.8200131449285517,4677,Upregulated,100,5
yhfK,1403,2709,0.9492453845821154,1306,Upregulated,100,5
crp,6168,1746,-1.8207492062855943,-4422,Downregulated,100,5
yhfA,1356,527,-1.3634823114991292,-829,Downregulated,100,5
prkB,1319,1280,-0.043300754364182376,-39,Unchanged,100,5
yheU,93,68,-0.45169596985769195,-25,Unchanged,100,5
yheT,1403,1497,0.0935592124385177,94,Unchanged,100,5
yheS,3561,3585,0.009690683226204215,24,Unchanged,100,5
kefG,71,510,2.844606317354176,439,Upregulated,100,5
kefB,229,2317,3.338838540767878,2088,Upregulated,100,5
slyD,10267,2496,-2.040324850873917,-7771,Downregulated,100,5
slyX,499,96,-2.3779335046161045,-403,Downregulated,100,5
fkpA,5129,1554,-1.7226910675696074,-3575,Downregulated,100,5
yheO,2832,1316,-1.1056617763477559,-1516,Downregulated,100,5
tusD,1063,721,-0.5600704322902822,-342,Downregulated,100,5
tusC,439,369,-0.250600123474962,-70,Unchanged,100,5
tusB,318,223,-0.5119830553640508,-95,Unchanged,100,5
rpsL,12880,2267,-2.5062762972611936,-10613,Downregulated,100,5
rpsG,40203,8973,-2.16364084490506,-31230,Downregulated,100,5
fusA,259693,76012,-1.772508027192603,-183681,Downregulated,100,5
tufA,160805,46439,-1.79190345454288,-114366,Downregulated,100,5
chiA,831,2716,1.7085630974743873,1885,Upregulated,100,5
bfd,22,34,0.6280312226130421,12,Unchanged,100,5
bfr,3471,318,-3.4482526945442906,-3153,Downregulated,100,5
gspO,53,459,3.1144298888506086,406,Upregulated,100,5
gspM,31,274,3.1438357725736514,243,Upregulated,100,5
gspL,78,964,3.6274871173677132,886,Upregulated,100,5
gspK,37,703,4.247927513443585,666,Upregulated,100,5
gspJ,16,389,4.603626344986192,373,Upregulated,100,5
gspI,9,213,4.564784618783526,204,Upregulated,100,5
gspH,16,345,4.430452551665532,329,Upregulated,100,5
gspG,8,222,4.794415866350106,214,Upregulated,100,5
gspF,51,1045,4.356861884996749,994,Upregulated,100,5
gspE,44,1138,4.692853223669284,1094,Upregulated,100,5
gspD,161,1577,3.2920500666758934,1416,Upregulated,100,5
gspC,25,343,3.7782085763980877,318,Upregulated,100,5
gspA,50,1087,4.442280035252584,1037,Upregulated,100,5
gspB,54,179,1.728928275100788,125,Upregulated,100,5
rpsJ,10057,3779,-1.4121235901216238,-6278,Downregulated,100,5
rplC,42078,15345,-1.455297488040335,-26733,Downregulated,100,5
rplD,31887,10386,-1.618328241472831,-21501,Downregulated,100,5
rplW,8356,3575,-1.224869250513994,-4781,Downregulated,100,5
rplB,39272,12341,-1.6700417699882626,-26931,Downregulated,100,5
rpsS,11292,3428,-1.7198620193371932,-7864,Downregulated,100,5
rplV,5558,1516,-1.8742960810294704,-4042,Downregulated,100,5
rpsC,44308,14383,-1.6232025832147647,-29925,Downregulated,100,5
rplP,22826,6892,-1.7276834589420342,-15934,Downregulated,100,5
rpmC,3854,1490,-1.3710442409461971,-2364,Downregulated,100,5
rpsQ,9771,1997,-2.2906718876730867,-7774,Downregulated,100,5
rplN,31865,7634,-2.061461569083948,-24231,Downregulated,100,5
rplX,12642,2961,-2.0940683243609084,-9681,Downregulated,100,5
rplE,55153,19803,-1.4777203582025369,-35350,Downregulated,100,5
rpsN,16351,6471,-1.337318288921691,-9880,Downregulated,100,5
rpsH,20946,9110,-1.2011518035844966,-11836,Downregulated,100,5
rplF,39469,15343,-1.3631393680768504,-24126,Downregulated,100,5
rplR,16562,6565,-1.3350099846171433,-9997,Downregulated,100,5
rpsE,31390,10710,-1.5513465488318592,-20680,Downregulated,100,5
rpmD,1969,803,-1.2939912183842393,-1166,Downregulated,100,5
rplO,38072,15326,-1.3127491487962615,-22746,Downregulated,100,5
secY,81723,25549,-1.677475340973498,-56174,Downregulated,100,5
rpmJ,14,8,-0.8073549220576042,-6,Unchanged,100,5
rpsM,22470,6025,-1.8989669780625833,-16445,Downregulated,100,5
rpsK,20635,6328,-1.705271933421605,-14307,Downregulated,100,5
rpsD,39080,11165,-1.8074472161459116,-27915,Downregulated,100,5
rpoA,81897,23791,-1.783394691518744,-58106,Downregulated,100,5
rplQ,10483,1884,-2.476180772934456,-8599,Downregulated,100,5
yhdN,514,336,-0.6133071264151178,-178,Downregulated,100,5
zntR,422,374,-0.1742047288195484,-48,Unchanged,100,5
mscL,1527,334,-2.192780054322799,-1193,Downregulated,100,5
trkA,1754,1350,-0.3776893405065398,-404,Downregulated,100,5
rsmB,1846,1650,-0.16193652851259613,-196,Downregulated,100,5
fmt,2838,1732,-0.7124356593338266,-1106,Downregulated,100,5
def,1586,634,-1.322838025564571,-952,Downregulated,100,5
smg,2402,915,-1.3923925025342294,-1487,Downregulated,100,5
yrdD,1185,647,-0.8730494417931141,-538,Downregulated,100,5
tsaC,588,550,-0.09638453642434239,-38,Unchanged,100,5
aroE,882,771,-0.19404779564248634,-111,Downregulated,100,5
yrdB,113,102,-0.1477536204436922,-11,Unchanged,100,5
yrdA,1919,639,-1.586466875248386,-1280,Downregulated,100,5
yhdZ,82,517,2.6564684656968507,435,Upregulated,100,5
yhdY,42,886,4.398845465776258,844,Upregulated,100,5
yhdX,40,807,4.334496768390418,767,Upregulated,100,5
yhdW,87,801,3.202714936559982,714,Upregulated,100,5
yhdV,77,61,-0.33604920313201503,-16,Unchanged,100,5
acrF,280,3050,3.4453105103926442,2770,Upregulated,100,5
acrE,8,1076,7.071462362556624,1068,Upregulated,100,5
envR,6,359,5.902877533101895,353,Upregulated,100,5
yhdU,6,13,1.1154772174199359,7,Unchanged,100,5
yhdJ,87,856,3.2985234905524186,769,Upregulated,100,5
fis,2042,284,-2.8460200313731194,-1758,Downregulated,100,5
dusB,5968,1842,-1.6959744741639022,-4126,Downregulated,100,5
prmA,614,1175,0.9363501960821826,561,Upregulated,100,5
panF,300,1753,2.5467915902636573,1453,Upregulated,100,5
yhdT,35,112,1.6780719051126378,77,Unchanged,100,5
accC,15629,4037,-1.9528699805079672,-11592,Downregulated,100,5
accB,4322,1068,-2.0167874251719535,-3254,Downregulated,100,5
yhdH,1520,1361,-0.1594042568269532,-159,Downregulated,100,5
csrD,2543,2901,0.19001883350789106,358,Upregulated,100,5
mreB,10632,4009,-1.4070986871254039,-6623,Downregulated,100,5
mreC,2373,1876,-0.33905227267857135,-497,Downregulated,100,5
mreD,621,560,-0.14916644127551495,-61,Unchanged,100,5
yhdE,929,892,-0.05863488646234817,-37,Unchanged,100,5
rng,2994,2528,-0.2440777578813138,-466,Downregulated,100,5
tldD,3850,2725,-0.4986022159179751,-1125,Downregulated,100,5
aaeR,571,1150,1.0100712104688947,579,Upregulated,100,5
aaeX,7,59,3.0752881273042374,52,Unchanged,100,5
aaeA,88,979,3.4757334309663976,891,Upregulated,100,5
aaeB,184,2827,3.9414942117741627,2643,Upregulated,100,5
yhcO,68,108,0.667424660913129,40,Unchanged,100,5
yhcN,39,171,2.1324502960236495,132,Upregulated,100,5
argR,2895,1486,-0.9621292323380028,-1409,Downregulated,100,5
mdh,52912,3353,-3.9800705623973305,-49559,Downregulated,100,5
degS,984,1573,0.6767884500764468,589,Upregulated,100,5
degQ,1658,2030,0.2920357205767883,372,Upregulated,100,5
yhcB,3230,1259,-1.3592558818622706,-1971,Downregulated,100,5
zapE,1290,1824,0.4997346638541252,534,Upregulated,100,5
rplM,14631,2459,-2.5728847381609414,-12172,Downregulated,100,5
rpsI,24032,3493,-2.7824181701194073,-20539,Downregulated,100,5
sspA,7161,3029,-1.2413194890075603,-4132,Downregulated,100,5
sspB,3922,1919,-1.0312348239967688,-2003,Downregulated,100,5
dcuD,47,1991,5.404688654042865,1944,Upregulated,100,5
nanR,1477,1729,0.2272680428774925,252,Upregulated,100,5
nanA,112,1531,3.7729036454421836,1419,Upregulated,100,5
nanT,149,3044,4.3525841230413835,2895,Upregulated,100,5
nanE,107,1248,3.5439352324611013,1141,Upregulated,100,5
nanK,343,1588,2.2109304309701456,1245,Upregulated,100,5
yhcH,175,441,1.3334237337251917,266,Upregulated,100,5
yhcG,71,1640,4.529732980000764,1569,Upregulated,100,5
yhcF,131,553,2.0777126686972567,422,Upregulated,100,5
insH10,4199,3723,-0.17358017198350417,-476,Downregulated,100,5
yhcD,160,2481,3.9547779250050685,2321,Upregulated,100,5
yhcA,21,409,4.2836396101629886,388,Upregulated,100,5
gltF,128,612,2.2573878426926517,484,Upregulated,100,5
gltD,13762,7198,-0.9350221414734571,-6564,Downregulated,100,5
gltB,43846,23742,-0.885003762782498,-20104,Downregulated,100,5
yhcC,678,1574,1.2150783623711425,896,Upregulated,100,5
arcB,2328,4031,0.7920467249427957,1703,Upregulated,100,5
elbB,1816,1414,-0.36098208248151614,-402,Downregulated,100,5
mtgA,490,1060,1.113210610447991,570,Upregulated,100,5
yrbL,13706,5128,-1.418339425042558,-8578,Downregulated,100,5
npr,157,161,0.03629612922298996,4,Unchanged,100,5
rapZ,4030,2115,-0.9301221754080176,-1915,Downregulated,100,5
ptsN,2341,1144,-1.0330378823336233,-1197,Downregulated,100,5
hpf,2711,892,-1.6037094979174071,-1819,Downregulated,100,5
rpoN,7574,5098,-0.5711240478622175,-2476,Downregulated,100,5
lptB,2771,1705,-0.7006349715698823,-1066,Downregulated,100,5
lptA,2797,1472,-0.9261025824191789,-1325,Downregulated,100,5
lptC,1520,1064,-0.5145731728297583,-456,Downregulated,100,5
kdsC,1998,1443,-0.46948528330122025,-555,Downregulated,100,5
kdsD,2932,2230,-0.39484139332614476,-702,Downregulated,100,5
yrbG,1016,1370,0.43127549107572327,354,Upregulated,100,5
mlaF,2567,2111,-0.2821567172282624,-456,Downregulated,100,5
mlaE,2524,2167,-0.22001275688887545,-357,Downregulated,100,5
mlaD,1460,1055,-0.4687253701728321,-405,Downregulated,100,5
mlaC,3345,1922,-0.7993978747550728,-1423,Downregulated,100,5
mlaB,737,497,-0.5684187675327834,-240,Downregulated,100,5
ibaG,791,237,-1.7387906355745328,-554,Downregulated,100,5
murA,4837,2509,-0.94700006703669,-2328,Downregulated,100,5
sfsB,58,246,2.0845335102116676,188,Upregulated,100,5
ispB,3351,1721,-0.9613445891642675,-1630,Downregulated,100,5
rplU,8615,2069,-2.057917151252301,-6546,Downregulated,100,5
rpmA,5837,1321,-2.1435966016354113,-4516,Downregulated,100,5
yhbE,700,1310,0.9041399845924838,610,Upregulated,100,5
obgE,1606,3346,1.0589655525210382,1740,Upregulated,100,5
dacB,1392,1814,0.3820152446797941,422,Upregulated,100,5
greA,624,583,-0.0980501456617519,-41,Unchanged,100,5
yhbY,719,377,-0.9314272471706336,-342,Downregulated,100,5
rlmE,3352,2370,-0.5001350899137301,-982,Downregulated,100,5
ftsH,20778,14521,-0.5169159842939776,-6257,Downregulated,100,5
folP,2274,1280,-0.8290884440048853,-994,Downregulated,100,5
glmM,6991,3076,-1.1844433316791783,-3915,Downregulated,100,5
secG,4618,641,-2.848871911155374,-3977,Downregulated,100,5
yhbX,129,1075,3.0588936890535687,946,Upregulated,100,5
argG,3641,5672,0.6395227917950013,2031,Upregulated,100,5
rimP,2598,1236,-1.0717226875435064,-1362,Downregulated,100,5
nusA,11192,7760,-0.5283393100902632,-3432,Downregulated,100,5
infB,31405,17363,-0.8549780294361183,-14042,Downregulated,100,5
rbfA,1438,1041,-0.46609360713988074,-397,Downregulated,100,5
truB,2889,2497,-0.21037438263640323,-392,Downregulated,100,5
rpsO,5789,553,-3.387962770994172,-5236,Downregulated,100,5
pnp,29966,11315,-1.4050899345052204,-18651,Downregulated,100,5
nlpI,9908,3930,-1.334064556100394,-5978,Downregulated,100,5
deaD,5729,8287,0.5325665844045654,2558,Upregulated,100,5
mtr,727,2577,1.8256652679400254,1850,Upregulated,100,5
yhbW,269,1946,2.8548336322244876,1677,Upregulated,100,5
ubiV,1423,1744,0.2934643782504439,321,Upregulated,100,5
ubiU,1769,2243,0.34249557239581396,474,Upregulated,100,5
ubiT,3518,1679,-1.0671532525349308,-1839,Downregulated,100,5
yhbS,2449,1725,-0.5055964120110843,-724,Downregulated,100,5
yhbQ,85,508,2.579293750634464,423,Upregulated,100,5
yhbP,213,737,1.7908111888692315,524,Upregulated,100,5
yhbO,578,736,0.34863627355633403,158,Upregulated,100,5
yraR,222,1063,2.259510015180999,841,Upregulated,100,5
yraQ,471,2233,2.2451842862096902,1762,Upregulated,100,5
yraP,1666,1291,-0.36789940005835703,-375,Downregulated,100,5
diaA,1427,1028,-0.4731450702818853,-399,Downregulated,100,5
yraN,346,640,0.8872998672506377,294,Upregulated,100,5
lpoA,3959,5243,0.40525647848625845,1284,Upregulated,100,5
rsmI,692,1425,1.0421179763027415,733,Upregulated,100,5
yraK,109,1207,3.469025635978095,1098,Upregulated,100,5
yraJ,163,3021,4.212082314496864,2858,Upregulated,100,5
yraI,12,449,5.225609134019991,437,Upregulated,100,5
yraH,59,597,3.3389440719029637,538,Upregulated,100,5
agaI,21,875,5.380821783940931,854,Upregulated,100,5
agaD,18,995,5.788627713988699,977,Upregulated,100,5
agaC,9,770,6.4187896341399515,761,Upregulated,100,5
agaB,10,321,5.004501392234941,311,Upregulated,100,5
kbaY,11,1421,7.013259220605483,1410,Upregulated,100,5
agaS,19,1984,6.70626879694329,1965,Upregulated,100,5
agaA,67,841,3.6498727997973717,774,Upregulated,100,5
agaW,26,328,3.6571122864769916,302,Upregulated,100,5
agaV,32,553,4.111135670234707,521,Upregulated,100,5
kbaZ,38,2119,5.801240358928585,2081,Upregulated,100,5
agaR,1420,1559,0.13472999830574028,139,Upregulated,100,5
yhaV,555,633,0.18971772819087288,78,Unchanged,100,5
prlF,314,392,0.32008909522358114,78,Unchanged,100,5
garD,643,2624,2.0288770772901366,1981,Upregulated,100,5
garP,21,2163,6.6865005271832185,2142,Upregulated,100,5
garL,42,927,4.464108105846771,885,Upregulated,100,5
garR,216,1252,2.53513134476915,1036,Upregulated,100,5
garK,299,1832,2.615202113898839,1533,Upregulated,100,5
rnpB,949408,275071,-1.7872241582140715,-674337,Downregulated,100,5
yhaC,11,117,3.4109331009461075,106,Upregulated,100,5
yhaB,7,86,3.6189098326444937,79,Unchanged,100,5
tdcR,2,15,2.9068905956085187,13,Unchanged,100,5
tdcA,40,605,3.9188632372745946,565,Upregulated,100,5
tdcB,36,1199,5.057690941971911,1163,Upregulated,100,5
tdcC,202,1948,3.2695664793305474,1746,Upregulated,100,5
tdcD,57,1434,4.6529392945371635,1377,Upregulated,100,5
tdcE,222,3579,4.010924962066278,3357,Upregulated,100,5
tdcF,30,425,3.8244284354165456,395,Upregulated,100,5
cyuP,131,1930,3.8809621306179922,1799,Upregulated,100,5
yhaL,111,66,-0.7500217469916525,-45,Unchanged,100,5
yhaK,139,1084,2.963207968630364,945,Upregulated,100,5
yhaJ,943,1548,0.7150757954693138,605,Upregulated,100,5
yhaI,16,271,4.082149041353872,255,Upregulated,100,5
yhaH,548,468,-0.22766736337712226,-80,Unchanged,100,5
yqjG,576,1330,1.2072855289462394,754,Upregulated,100,5
yqjF,83,468,2.49532528823648,385,Upregulated,100,5
yqjK,5091,625,-3.02602097071437,-4466,Downregulated,100,5
yqjE,7344,706,-3.3788259701426275,-6638,Downregulated,100,5
yqjD,3018,458,-2.7201733024297394,-2560,Downregulated,100,5
yqjC,2697,650,-2.0528438983197868,-2047,Downregulated,100,5
mzrA,327,492,0.5893676798411575,165,Upregulated,100,5
yqjA,831,1014,0.287137270232996,183,Upregulated,100,5
exuR,1427,1820,0.35095311561029513,393,Upregulated,100,5
exuT,368,2439,2.7285120867391712,2071,Upregulated,100,5
uxaC,489,2861,2.5486131273709494,2372,Upregulated,100,5
uxaA,383,2925,2.933020327433172,2542,Upregulated,100,5
ygjV,107,638,2.5759456273637227,531,Upregulated,100,5
sstT,12868,4460,-1.5286722258450713,-8408,Downregulated,100,5
alx,105,1615,3.9430729319151645,1510,Upregulated,100,5
ygjR,700,1752,1.3235759477688445,1052,Upregulated,100,5
ygjQ,17,893,5.715053523870884,876,Upregulated,100,5
ygjP,190,618,1.7016074195734268,428,Upregulated,100,5
rlmG,328,2153,2.71458059954915,1825,Upregulated,100,5
higB,38,164,2.109624491174498,126,Upregulated,100,5
higA,160,706,2.1415962783838176,546,Upregulated,100,5
fadH,130,3960,4.928916901938518,3830,Upregulated,100,5
ygjK,111,4518,5.347052689042978,4407,Upregulated,100,5
ygjJ,7,1654,7.884388597113671,1647,Upregulated,100,5
ygjI,12,2141,7.479106579664354,2129,Upregulated,100,5
ebgC,9,445,5.627736524411448,436,Upregulated,100,5
ebgA,111,5640,5.66706358093605,5529,Upregulated,100,5
ebgR,444,1662,1.9042888004202385,1218,Upregulated,100,5
ygjH,6,380,5.984893107609792,374,Upregulated,100,5
patA,306,2431,2.989946335336077,2125,Upregulated,100,5
aer,185,2941,3.990709608370752,2756,Upregulated,100,5
nfeR,1179,1221,0.05049948200764056,42,Unchanged,100,5
nfeF,133,1323,3.314314910777487,1190,Upregulated,100,5
mug,1050,1094,0.05922341023907156,44,Unchanged,100,5
rpoD,12120,7711,-0.6523998257123927,-4409,Downregulated,100,5
dnaG,4439,4268,-0.05667453250066833,-171,Downregulated,100,5
rpsU,3308,384,-3.1067810184501186,-2924,Downregulated,100,5
tsaD,2887,2215,-0.3822644087936013,-672,Downregulated,100,5
ttdT,78,2873,5.202940058670276,2795,Upregulated,100,5
ttdB,137,1004,2.873511470990245,867,Upregulated,100,5
ttdA,194,1390,2.840956325423742,1196,Upregulated,100,5
ttdR,134,1392,3.376854305390956,1258,Upregulated,100,5
plsY,481,899,0.9022842217444054,418,Upregulated,100,5
folB,235,528,1.1678771727934538,293,Upregulated,100,5
bacA,997,1647,0.7241751453281589,650,Upregulated,100,5
cca,2899,2989,0.044107563616697605,90,Unchanged,100,5
ygiM,3729,2044,-0.8673936008360197,-1685,Downregulated,100,5
ygiF,1686,2589,0.618790428958029,903,Upregulated,100,5
glnE,4421,6303,0.5116659284401358,1882,Upregulated,100,5
hldE,2863,3195,0.15828826083500397,332,Upregulated,100,5
yqiK,77,2629,5.093511885923145,2552,Upregulated,100,5
yqiJ,19,397,4.385067683699372,378,Upregulated,100,5
glgS,276,80,-1.7865963618908067,-196,Downregulated,100,5
yqiI,47,517,3.4594316186372973,470,Upregulated,100,5
yqiH,40,361,3.1739269319998087,321,Upregulated,100,5
yqiG,258,3301,3.677460167799282,3043,Upregulated,100,5
insD5,419,649,0.631268234299787,230,Upregulated,100,5
insC5,388,374,-0.05301838229949099,-14,Unchanged,100,5
ygiL,11,351,4.9958956016672635,340,Upregulated,100,5
ubiK,1100,370,-1.5719063478957098,-730,Downregulated,100,5
ribB,4708,1358,-1.7936308407937125,-3350,Downregulated,100,5
zupT,1120,1151,0.03938910118726399,31,Unchanged,100,5
ygiD,168,1069,2.6697287149417304,901,Upregulated,100,5
ygiC,4783,2546,-0.9096833720849474,-2237,Downregulated,100,5
ygiB,3032,1622,-0.9024959339538187,-1410,Downregulated,100,5
tolC,11961,4410,-1.439487450273604,-7551,Downregulated,100,5
nudF,1144,892,-0.35897143685808475,-252,Downregulated,100,5
yqiB,709,558,-0.3455205054103285,-151,Downregulated,100,5
cpdA,2709,1885,-0.5231958700459878,-824,Downregulated,100,5
yqiA,967,941,-0.039321166748304485,-26,Unchanged,100,5
parE,4327,4059,-0.09224278072419789,-268,Downregulated,100,5
ygiN,3693,622,-2.5698067770750113,-3071,Downregulated,100,5
mdaB,921,842,-0.12938092302493956,-79,Unchanged,100,5
ygiZ,9,59,2.712718047919529,50,Unchanged,100,5
qseC,371,2323,2.6464980621880043,1952,Upregulated,100,5
qseB,184,911,2.3077452877450377,727,Upregulated,100,5
ygiW,2630,545,-2.270734664515376,-2085,Downregulated,100,5
ygiV,424,532,0.32736198093799046,108,Upregulated,100,5
mqsR,432,412,-0.06838697498025013,-20,Unchanged,100,5
mqsA,613,779,0.3457362543708877,166,Upregulated,100,5
ygiS,629,2644,2.071590254628403,2015,Upregulated,100,5
parC,6193,5018,-0.3035259753083543,-1175,Downregulated,100,5
plsC,947,891,-0.087938993946463,-56,Unchanged,100,5
ftsP,2332,2706,0.2145940507760408,374,Upregulated,100,5
yqhH,15,163,3.441837558622559,148,Upregulated,100,5
yqhG,108,1103,3.352329573427914,995,Upregulated,100,5
dkgA,3767,3626,-0.05503710820323461,-141,Downregulated,100,5
yqhD,7937,12203,0.6205701546581761,4266,Upregulated,100,5
yqhC,450,1404,1.6415460290875237,954,Upregulated,100,5
yghB,859,888,0.04790154521164227,29,Unchanged,100,5
metC,3522,1898,-0.891914916810099,-1624,Downregulated,100,5
exbB,410,941,1.1985708132230906,531,Upregulated,100,5
exbD,152,357,1.2318527505855144,205,Upregulated,100,5
yghA,3921,1504,-1.3824170748389522,-2417,Downregulated,100,5
yqhA,1118,1033,-0.11407993397813058,-85,Unchanged,100,5
gpr,1742,2642,0.600885842647963,900,Upregulated,100,5
yghW,10,275,4.78135971352466,265,Upregulated,100,5
hybO,9003,6137,-0.552872236181934,-2866,Downregulated,100,5
hybA,6466,4321,-0.5815082765363517,-2145,Downregulated,100,5
hybB,4812,3264,-0.5599955852045808,-1548,Downregulated,100,5
hybC,7003,6707,-0.06230548542503315,-296,Downregulated,100,5
hybD,1761,1393,-0.3381996512299555,-368,Downregulated,100,5
hybE,1558,1264,-0.3016987698845663,-294,Downregulated,100,5
hybF,270,331,0.2938718097563867,61,Unchanged,100,5
hybG,260,180,-0.5305147166987798,-80,Unchanged,100,5
yghU,2035,1817,-0.16347037491949354,-218,Downregulated,100,5
gss,6278,3983,-0.6564495492179292,-2295,Downregulated,100,5
pitB,49,2667,5.766292265435718,2618,Upregulated,100,5
yghT,11,860,6.288761230952163,849,Upregulated,100,5
yghS,23,980,5.413075982945558,957,Upregulated,100,5
yghR,22,1246,5.823656734386705,1224,Upregulated,100,5
yghQ,28,1654,5.884388597113671,1626,Upregulated,100,5
insH9,8435,3459,-1.286033054802,-4976,Downregulated,100,5
yghO,58,2245,5.274518734500937,2187,Upregulated,100,5
glcC,36,1427,5.308844618033451,1391,Upregulated,100,5
glcD,108,3740,5.11393505261153,3632,Upregulated,100,5
glcG,194,630,1.6992951762001511,436,Upregulated,100,5
glcB,1975,5449,1.4641388376246995,3474,Upregulated,100,5
glcA,80,2929,5.194264382992005,2849,Upregulated,100,5
pppA,608,1301,1.0974777332742098,693,Upregulated,100,5
yghG,100,363,1.859969548221026,263,Upregulated,100,5
yghF,109,1375,3.657031578522458,1266,Upregulated,100,5
yghE,429,1651,1.9442905674137125,1222,Upregulated,100,5
yghD,63,678,3.4278615396364276,615,Upregulated,100,5
yqgA,202,1036,2.358596804934759,834,Upregulated,100,5
speC,4947,3646,-0.4402393381194889,-1301,Downregulated,100,5
nupG,776,2199,1.5027190466678404,1423,Upregulated,100,5
mltC,1057,1697,0.6830111881599804,640,Upregulated,100,5
yggX,571,233,-1.2931607907085627,-338,Downregulated,100,5
mutY,1232,2016,0.7104933828050152,784,Upregulated,100,5
trmB,1644,1293,-0.3464880238714287,-351,Downregulated,100,5
yggL,1162,400,-1.5385381636298043,-762,Downregulated,100,5
yggN,575,1372,1.2546466203410749,797,Upregulated,100,5
ansB,3176,2156,-0.5588537343904522,-1020,Downregulated,100,5
yggM,43,1205,4.808552676415226,1162,Upregulated,100,5
hemW,835,2153,1.3665002168058191,1318,Upregulated,100,5
rdgB,792,1168,0.5604679388004076,376,Upregulated,100,5
yggU,186,265,0.5106897383425302,79,Unchanged,100,5
yggT,1213,916,-0.40516004702356645,-297,Downregulated,100,5
yggS,575,1072,0.898671044626035,497,Upregulated,100,5
yggR,43,1759,5.354275012769863,1716,Upregulated,100,5
yqgF,396,591,0.5776577000979228,195,Upregulated,100,5
yqgE,1563,1407,-0.15169544976313168,-156,Downregulated,100,5
gshB,1785,1954,0.13050639305192333,169,Upregulated,100,5
rsmE,922,1206,0.38739125147074693,284,Upregulated,100,5
endA,144,930,2.6911619045530815,786,Upregulated,100,5
yggI,237,550,1.214544559513763,313,Upregulated,100,5
galP,6076,3254,-0.9009076188295557,-2822,Downregulated,100,5
metK,44281,4382,-3.3370264134996166,-39899,Downregulated,100,5
yqgC,53,60,0.1789701410453193,7,Unchanged,100,5
yqgB,4,3,-0.4150374992788438,-1,Unchanged,100,5
speA,8034,4151,-0.9526595294418588,-3883,Downregulated,100,5
speB,1381,1420,0.04017761013399361,39,Unchanged,100,5
loiP,1397,1491,0.09394823687397919,94,Unchanged,100,5
tktA,40006,8739,-2.194676280715382,-31267,Downregulated,100,5
cmtB,7,241,5.105534414172357,234,Upregulated,100,5
cmtA,42,1733,5.366738516381409,1691,Upregulated,100,5
yggF,58,1365,4.556704240679642,1307,Upregulated,100,5
fumE,555,924,0.7354050801785893,369,Upregulated,100,5
yggC,563,1177,1.0639074929582146,614,Upregulated,100,5
epd,15423,4216,-1.8711366458342684,-11207,Downregulated,100,5
pgk,58834,15751,-1.9012066999993138,-43083,Downregulated,100,5
fbaA,127930,16826,-2.926590466055984,-111104,Downregulated,100,5
mscS,16583,3317,-2.3217541085098135,-13266,Downregulated,100,5
argO,334,855,1.3560763172992079,521,Upregulated,100,5
yggE,6522,1741,-1.9053982380973644,-4781,Downregulated,100,5
ygfI,231,959,2.0536379636020734,728,Upregulated,100,5
scpC,118,2210,4.227187604916953,2092,Upregulated,100,5
scpB,81,979,3.59531504671907,898,Upregulated,100,5
argK,68,1382,4.34507905913792,1314,Upregulated,100,5
scpA,140,3559,4.667973200564819,3419,Upregulated,100,5
argP,1776,1544,-0.20195882908202553,-232,Downregulated,100,5
yqfE,17,187,3.4594316186372973,170,Upregulated,100,5
rpiA,7654,2989,-1.3565510039904012,-4665,Downregulated,100,5
serA,48418,9691,-2.3208260392246167,-38727,Downregulated,100,5
fau,364,706,0.955729733072484,342,Upregulated,100,5
ssrS,6382,624,-3.3543906744170635,-5758,Downregulated,100,5
zapA,1183,460,-1.362744307395413,-723,Downregulated,100,5
ygfB,4239,1617,-1.390404287581434,-2622,Downregulated,100,5
pepP,10390,4728,-1.1358937136140417,-5662,Downregulated,100,5
ubiH,4132,3224,-0.3579885103370922,-908,Downregulated,100,5
ubiI,3056,2643,-0.20946811839417878,-413,Downregulated,100,5
gcvT,2759,2186,-0.3358520556813683,-573,Downregulated,100,5
gcvH,1286,556,-1.2097338546044398,-730,Downregulated,100,5
gcvP,4765,5353,0.16787143851768954,588,Upregulated,100,5
ygfF,137,1043,2.928491359559239,906,Upregulated,100,5
bglA,3541,2603,-0.443981531986804,-938,Downregulated,100,5
yqfB,500,296,-0.7563309190331373,-204,Downregulated,100,5
yqfA,468,1126,1.266626392496825,658,Upregulated,100,5
ygfZ,5845,3029,-0.9483614466236463,-2816,Downregulated,100,5
sdhE,872,598,-0.5441826505788212,-274,Downregulated,100,5
ygfX,1050,993,-0.08052370502511108,-57,Unchanged,100,5
fldB,1045,708,-0.5616816768852476,-337,Downregulated,100,5
xerD,2425,1805,-0.425985910187319,-620,Downregulated,100,5
dsbC,2407,1563,-0.6229183634748325,-844,Downregulated,100,5
recJ,4869,4760,-0.03266392707382181,-109,Downregulated,100,5
prfB,6706,3578,-0.9062990957418762,-3128,Downregulated,100,5
lysS,11239,5398,-1.0580167942800915,-5841,Downregulated,100,5
idi,181,509,1.49167595899249,328,Upregulated,100,5
uacT,14,1355,6.59672221418363,1341,Upregulated,100,5
ygfT,170,2332,3.777961137062795,2162,Upregulated,100,5
ygfS,41,420,3.356693513048039,379,Upregulated,100,5
guaD,321,1480,2.204951973394009,1159,Upregulated,100,5
xanQ,81,1283,3.985455452205058,1202,Upregulated,100,5
xdhD,412,3601,3.127681357007062,3189,Upregulated,100,5
ygfM,55,791,3.846174170948132,736,Upregulated,100,5
ssnA,48,1502,4.967706596793116,1454,Upregulated,100,5
ygfK,131,3110,4.569275863480515,2979,Upregulated,100,5
mocA,72,366,2.34577483684173,294,Upregulated,100,5
yqeC,68,788,3.534588978206037,720,Upregulated,100,5
yqeB,312,1897,2.604101744549227,1585,Upregulated,100,5
yqeA,155,781,2.333054332867742,626,Upregulated,100,5
hyuA,67,1470,4.455511249265954,1403,Upregulated,100,5
ygeY,108,1108,3.3588546638857197,1000,Upregulated,100,5
ygeX,68,1344,4.304854581528421,1276,Upregulated,100,5
ygeW,39,1194,4.936184902402557,1155,Upregulated,100,5
ygeV,542,1615,1.5751694082274157,1073,Upregulated,100,5
xdhC,85,400,2.234465253637023,315,Upregulated,100,5
xdhB,119,982,3.0447614510067496,863,Upregulated,100,5
xdhA,362,2539,2.8101987925643006,2177,Upregulated,100,5
ygeR,833,936,0.16819203421785683,103,Upregulated,100,5
ygeQ,169,600,1.8279392542136965,431,Upregulated,100,5
insC4,261,494,0.9204612350147932,233,Upregulated,100,5
insD4,297,752,1.3402697308768716,455,Upregulated,100,5
ygeO,36,68,0.9175378398080271,32,Unchanged,100,5
ygeN,36,39,0.11547721741993588,3,Unchanged,100,5
ygeL,9,132,3.8744691179161412,123,Upregulated,100,5
pbl,2,58,4.857980995127572,56,Unchanged,100,5
ygeI,2,3,0.5849625007211562,1,Unchanged,100,5
ygeH,12,130,3.4374053123072983,118,Upregulated,100,5
ygeG,4,20,2.321928094887362,16,Unchanged,100,5
ygeF,5,52,3.37851162325373,47,Unchanged,100,5
yqeK,5,7,0.48542682717024166,2,Unchanged,100,5
yqeJ,45,37,-0.282399730700725,-8,Unchanged,100,5
yqeI,222,245,0.14222207265246467,23,Unchanged,100,5
yqeH,37,138,1.8990710911492192,101,Upregulated,100,5
yqeG,393,779,0.9870940158030628,386,Upregulated,100,5
yqeF,130,1295,3.3163685695454617,1165,Upregulated,100,5
kduI,78,740,3.2459792416540636,662,Upregulated,100,5
kduD,153,772,2.3350691945754285,619,Upregulated,100,5
araE,535,1642,1.6178433304892954,1107,Upregulated,100,5
ygeA,439,672,0.6142402932434021,233,Upregulated,100,5
lysR,267,1107,2.0517435750939983,840,Upregulated,100,5
lysA,718,1585,1.1424270912037182,867,Upregulated,100,5
galR,663,1519,1.1960410943894957,856,Upregulated,100,5
aas,1936,2778,0.5209676467067981,842,Upregulated,100,5
lplT,801,1632,1.0267669095627856,831,Upregulated,100,5
tas,3231,2100,-0.6215914227118787,-1131,Downregulated,100,5
ygdR,408,99,-2.043068721891886,-309,Downregulated,100,5
ygdQ,382,1163,1.6062065534374697,781,Upregulated,100,5
mutH,409,1181,1.5298362164554085,772,Upregulated,100,5
rppH,3547,1514,-1.228234124949457,-2033,Downregulated,100,5
ptsP,6027,5486,-0.13568544260617083,-541,Downregulated,100,5
lgt,796,1141,0.5194584557450329,345,Upregulated,100,5
thyA,1386,1144,-0.27684020535882436,-242,Downregulated,100,5
ppdA,46,565,3.618545101245537,519,Upregulated,100,5
ppdB,135,734,2.442820655792382,599,Upregulated,100,5
ygdB,95,409,2.106101424610801,314,Upregulated,100,5
ppdC,58,262,2.1754420064098783,204,Upregulated,100,5
recC,3896,6288,0.6906075401762644,2392,Upregulated,100,5
ptrA,3035,5745,0.9206103763904312,2710,Upregulated,100,5
recB,4763,9327,0.9695425686981982,4564,Upregulated,100,5
recD,1512,3949,1.385029228239276,2437,Upregulated,100,5
argA,2043,5720,1.4853259429325243,3677,Upregulated,100,5
amiC,3720,2741,-0.44060029316961863,-979,Downregulated,100,5
mltA,2422,1986,-0.28633324216595485,-436,Downregulated,100,5
tcdA,309,1510,2.2888698063080666,1201,Upregulated,100,5
csdE,474,826,0.8012547225211862,352,Upregulated,100,5
csdA,2838,3493,0.29959205333431327,655,Upregulated,100,5
ygdI,787,166,-2.2451803941605615,-621,Downregulated,100,5
gcvA,1154,1751,0.6015358597880753,597,Upregulated,100,5
ygdD,429,674,0.6517709436823129,245,Upregulated,100,5
rlmM,1847,2280,0.30384995806966586,433,Upregulated,100,5
fucR,551,939,0.7690728390826168,388,Upregulated,100,5
fucU,454,560,0.3027345296540515,106,Upregulated,100,5
fucK,235,2406,3.355903980611077,2171,Upregulated,100,5
fucI,240,3344,3.8004685364723643,3104,Upregulated,100,5
fucP,40,1792,5.485426827170242,1752,Upregulated,100,5
fucA,37,822,4.473541218052733,785,Upregulated,100,5
fucO,1239,2308,0.8974670365048809,1069,Upregulated,100,5
ygdG,509,1252,1.2984970008569232,743,Upregulated,100,5
sdaB,1306,2363,0.855464732427416,1057,Upregulated,100,5
sdaC,3225,2429,-0.40893667056211386,-796,Downregulated,100,5
ppnN,5017,3382,-0.5689482783543135,-1635,Downregulated,100,5
queF,935,1189,0.3467104449706569,254,Upregulated,100,5
syd,688,840,0.28798076296402464,152,Upregulated,100,5
yqcC,227,274,0.2714835956696118,47,Unchanged,100,5
truC,600,1086,0.8559896973084807,486,Upregulated,100,5
yqcA,1328,630,-1.0758314129596458,-698,Downregulated,100,5
gudP,63,1746,4.792557920129523,1683,Upregulated,100,5
gudX,179,1748,3.287673692236342,1569,Upregulated,100,5
gudD,447,2124,2.248437029620836,1677,Upregulated,100,5
barA,1859,3721,1.001163620206291,1862,Upregulated,100,5
rlmD,961,2028,1.0774493162295902,1067,Upregulated,100,5
relA,4341,4857,0.1620380637708414,516,Upregulated,100,5
mazE,228,461,1.0157329262645964,233,Upregulated,100,5
mazF,274,358,0.3857836943037298,84,Unchanged,100,5
mazG,1247,2351,0.9148130738233513,1104,Upregulated,100,5
pyrG,25298,7476,-1.7586848591770456,-17822,Downregulated,100,5
eno,95671,30399,-1.6540578123284673,-65272,Downregulated,100,5
ygcG,13,321,4.625989768981211,308,Upregulated,100,5
queE,539,1103,1.0330756128388772,564,Upregulated,100,5
ygcE,81,1673,4.368371727153728,1592,Upregulated,100,5
yqcE,24,1512,5.977279923499917,1488,Upregulated,100,5
ygcW,14,671,5.582814034142579,657,Upregulated,100,5
ygcS,56,1777,4.987873043971074,1721,Upregulated,100,5
ygcR,42,1244,4.888453347351843,1202,Upregulated,100,5
ygcQ,80,1208,3.9164766444377164,1128,Upregulated,100,5
ygcP,85,530,2.6404576133128597,445,Upregulated,100,5
ygcO,10,142,3.8278190246173196,132,Upregulated,100,5
ygcN,370,1949,2.3971369147415778,1579,Upregulated,100,5
queD,429,405,-0.08305573972755852,-24,Unchanged,100,5
cysJ,422,5213,3.626798955888827,4791,Upregulated,100,5
cysI,469,5428,3.5327608929034775,4959,Upregulated,100,5
cysH,236,1489,2.6574849892202588,1253,Upregulated,100,5
cas3,306,2941,3.264703226194412,2635,Upregulated,100,5
casA,164,1734,3.4023361786037514,1570,Upregulated,100,5
casB,92,504,2.4537179674429037,412,Upregulated,100,5
casC,353,1240,1.8126000320030573,887,Upregulated,100,5
casD,180,898,2.3187185384114724,718,Upregulated,100,5
casE,222,731,1.7193117296023313,509,Upregulated,100,5
cas1,318,1412,2.150641417986825,1094,Upregulated,100,5
cas2,60,276,2.2016338611696504,216,Upregulated,100,5
iap,545,1587,1.5419739931708931,1042,Upregulated,100,5
cysD,382,3783,3.3078862330136274,3401,Upregulated,100,5
cysN,880,6089,2.7906298840799177,5209,Upregulated,100,5
cysC,130,1389,3.417463070952938,1259,Upregulated,100,5
ygbE,61,298,2.2884311828992754,237,Upregulated,100,5
ftsB,714,479,-0.5758984182929195,-235,Downregulated,100,5
ispD,1716,1620,-0.08305573972755852,-96,Unchanged,100,5
ispF,1077,709,-0.6031607173046915,-368,Downregulated,100,5
truD,3937,2572,-0.6142060698310937,-1365,Downregulated,100,5
umpG,2166,1754,-0.30438449516359406,-412,Downregulated,100,5
pcm,1324,1128,-0.23113605440842414,-196,Downregulated,100,5
nlpD,8032,12648,0.6550780984075988,4616,Upregulated,100,5
rpoS,26810,22547,-0.24983573142950463,-4263,Downregulated,100,5
ygbN,132,1960,3.892243819644117,1828,Upregulated,100,5
ygbM,92,1072,3.5425272344007595,980,Upregulated,100,5
ygbL,54,1100,4.3484003062485534,1046,Upregulated,100,5
ygbK,103,2074,4.331699651630007,1971,Upregulated,100,5
ygbJ,62,1604,4.693262116068045,1542,Upregulated,100,5
ygbI,471,1357,1.5266217558060708,886,Upregulated,100,5
pphB,34,493,3.8579809951275723,459,Upregulated,100,5
mutS,2242,5382,1.2633561128349906,3140,Upregulated,100,5
ygbA,37,463,3.6454150176312865,426,Upregulated,100,5
fhlA,1088,4631,2.089645200453354,3543,Upregulated,100,5
hypE,1891,2273,0.2654483208680863,382,Upregulated,100,5
hypD,2762,3198,0.21145661922228126,436,Upregulated,100,5
hypC,262,377,0.5249977117312139,115,Upregulated,100,5
hypB,2678,2636,-0.022805590316258825,-42,Unchanged,100,5
hypA,168,614,1.869777422591419,446,Upregulated,100,5
hycA,178,814,2.1931515532998493,636,Upregulated,100,5
hycB,153,1186,2.954500451853352,1033,Upregulated,100,5
hycC,477,4998,3.389289730081192,4521,Upregulated,100,5
hycD,215,2287,3.4110478008222125,2072,Upregulated,100,5
hycE,590,4908,3.0563483894137016,4318,Upregulated,100,5
hycF,162,1198,2.886562189904161,1036,Upregulated,100,5
hycG,319,1666,2.3847600716006783,1347,Upregulated,100,5
hycH,180,694,1.9469387562485863,514,Upregulated,100,5
hycI,257,836,1.7017345828870047,579,Upregulated,100,5
ascB,431,3340,2.9540883282723165,2909,Upregulated,100,5
ascF,310,3787,3.610715300610182,3477,Upregulated,100,5
ascG,412,2505,2.6040943608993525,2093,Upregulated,100,5
hydN,207,768,1.8914755432218309,561,Upregulated,100,5
hypF,1876,6526,1.7985391595764877,4650,Upregulated,100,5
norW,116,2928,4.65771884315647,2812,Upregulated,100,5
norV,249,3637,3.868531278387536,3388,Upregulated,100,5
norR,792,3969,2.3252032269202236,3177,Upregulated,100,5
gutQ,1080,2405,1.1550055816065732,1325,Upregulated,100,5
srlR,672,1493,1.1516810273557812,821,Upregulated,100,5
gutM,45,461,3.356769844099663,416,Upregulated,100,5
srlD,346,1916,2.4692536180994558,1570,Upregulated,100,5
srlB,36,591,4.03708931873522,555,Upregulated,100,5
srlE,87,1760,4.338416217675931,1673,Upregulated,100,5
srlA,41,699,4.091596640757353,658,Upregulated,100,5
mltB,1378,2250,0.7073491134001081,872,Upregulated,100,5
pncC,685,778,0.18366616713830297,93,Unchanged,100,5
recA,17576,4915,-1.8383434531953335,-12661,Downregulated,100,5
recX,112,628,2.487265826834023,516,Upregulated,100,5
alaS,28405,11168,-1.3467740563194006,-17237,Downregulated,100,5
csrA,1690,209,-3.015448399088664,-1481,Downregulated,100,5
yqaB,769,951,0.3064617428987369,182,Upregulated,100,5
yqaA,623,484,-0.36422511574940736,-139,Downregulated,100,5
gshA,5324,3238,-0.7174075856093258,-2086,Downregulated,100,5
luxS,7464,1341,-2.4766397489472847,-6123,Downregulated,100,5
emrB,1165,2349,1.0117167584705542,1184,Upregulated,100,5
emrA,1958,1855,-0.07796157809552932,-103,Downregulated,100,5
mprA,4158,1218,-1.7713756249520376,-2940,Downregulated,100,5
ygaH,691,555,-0.3161979391507903,-136,Downregulated,100,5
ygaZ,3482,2195,-0.6656952632283807,-1287,Downregulated,100,5
ygaY,261,2112,3.016488122788569,1851,Upregulated,100,5
proX,21168,17839,-0.24685022229369336,-3329,Downregulated,100,5
proW,20183,20659,0.0336297896684495,476,Upregulated,100,5
proV,29020,25379,-0.19341229512175842,-3641,Downregulated,100,5
nrdF,34,1274,5.227686721005961,1240,Upregulated,100,5
nrdE,114,3660,5.004737919006663,3546,Upregulated,100,5
nrdI,10,348,5.121015400961366,338,Upregulated,100,5
nrdH,7,179,4.676460855206653,172,Upregulated,100,5
ygaM,2129,484,-2.1370969971776996,-1645,Downregulated,100,5
ygaC,795,346,-1.200182822534993,-449,Downregulated,100,5
alaE,143,446,1.6410285631419153,303,Upregulated,100,5
stpA,7718,1603,-2.2674526183867063,-6115,Downregulated,100,5
ygaP,221,666,1.5914758076798305,445,Upregulated,100,5
ygaV,67,246,1.8764253148814674,179,Upregulated,100,5
yqaE,34,44,0.37196877738695794,10,Unchanged,100,5
kbp,3208,787,-2.0272386009474337,-2421,Downregulated,100,5
glaR,326,1185,1.861943189554544,859,Upregulated,100,5
gabP,140,2040,3.8650704199138914,1900,Upregulated,100,5
gabT,630,2902,2.2036237856794654,2272,Upregulated,100,5
gabD,737,3073,2.0599112424978925,2336,Upregulated,100,5
lhgD,230,2559,3.475874381095071,2329,Upregulated,100,5
glaH,222,1571,2.8230515989440903,1349,Upregulated,100,5
ypjC,10,184,4.20163386116965,174,Upregulated,100,5
pinH,1,97,6.599912842187128,96,Unchanged,100,5
ypjA,579,5165,3.1571330957631853,4586,Upregulated,100,5
ypjF,12,137,3.5130695822393703,125,Upregulated,100,5
yfjZ,3,115,5.260527550223219,112,Upregulated,100,5
yfjY,9,350,5.281286110390016,341,Upregulated,100,5
yfjX,10,488,5.608809242675524,478,Upregulated,100,5
yfjW,751,237,-1.6639258486160127,-514,Downregulated,100,5
yfjV,226,1065,2.236458752698013,839,Upregulated,100,5
yfjU,3,2,-0.5849625007211563,-1,Unchanged,100,5
yfjT,47,384,3.030373649043519,337,Upregulated,100,5
yfjS,14,289,4.3675707604430745,275,Upregulated,100,5
ypjK,7,109,3.9608294027193223,102,Upregulated,100,5
yfjR,27,593,4.457000792382535,566,Upregulated,100,5
yfjQ,18,800,5.473931188332412,782,Upregulated,100,5
yfjP,75,952,3.665999072812063,877,Upregulated,100,5
rnlB,396,325,-0.28506071216379275,-71,Unchanged,100,5
rnlA,4217,1619,-1.3811140359765677,-2598,Downregulated,100,5
yfjM,14,109,2.9608294027193223,95,Unchanged,100,5
abpA,1810,1794,-0.01280980705130656,-16,Unchanged,100,5
abpB,1926,2173,0.1740804713378237,247,Upregulated,100,5
yfjJ,25,146,2.5459683691052923,121,Upregulated,100,5
yfjI,45,437,3.2796363731709235,392,Upregulated,100,5
alpA,7,62,3.146841388329271,55,Unchanged,100,5
yfjH,292,345,0.2406279927855141,53,Unchanged,100,5
intA,1577,1368,-0.20511442990461237,-209,Downregulated,100,5
ssrA,836700,230403,-1.8605509333377752,-606297,Downregulated,100,5
smpB,1129,586,-0.9460729163507529,-543,Downregulated,100,5
ratA,1459,749,-0.9619422594591398,-710,Downregulated,100,5
yfjF,337,212,-0.6686843266186594,-125,Downregulated,100,5
bamE,2178,451,-2.271804615461526,-1727,Downregulated,100,5
recN,4802,2374,-1.0163154685885099,-2428,Downregulated,100,5
nadK,1039,895,-0.21523606675259307,-144,Downregulated,100,5
grpE,13820,4361,-1.6640267201940149,-9459,Downregulated,100,5
ypjD,620,749,0.2726975031845134,129,Upregulated,100,5
ffh,7914,4949,-0.677270023105698,-2965,Downregulated,100,5
rpsP,3736,790,-2.241569896645197,-2946,Downregulated,100,5
rimM,20347,4125,-2.302350072026451,-16222,Downregulated,100,5
trmD,22564,4815,-2.2284151388740416,-17749,Downregulated,100,5
rplS,6860,906,-2.9206256210139396,-5954,Downregulated,100,5
yfiB,519,272,-0.9321278871075415,-247,Downregulated,100,5
dgcN,547,986,0.8500468135853549,439,Upregulated,100,5
yfiR,386,430,0.1557358123213798,44,Unchanged,100,5
yfiL,47,144,1.615336149764675,97,Unchanged,100,5
aroF,1014,3907,1.9460036031803325,2893,Upregulated,100,5
tyrA,1266,3519,1.4748881093213233,2253,Upregulated,100,5
pheA,2987,1816,-0.7179330350198756,-1171,Downregulated,100,5
pheL,1,1,0.0,0,Unchanged,100,5
raiA,10047,3287,-1.6119214203475616,-6760,Downregulated,100,5
bamD,6003,1875,-1.6787930723562918,-4128,Downregulated,100,5
rluD,2293,1726,-0.40980389040183846,-567,Downregulated,100,5
pgeF,778,832,0.0968133731549001,54,Unchanged,100,5
clpB,36074,29838,-0.27380856564118633,-6236,Downregulated,100,5
kgtP,3210,4043,0.3328529062620291,833,Upregulated,100,5
yfiM,100,301,1.5897634869849773,201,Upregulated,100,5
pssA,4784,2306,-1.0528248765463333,-2478,Downregulated,100,5
patZ,2061,4108,0.9950916767789388,2047,Upregulated,100,5
tapT,142,783,2.4631213777863588,641,Upregulated,100,5
trxC,116,351,1.5973462251769885,235,Upregulated,100,5
yfiF,2027,1938,-0.06477751805181789,-89,Unchanged,100,5
ung,1231,1055,-0.22258776288990983,-176,Downregulated,100,5
grcA,2592,1976,-0.39148277129994696,-616,Downregulated,100,5
eamB,196,795,2.0201012060565096,599,Upregulated,100,5
yfiE,174,1283,2.882361959240954,1109,Upregulated,100,5
srmB,3008,3387,0.17120341981651963,379,Upregulated,100,5
yfiC,508,1020,1.005668750086692,512,Upregulated,100,5
nadB,16222,3755,-2.1110668866170283,-12467,Downregulated,100,5
rpoE,9016,2998,-1.5884871322243617,-6018,Downregulated,100,5
rseA,13743,5654,-1.2813531804079885,-8089,Downregulated,100,5
rseB,7779,2854,-1.4465993720986874,-4925,Downregulated,100,5
rseC,2917,1030,-1.5018410488275968,-1887,Downregulated,100,5
lepA,10039,5222,-0.9429412046435173,-4817,Downregulated,100,5
lepB,3404,1888,-0.8503722723241213,-1516,Downregulated,100,5
rnc,2100,1337,-0.6513898624601321,-763,Downregulated,100,5
era,3271,2582,-0.3412427587755877,-689,Downregulated,100,5
recO,630,1027,0.7050124479309162,397,Upregulated,100,5
pdxJ,2397,1487,-0.6888252615967143,-910,Downregulated,100,5
acpS,605,552,-0.13226687538378784,-53,Unchanged,100,5
yfhL,99,112,0.17799830197799443,13,Unchanged,100,5
yfhH,425,1286,1.597355896302883,861,Upregulated,100,5
pgpC,1126,1457,0.3717940499842829,331,Upregulated,100,5
tadA,684,952,0.4769652484220457,268,Upregulated,100,5
mltF,354,2764,2.964936350305261,2410,Upregulated,100,5
purL,26525,18325,-0.533539552780953,-8200,Downregulated,100,5
glrK,1115,3405,1.6106110880917666,2290,Upregulated,100,5
qseG,780,1496,0.9395641461380261,716,Upregulated,100,5
glrR,1138,3048,1.4213623451867403,1910,Upregulated,100,5
glnB,1054,452,-1.2214801892220268,-602,Downregulated,100,5
hmp,402,2387,2.569931159902848,1985,Upregulated,100,5
glyA,93445,9592,-3.2842139072946566,-83853,Downregulated,100,5
yphH,303,2184,2.8495831574469017,1881,Upregulated,100,5
yphG,152,6405,5.397055341785423,6253,Upregulated,100,5
yphF,51,1392,4.770518153877233,1341,Upregulated,100,5
yphE,52,3191,5.93935317513822,3139,Upregulated,100,5
yphD,58,1914,5.044394119358453,1856,Upregulated,100,5
yphC,290,2141,2.884159990370575,1851,Upregulated,100,5
yphB,183,1595,3.1236408703681895,1412,Upregulated,100,5
yphA,471,473,0.006113123726612006,2,Unchanged,100,5
hcaD,206,2111,3.3572103361639374,1905,Upregulated,100,5
hcaB,180,1745,3.27715822476734,1565,Upregulated,100,5
hcaC,50,475,3.2479275134435857,425,Upregulated,100,5
hcaF,53,665,3.649290075825353,612,Upregulated,100,5
hcaE,854,3166,1.8903532805166907,2312,Upregulated,100,5
hcaR,164,1769,3.4311663280723748,1605,Upregulated,100,5
hcaT,380,2506,2.7213150909909127,2126,Upregulated,100,5
csiE,616,2389,1.955404597761431,1773,Upregulated,100,5
yfhR,49,1977,5.334387311614,1928,Upregulated,100,5
suhB,2777,1927,-0.5271706055231249,-850,Downregulated,100,5
trmJ,2986,4118,0.463729664497713,1132,Upregulated,100,5
iscR,525,1270,1.274439169106043,745,Upregulated,100,5
iscS,4420,5898,0.41617945278294277,1478,Upregulated,100,5
iscU,1186,1325,0.1598883497919203,139,Upregulated,100,5
iscA,1381,1280,-0.10956950937068856,-101,Downregulated,100,5
hscB,757,1434,0.9216798187161731,677,Upregulated,100,5
hscA,5431,7576,0.48021846754418435,2145,Upregulated,100,5
fdx,758,794,0.06694115897186609,36,Unchanged,100,5
iscX,121,228,0.9140267768901471,107,Upregulated,100,5
pepB,2829,5045,0.8345620925974669,2216,Upregulated,100,5
sseB,1007,1602,0.6698104644019254,595,Upregulated,100,5
sseA,2118,2089,-0.019890096925228282,-29,Unchanged,100,5
yfhM,7373,14354,0.9611291637400687,6981,Upregulated,100,5
pbpC,591,5700,3.269731883761934,5109,Upregulated,100,5
ndk,263,834,1.6649845841523612,571,Upregulated,100,5
rlmN,1606,2891,0.848096715959735,1285,Upregulated,100,5
rodZ,3168,3074,-0.043455170388838255,-94,Unchanged,100,5
ispG,5829,4374,-0.41429518125840753,-1455,Downregulated,100,5
hisS,7522,4323,-0.7990834701444027,-3199,Downregulated,100,5
yfgM,3246,1861,-0.8025849444888199,-1385,Downregulated,100,5
bamB,9072,4553,-0.9946031809230298,-4519,Downregulated,100,5
der,2925,3850,0.3964218211114968,925,Upregulated,100,5
yfgJ,25,92,1.8797057662822882,67,Unchanged,100,5
xseA,2388,2775,0.21668493486002566,387,Upregulated,100,5
guaB,42100,4813,-3.1288119048762484,-37287,Downregulated,100,5
guaA,43232,4688,-3.205055104903437,-38544,Downregulated,100,5
yfgI,48,854,4.153129758899334,806,Upregulated,100,5
yfgH,25,453,4.17951105027151,428,Upregulated,100,5
yfgG,37,84,1.1828640571498104,47,Unchanged,100,5
pdeF,214,3472,4.020084246043332,3258,Upregulated,100,5
ppx,3634,3416,-0.0892504446136255,-218,Downregulated,100,5
ppk,6678,5093,-0.39090037616558193,-1585,Downregulated,100,5
purN,3619,1701,-1.0892079667091537,-1918,Downregulated,100,5
purM,12455,5024,-1.3098166522365717,-7431,Downregulated,100,5
upp,17025,1252,-3.7653483308541777,-15773,Downregulated,100,5
uraA,7735,2163,-1.8383676263744193,-5572,Downregulated,100,5
hda,1509,1751,0.21458627790687457,242,Upregulated,100,5
yfgD,1555,699,-1.1535502196425285,-856,Downregulated,100,5
bepA,3959,4232,0.09620356008392907,273,Upregulated,100,5
yfgO,1210,2575,1.0895653847959863,1365,Upregulated,100,5
focB,97,1824,4.232977171977614,1727,Upregulated,100,5
hyfR,167,4278,4.679016474690992,4111,Upregulated,100,5
hyfJ,33,563,4.092596992721776,530,Upregulated,100,5
hyfI,71,1370,4.270213058343207,1299,Upregulated,100,5
hyfH,61,982,4.008841876751807,921,Upregulated,100,5
hyfG,231,3849,4.0585189143947815,3618,Upregulated,100,5
hyfF,92,2853,4.954702075524707,2761,Upregulated,100,5
hyfE,19,1270,6.062685268215943,1251,Upregulated,100,5
hyfD,34,2758,6.341943900263641,2724,Upregulated,100,5
hyfC,10,1798,7.490249210627085,1788,Upregulated,100,5
hyfB,105,4560,5.4405725913859815,4455,Upregulated,100,5
hyfA,13,1186,6.511448576404911,1173,Upregulated,100,5
bcp,4909,1094,-2.1658164285734918,-3815,Downregulated,100,5
gcvR,2622,1276,-1.0390393564568852,-1346,Downregulated,100,5
dapA,12848,5392,-1.252651396335456,-7456,Downregulated,100,5
bamC,10846,6171,-0.8135868757691186,-4675,Downregulated,100,5
purC,16539,4418,-1.9044066834569928,-12121,Downregulated,100,5
ypfJ,1889,2527,0.41980296255640537,638,Upregulated,100,5
tmcA,1729,5079,1.5546066049745162,3350,Upregulated,100,5
ypfH,1234,1969,0.6741207167521358,735,Upregulated,100,5
dapE,1373,2801,1.028610357927406,1428,Upregulated,100,5
yffB,299,509,0.7675201718775903,210,Upregulated,100,5
acrD,590,7637,3.694219164132008,7047,Upregulated,100,5
narQ,1044,3821,1.8718285457876267,2777,Upregulated,100,5
aegA,577,4592,2.9924794180302055,4015,Upregulated,100,5
nudK,547,1258,1.2015191840867327,711,Upregulated,100,5
ypfG,1168,2779,1.2505255603205445,1611,Upregulated,100,5
tktB,9029,5549,-0.7023384089773067,-3480,Downregulated,100,5
talA,4121,1996,-1.045882742943239,-2125,Downregulated,100,5
maeB,3955,7260,0.8762918535229589,3305,Upregulated,100,5
eutS,3,592,7.624490864907794,589,Upregulated,100,5
eutP,8,762,6.573647187493322,754,Upregulated,100,5
eutQ,28,1891,6.077578725892158,1863,Upregulated,100,5
eutT,34,2262,6.0559203727394815,2228,Upregulated,100,5
eutD,40,3074,6.263973354803409,3034,Upregulated,100,5
eutM,22,300,3.7693870718585836,278,Upregulated,100,5
eutN,1,410,8.679480099505446,409,Upregulated,100,5
eutE,41,3690,6.491853096329675,3649,Upregulated,100,5
eutJ,17,2236,7.0392416315928505,2219,Upregulated,100,5
eutG,58,3404,5.87503432655839,3346,Upregulated,100,5
eutH,64,3375,5.720671786825555,3311,Upregulated,100,5
eutA,68,3885,5.8362360420447335,3817,Upregulated,100,5
yffS,1061,1909,0.8473924464891729,848,Upregulated,100,5
yffR,350,616,0.8155754288625726,266,Upregulated,100,5
yffQ,19,335,4.1400897719015495,316,Upregulated,100,5
yffP,70,1248,4.156119201917282,1178,Upregulated,100,5
yffO,52,584,3.489384840738925,532,Upregulated,100,5
yffN,21,491,4.547261791535933,470,Upregulated,100,5
yffM,6,238,5.309855262586788,232,Upregulated,100,5
yffL,322,1063,1.7230090034164878,741,Upregulated,100,5
intZ,335,2598,2.9551684301027463,2263,Upregulated,100,5
eutB,1718,4213,1.2941178794237909,2495,Upregulated,100,5
eutC,532,1618,1.604713456928788,1086,Upregulated,100,5
eutL,472,1549,1.7144783794277272,1077,Upregulated,100,5
eutK,305,1070,1.8107296488382607,765,Upregulated,100,5
eutR,393,2680,2.7696317830865285,2287,Upregulated,100,5
hemF,810,1930,1.2526070343834557,1120,Upregulated,100,5
amiA,1373,2284,0.7342310252157421,911,Upregulated,100,5
ypeA,656,1134,0.7896529203241452,478,Upregulated,100,5
yfeZ,277,934,1.7535365736604736,657,Upregulated,100,5
yfeY,758,1244,0.7147167319595109,486,Upregulated,100,5
yfeX,5567,2892,-0.9448325309147156,-2675,Downregulated,100,5
yfeW,108,2888,4.740967524723702,2780,Upregulated,100,5
murP,144,3370,4.548607874626908,3226,Upregulated,100,5
murQ,163,2127,3.7058761637295947,1964,Upregulated,100,5
murR,216,2029,3.2316656475931906,1813,Upregulated,100,5
ucpA,1306,2375,0.8627726165592418,1069,Upregulated,100,5
cysP,329,4508,3.7763280264369796,4179,Upregulated,100,5
cysU,126,2847,4.4979468542423495,2721,Upregulated,100,5
cysW,204,3261,3.99867338377697,3057,Upregulated,100,5
cysA,366,5022,3.7783464749874573,4656,Upregulated,100,5
cysM,795,3112,1.9688152948144741,2317,Upregulated,100,5
yfeS,267,511,0.9364835492500674,244,Upregulated,100,5
yfeK,103,367,1.8331357256599945,264,Upregulated,100,5
pdxK,2480,1933,-0.35949848306300186,-547,Downregulated,100,5
crr,33596,4329,-2.9561837677075102,-29267,Downregulated,100,5
ptsI,141378,27201,-2.377826042236528,-114177,Downregulated,100,5
ptsH,17812,2381,-2.9032099911725697,-15431,Downregulated,100,5
cysK,9227,22902,1.3115400305896625,13675,Upregulated,100,5
cysZ,1228,1754,0.5143381870745536,526,Upregulated,100,5
zipA,6068,3569,-0.7657011841980108,-2499,Downregulated,100,5
ligA,3873,5243,0.43694104448800836,1370,Upregulated,100,5
yfeH,505,1848,1.8716094637769005,1343,Upregulated,100,5
yfeR,249,1853,2.895645233959185,1604,Upregulated,100,5
yfeN,124,972,2.970616193218906,848,Upregulated,100,5
xapA,27,1285,5.572665141917772,1258,Upregulated,100,5
xapB,252,1929,2.936357504549187,1677,Upregulated,100,5
xapR,432,1545,1.8385036206282683,1113,Upregulated,100,5
gltX,10436,4711,-1.147463612149531,-5725,Downregulated,100,5
yfeD,238,384,0.6901447374132127,146,Upregulated,100,5
yfeC,183,310,0.7604245669901952,127,Upregulated,100,5
pdeA,2579,3873,0.5866397282391328,1294,Upregulated,100,5
insL3,895,2493,1.4779232953398818,1598,Upregulated,100,5
nupC,4556,2436,-0.9032536138017795,-2120,Downregulated,100,5
mntH,249,2205,3.146561008376802,1956,Upregulated,100,5
ypeC,313,495,0.6612658680343536,182,Upregulated,100,5
yfeO,189,1851,3.2918467556495017,1662,Upregulated,100,5
glk,3112,4006,0.36432036082651587,894,Upregulated,100,5
fryB,3,312,6.700439718141092,309,Upregulated,100,5
fryC,28,2076,6.212235806300277,2048,Upregulated,100,5
ypdF,49,1997,5.348908773328764,1948,Upregulated,100,5
ypdE,24,1459,5.925801667196735,1435,Upregulated,100,5
fryA,199,4641,4.543595361626543,4442,Upregulated,100,5
ypdC,232,1474,2.6675398139674975,1242,Upregulated,100,5
pyrR,434,979,1.1736138171592156,545,Upregulated,100,5
pyrS,303,2444,3.0118545863457786,2141,Upregulated,100,5
alaC,1743,2657,0.6082256583648216,914,Upregulated,100,5
lpxP,110,1433,3.703463180737486,1323,Upregulated,100,5
yfdY,183,163,-0.16697168405296492,-20,Unchanged,100,5
ypdI,5,106,4.405992359675837,101,Upregulated,100,5
yfdX,40,573,3.8404632338695426,533,Upregulated,100,5
frc,63,1091,4.114155462823691,1028,Upregulated,100,5
oxc,43,1478,5.103165799444053,1435,Upregulated,100,5
yfdV,24,609,4.6653359171851765,585,Upregulated,100,5
yfdE,57,951,4.060411516695822,894,Upregulated,100,5
evgS,3760,2604,-0.5300032133993643,-1156,Downregulated,100,5
evgA,2842,729,-1.9629158349158433,-2113,Downregulated,100,5
emrK,75,574,2.936088236179807,499,Upregulated,100,5
emrY,53,797,3.910515459427273,744,Upregulated,100,5
dsdA,519,1365,1.3950945074493342,846,Upregulated,100,5
dsdX,86,1253,3.8649059446197627,1167,Upregulated,100,5
dsdC,460,896,0.9618648711132289,436,Upregulated,100,5
yfdT,8,130,4.022367813028454,122,Upregulated,100,5
yfdS,5,163,5.026800059343715,158,Upregulated,100,5
yfdR,2,349,7.447083226209652,347,Upregulated,100,5
yfdQ,53,650,3.616375453352618,597,Upregulated,100,5
yfdP,8,218,4.768184324776926,210,Upregulated,100,5
yfdO,5,596,6.897240425574799,591,Upregulated,100,5
yfdN,3,448,7.222392421336448,445,Upregulated,100,5
yfdM,2,163,6.348728154231077,161,Upregulated,100,5
yfdL,5,424,6.405992359675837,419,Upregulated,100,5
yfdK,61,245,2.0059006014396843,184,Upregulated,100,5
tfaS,22,129,2.5517956367859567,107,Upregulated,100,5
yfdI,514,142,-1.855877429689196,-372,Downregulated,100,5
yfdH,920,562,-0.7110637307234491,-358,Downregulated,100,5
yfdG,289,212,-0.4470052279374796,-77,Unchanged,100,5
intS,574,1301,1.1804983200421075,727,Upregulated,100,5
yfdC,477,900,0.9159357352115255,423,Upregulated,100,5
mlaA,5785,1100,-2.3948134355828303,-4685,Downregulated,100,5
yfdF,46,258,2.4876652993662414,212,Upregulated,100,5
fadL,415,1341,1.6921259956701868,926,Upregulated,100,5
yfcZ,971,280,-1.7940444684742258,-691,Downregulated,100,5
fadI,57,1688,4.888209174542443,1631,Upregulated,100,5
fadJ,295,3042,3.366233293475293,2747,Upregulated,100,5
sixA,1782,871,-1.0327527129230574,-911,Downregulated,100,5
yfcV,9,496,5.784271308944563,487,Upregulated,100,5
yfcS,23,1040,5.498805856971441,1017,Upregulated,100,5
yfcR,35,439,3.6487941125903918,404,Upregulated,100,5
yfcQ,22,441,4.325203226920223,419,Upregulated,100,5
yfcP,27,675,4.643856189774724,648,Upregulated,100,5
yfcO,624,971,0.6379252665569439,347,Upregulated,100,5
smrB,1050,1099,0.06580205839574609,49,Unchanged,100,5
prmB,4764,2105,-1.1783531799103557,-2659,Downregulated,100,5
aroC,6610,3877,-0.7697095366438736,-2733,Downregulated,100,5
mepA,2355,1967,-0.25973010222161524,-388,Downregulated,100,5
yfcA,1300,1687,0.3759483503717489,387,Upregulated,100,5
epmC,1294,1022,-0.34044242105488615,-272,Downregulated,100,5
yfcL,394,370,-0.09067035894006407,-24,Unchanged,100,5
mnmC,1426,4951,1.7957459675182725,3525,Upregulated,100,5
fabB,4505,8243,0.8716423888252957,3738,Upregulated,100,5
yfcJ,390,2621,2.7485713245788066,2231,Upregulated,100,5
flk,872,1911,1.1319277382005304,1039,Upregulated,100,5
pdxB,3710,3424,-0.11573648510701863,-286,Downregulated,100,5
usg,1978,2961,0.5820420644184431,983,Upregulated,100,5
truA,555,1242,1.162105496983013,687,Upregulated,100,5
dedA,692,1230,0.8298143725898777,538,Upregulated,100,5
accD,13002,4494,-1.5326615296349224,-8508,Downregulated,100,5
folC,2611,3447,0.40073884105442764,836,Upregulated,100,5
dedD,2006,1673,-0.26188416057382796,-333,Downregulated,100,5
cvpA,4868,2123,-1.1972247968083507,-2745,Downregulated,100,5
purF,7738,5515,-0.48859984296447145,-2223,Downregulated,100,5
ubiX,634,1019,0.6845993060264066,385,Upregulated,100,5
argT,206,1178,2.515623296647242,972,Upregulated,100,5
hisJ,1225,3490,1.5104452872070817,2265,Upregulated,100,5
hisQ,422,1865,2.143860726435415,1443,Upregulated,100,5
hisM,278,1192,2.100227447738654,914,Upregulated,100,5
hisP,311,1687,2.4394734881569633,1376,Upregulated,100,5
rpnB,127,895,2.817059185379453,768,Upregulated,100,5
yfcH,1907,2064,0.11413812711049784,157,Upregulated,100,5
folX,662,308,-1.1039008661123162,-354,Downregulated,100,5
yfcG,248,841,1.761765679868269,593,Upregulated,100,5
yfcF,507,894,0.8182890841799771,387,Upregulated,100,5
yfcE,2076,1156,-0.8446650458572021,-920,Downregulated,100,5
yfcD,2943,1323,-1.153474480661718,-1620,Downregulated,100,5
yfcC,1489,2693,0.8548704759195719,1204,Upregulated,100,5
pta,1966,4752,1.2732715144601852,2786,Upregulated,100,5
ackA,2,1,-1.0,-1,Unchanged,100,5
yfbV,1435,1347,-0.09130088610074703,-88,Unchanged,100,5
yfbU,2808,1368,-1.0374747054186628,-1440,Downregulated,100,5
hxpA,4106,2090,-0.9742306851403568,-2016,Downregulated,100,5
yfbS,1499,3405,1.183654414951574,1906,Upregulated,100,5
yfbR,796,862,0.1149194385454494,66,Unchanged,100,5
alaA,4858,2801,-0.7944205065613587,-2057,Downregulated,100,5
lrhA,1614,2427,0.5885335298733533,813,Upregulated,100,5
nuoA,1799,1096,-0.7149473882909556,-703,Downregulated,100,5
nuoB,4216,2742,-0.6206462958579887,-1474,Downregulated,100,5
nuoC,9393,7895,-0.25064674311222684,-1498,Downregulated,100,5
nuoE,2488,1928,-0.3678814339006409,-560,Downregulated,100,5
nuoF,6727,5652,-0.2512017924974152,-1075,Downregulated,100,5
nuoG,10852,10182,-0.09193998201804657,-670,Downregulated,100,5
nuoH,3331,2832,-0.23413408859135365,-499,Downregulated,100,5
nuoI,1099,1533,0.4801663107095463,434,Upregulated,100,5
nuoJ,1365,1481,0.11767068948163283,116,Upregulated,100,5
nuoK,291,389,0.418751002077908,98,Unchanged,100,5
nuoL,4609,5209,0.17655266941405348,600,Upregulated,100,5
nuoM,3547,3878,0.12871347317160373,331,Upregulated,100,5
nuoN,5211,4153,-0.3274063830067539,-1058,Downregulated,100,5
yfbP,59,838,3.8281633843375102,779,Upregulated,100,5
yfbO,30,176,2.5525410230287786,146,Upregulated,100,5
yfbN,19,398,4.3886971071000636,379,Upregulated,100,5
yfbM,173,631,1.8668679673458244,458,Upregulated,100,5
yfbL,28,1046,5.223312214189337,1018,Upregulated,100,5
yfbK,79,2576,5.027136129937515,2497,Upregulated,100,5
elaD,55,415,2.9156078127096277,360,Upregulated,100,5
rbn,411,1558,1.9224849343799864,1147,Upregulated,100,5
elaA,690,784,0.18425729244967684,94,Unchanged,100,5
elaB,9861,641,-3.9433376951827253,-9220,Downregulated,100,5
menF,1610,2641,0.7140236131651136,1031,Upregulated,100,5
menD,1714,4043,1.238059094159195,2329,Upregulated,100,5
menH,147,1329,3.17645304443981,1182,Upregulated,100,5
menB,3115,2260,-0.4629093906088141,-855,Downregulated,100,5
menC,2646,2405,-0.13777616762127248,-241,Downregulated,100,5
menE,1821,3248,0.834820710208338,1427,Upregulated,100,5
pmrD,174,246,0.49957100949051153,72,Unchanged,100,5
arnF,69,400,2.5353317329965557,331,Upregulated,100,5
arnT,173,2970,4.101618988051404,2797,Upregulated,100,5
arnD,129,1585,3.6190398696035158,1456,Upregulated,100,5
arnA,615,3468,2.4954455829952327,2853,Upregulated,100,5
arnC,164,1267,2.9496488045227256,1103,Upregulated,100,5
arnB,326,2036,2.6427936918446178,1710,Upregulated,100,5
ais,34,458,3.7517409468466045,424,Upregulated,100,5
nudI,203,508,1.3233487695869897,305,Upregulated,100,5
yfaZ,155,796,2.3605002152694112,641,Upregulated,100,5
yfaY,1564,2724,0.8004861907047189,1160,Upregulated,100,5
yfaX,17,1011,5.894104440652675,994,Upregulated,100,5
rhmD,49,2224,5.504231228608299,2175,Upregulated,100,5
yfaV,37,2380,6.007292492566356,2343,Upregulated,100,5
yfaU,40,1353,5.0800180290891745,1313,Upregulated,100,5
rpnE,283,1170,2.0476345716388846,887,Upregulated,100,5
glpC,14723,6938,-1.0854799232219399,-7785,Downregulated,100,5
glpB,17244,9755,-0.8218806896821039,-7489,Downregulated,100,5
glpA,27879,16500,-0.7567127892131932,-11379,Downregulated,100,5
glpT,9621,4959,-0.956137629149333,-4662,Downregulated,100,5
glpQ,8403,3497,-1.2647866880979461,-4906,Downregulated,100,5
yfaH,3,106,5.142957953842043,103,Upregulated,100,5
inaA,544,1205,1.1473545898669844,661,Upregulated,100,5
yfaE,201,241,0.26183764505103296,40,Unchanged,100,5
nrdB,2013,2355,0.2263798875788059,342,Upregulated,100,5
nrdA,1142,4666,2.0306236566213562,3524,Upregulated,100,5
yfaL,1171,6569,2.487932689709059,5398,Upregulated,100,5
ubiG,1622,1788,0.14057291696604474,166,Upregulated,100,5
gyrA,16891,12835,-0.39617144681057487,-4056,Downregulated,100,5
yfaA,167,2759,4.046225448879221,2592,Upregulated,100,5
yfaT,17,849,5.642157902302699,832,Upregulated,100,5
yfaQ,111,2774,4.643336205973497,2663,Upregulated,100,5
yfaP,28,1013,5.1770635367435345,985,Upregulated,100,5
atoB,96,1658,4.110265790774594,1562,Upregulated,100,5
atoE,62,2130,5.102441404726325,2068,Upregulated,100,5
atoA,9,989,6.779901709316799,980,Upregulated,100,5
atoD,12,953,6.311369903188786,941,Upregulated,100,5
atoC,286,1897,2.7296326266330864,1611,Upregulated,100,5
atoS,165,2557,3.953914230995833,2392,Upregulated,100,5
rcsC,3070,5008,0.7059959066750766,1938,Upregulated,100,5
rcsB,6121,2103,-1.5413185180747846,-4018,Downregulated,100,5
rcsD,7900,6604,-0.25851253303856964,-1296,Downregulated,100,5
ompC,353442,36375,-3.2804543343829895,-317067,Downregulated,100,5
ftp,341,2012,2.5607866607813548,1671,Upregulated,100,5
ada,613,2311,1.9145582807768495,1698,Upregulated,100,5
alkB,157,1046,2.7360463873553145,889,Upregulated,100,5
yojI,106,2952,4.799556551497197,2846,Upregulated,100,5
mqo,82,3739,5.510884751240085,3657,Upregulated,100,5
eco,1033,860,-0.26443168927559924,-173,Downregulated,100,5
napF,210,1020,2.2801079191927354,810,Upregulated,100,5
napD,41,288,2.812372996824229,247,Upregulated,100,5
napA,1787,7122,1.9947428013215722,5335,Upregulated,100,5
napG,268,1491,2.47597535182567,1223,Upregulated,100,5
napH,250,1942,2.957543200757105,1692,Upregulated,100,5
napB,144,787,2.450294824065174,643,Upregulated,100,5
napC,321,946,1.5592668862170922,625,Upregulated,100,5
ccmA,437,1405,1.68486494560769,968,Upregulated,100,5
ccmB,202,1227,2.6027080509111102,1025,Upregulated,100,5
ccmC,401,1443,1.8473971580362778,1042,Upregulated,100,5
ccmD,39,184,2.2381597371947644,145,Upregulated,100,5
ccmE,332,939,1.4999419163068497,607,Upregulated,100,5
ccmF,792,4796,2.598259323334614,4004,Upregulated,100,5
ccmG,203,921,2.1817214289061595,718,Upregulated,100,5
ccmH,455,1900,2.0620609681322515,1445,Upregulated,100,5
narP,1519,1264,-0.2651254063249806,-255,Downregulated,100,5
insH8,7246,3927,-0.8837572077868905,-3319,Downregulated,100,5
yejM,1918,3987,1.0557008849792,2069,Upregulated,100,5
yejL,277,210,-0.3994966483830657,-67,Unchanged,100,5
yejK,3066,2200,-0.47885417324675567,-866,Downregulated,100,5
rplY,9196,1156,-2.991865068217501,-8040,Downregulated,100,5
radD,504,3226,2.6782507996557263,2722,Upregulated,100,5
rsuA,1416,1479,0.06280078701607025,63,Unchanged,100,5
bcr,1387,2263,0.7062687969432897,876,Upregulated,100,5
yejG,163,505,1.6314114234080794,342,Upregulated,100,5
yejF,716,2588,1.8538061247282511,1872,Upregulated,100,5
yejE,272,1356,2.3176786218860044,1084,Upregulated,100,5
yejB,322,1590,2.3038941720571007,1268,Upregulated,100,5
yejA,1017,2815,1.4688152431100918,1798,Upregulated,100,5
pdeN,611,2480,2.021095835455508,1869,Upregulated,100,5
mepS,8428,1858,-2.1814398124346535,-6570,Downregulated,100,5
lpxT,494,771,0.6422198183303567,277,Upregulated,100,5
yeiR,757,1704,1.1705601302401067,947,Upregulated,100,5
yeiQ,90,2504,4.798165750602943,2414,Upregulated,100,5
yeiP,1136,542,-1.0675980781508105,-594,Downregulated,100,5
setB,91,1872,4.362570079384708,1781,Upregulated,100,5
fruB,12073,3052,-1.9839573462841358,-9021,Downregulated,100,5
fruK,8840,2580,-1.7766753039681773,-6260,Downregulated,100,5
fruA,22641,5623,-2.009525728050357,-17018,Downregulated,100,5
psuK,40,977,4.610286657081023,937,Upregulated,100,5
psuG,83,1428,4.104740832682175,1345,Upregulated,100,5
psuT,211,2147,3.3470072871515884,1936,Upregulated,100,5
yeiL,35,501,3.839383776250242,466,Upregulated,100,5
rihB,21,1173,5.803669875249748,1152,Upregulated,100,5
nupX,52,1823,5.131659127898042,1771,Upregulated,100,5
yeiI,661,1942,1.5548210239115006,1281,Upregulated,100,5
nfo,985,1790,0.8617639578078801,805,Upregulated,100,5
yeiH,1807,1907,0.07770833744815672,100,Unchanged,100,5
yeiE,1258,1735,0.46380374058633406,477,Upregulated,100,5
lysP,3826,2848,-0.4258877273797146,-978,Downregulated,100,5
cirA,218,3231,3.8895807104884375,3013,Upregulated,100,5
yeiG,3311,3785,0.19302628947609457,474,Upregulated,100,5
folE,6927,1649,-2.0706392750578044,-5278,Downregulated,100,5
yeiB,1356,2163,0.6736764868256349,807,Upregulated,100,5
galS,218,1860,3.092902581218467,1642,Upregulated,100,5
mglB,126,1676,3.733526510199435,1550,Upregulated,100,5
mglA,30,1812,5.916476644437717,1782,Upregulated,100,5
mglC,34,1684,5.630213581816057,1650,Upregulated,100,5
preA,1569,2762,0.8158679672899533,1193,Upregulated,100,5
preT,2219,3272,0.5602630807447375,1053,Upregulated,100,5
yeiS,54,189,1.8073549220576042,135,Upregulated,100,5
sanA,314,929,1.5649140374910258,615,Upregulated,100,5
cdd,632,2438,1.9477016624431092,1806,Upregulated,100,5
yohK,185,1505,3.0241663111307524,1320,Upregulated,100,5
yohJ,86,802,3.2211936717528222,716,Upregulated,100,5
dusC,165,2308,3.806105294399667,2143,Upregulated,100,5
mdtQ,39,3047,6.2877715658242375,3008,Upregulated,100,5
yohF,287,1591,2.47081119365536,1304,Upregulated,100,5
yohD,419,1101,1.3937923198650173,682,Upregulated,100,5
yohC,377,1073,1.5090136474878577,696,Upregulated,100,5
pbpG,1595,1746,0.13049713497720836,151,Upregulated,100,5
dld,4718,4521,-0.0615335009204825,-197,Downregulated,100,5
bglX,3112,6246,1.0050905090343814,3134,Upregulated,100,5
osmF,919,1761,0.9382581425421738,842,Upregulated,100,5
yehY,448,2612,2.543584259488827,2164,Upregulated,100,5
yehX,252,2102,3.060267030462262,1850,Upregulated,100,5
yehW,135,1352,3.3240638392313535,1217,Upregulated,100,5
mlrA,430,1274,1.5669567126668402,844,Upregulated,100,5
btsS,453,3196,2.8186844528817416,2743,Upregulated,100,5
btsR,363,1122,1.628031222613042,759,Upregulated,100,5
yehS,271,770,1.5065655942283922,499,Upregulated,100,5
yehR,16,435,4.764871590736091,419,Upregulated,100,5
yehQ,123,3454,4.8115378621896845,3331,Upregulated,100,5
yehP,32,1860,5.861086905995394,1828,Upregulated,100,5
yehM,68,4365,6.004303097266463,4297,Upregulated,100,5
yehL,22,1949,6.469086756620593,1927,Upregulated,100,5
yehI,305,5956,4.287462606131851,5651,Upregulated,100,5
metG,10395,6258,-0.7321161945048105,-4137,Downregulated,100,5
mrp,6457,4014,-0.6858234103847323,-2443,Downregulated,100,5
yehE,273,95,-1.5229015325889046,-178,Downregulated,100,5
yehD,115,218,0.9226942738325511,103,Upregulated,100,5
yehC,16,387,4.59618975614441,371,Upregulated,100,5
yehB,89,2652,4.89713162914619,2563,Upregulated,100,5
yehA,18,434,4.5916262310021665,416,Upregulated,100,5
rcnB,1118,456,-1.2938144586784484,-662,Downregulated,100,5
rcnA,78,1094,3.809994803930308,1016,Upregulated,100,5
rcnR,115,276,1.2630344058337937,161,Upregulated,100,5
thiM,194,1102,2.50599566638403,908,Upregulated,100,5
thiD,232,1166,2.329371078072924,934,Upregulated,100,5
yegX,154,1141,2.8892965355937803,987,Upregulated,100,5
yegW,332,1003,1.595066459265256,671,Upregulated,100,5
yegV,288,1793,2.6382347714260623,1505,Upregulated,100,5
yegU,323,1996,2.627505650643336,1673,Upregulated,100,5
yegT,140,2037,3.8629472480209217,1897,Upregulated,100,5
fbaB,28402,3261,-3.1226061781960226,-25141,Downregulated,100,5
gatY,63081,52673,-0.2601419000437396,-10408,Downregulated,100,5
gatZ,94167,68585,-0.45732848476521315,-25582,Downregulated,100,5
gatA,12288,8185,-0.5861957993596403,-4103,Downregulated,100,5
gatB,6011,1944,-1.6285768011158377,-4067,Downregulated,100,5
gatC,39885,22508,-0.825408409408629,-17377,Downregulated,100,5
gatD,5237,6935,0.405155277761614,1698,Upregulated,100,5
insF5,30,675,4.491853096329675,645,Upregulated,100,5
insE5,80,103,0.3645724322958561,23,Unchanged,100,5
yegS,830,1382,0.7355743741539715,552,Upregulated,100,5
yegR,26,87,1.7425037777076362,61,Unchanged,100,5
yegZ,5,57,3.5109619192773796,52,Unchanged,100,5
ogrK,95,130,0.4525122046975067,35,Unchanged,100,5
trhP,1783,3475,0.9627062748732371,1692,Upregulated,100,5
yegP,396,276,-0.5208321633014404,-120,Downregulated,100,5
baeR,709,1435,1.017193204323534,726,Upregulated,100,5
baeS,206,2176,3.400962314067121,1970,Upregulated,100,5
mdtD,195,2620,3.748020782675202,2425,Upregulated,100,5
mdtC,498,6795,3.7702559035866727,6297,Upregulated,100,5
mdtB,687,7160,3.3815775833335184,6473,Upregulated,100,5
mdtA,358,2090,2.5454714497039888,1732,Upregulated,100,5
yegL,54,1058,4.292236409950557,1004,Upregulated,100,5
pphC,23,1372,5.898502810115799,1349,Upregulated,100,5
yegJ,19,339,4.157213949692759,320,Upregulated,100,5
yegI,167,3354,4.327962681090294,3187,Upregulated,100,5
yegD,419,2672,2.6728978587747005,2253,Upregulated,100,5
alkA,316,1378,2.1245794245271883,1062,Upregulated,100,5
dgcE,1170,6681,2.5135555290381792,5511,Upregulated,100,5
udk,1166,1154,-0.014924564555013892,-12,Unchanged,100,5
dcd,3006,2147,-0.4855228180575914,-859,Downregulated,100,5
asmA,3564,4666,0.38868897046227724,1102,Upregulated,100,5
yegH,1224,3651,1.5766881107422328,2427,Upregulated,100,5
wza,169,1416,3.0667261138008133,1247,Upregulated,100,5
wzb,37,533,3.848538357130226,496,Upregulated,100,5
wzc,342,3733,3.448267278417172,3391,Upregulated,100,5
wcaA,129,1122,3.1206297051855385,993,Upregulated,100,5
wcaB,60,557,3.2146429217315133,497,Upregulated,100,5
wcaC,155,1827,3.559136513353251,1672,Upregulated,100,5
wcaD,137,944,2.7846109664013143,807,Upregulated,100,5
wcaE,64,682,3.4136279290241727,618,Upregulated,100,5
wcaF,31,426,3.780513309838963,395,Upregulated,100,5
gmd,291,1452,2.318950395087467,1161,Upregulated,100,5
fcl,241,1314,2.446860224092368,1073,Upregulated,100,5
gmm,66,437,2.727095350142145,371,Upregulated,100,5
wcaI,137,1658,3.5971962085352236,1521,Upregulated,100,5
cpsB,146,2095,3.842909969706697,1949,Upregulated,100,5
cpsG,135,1835,3.764748750679744,1700,Upregulated,100,5
wcaJ,108,1972,4.190556334214443,1864,Upregulated,100,5
wzxC,103,1853,4.1691466388440475,1750,Upregulated,100,5
wcaK,198,1800,3.1844245711374275,1602,Upregulated,100,5
wcaL,283,1732,2.6135649718948426,1449,Upregulated,100,5
wcaM,260,1368,2.3954847018574434,1108,Upregulated,100,5
galF,12704,2315,-2.456198718995359,-10389,Downregulated,100,5
rfbB,4733,1652,-1.5185412353189183,-3081,Downregulated,100,5
rfbD,3083,1511,-1.028831228942346,-1572,Downregulated,100,5
rfbA,3124,1145,-1.448046855157673,-1979,Downregulated,100,5
rfbC,1192,395,-1.5934596773976963,-797,Downregulated,100,5
rfbX,1662,601,-1.467483486059159,-1061,Downregulated,100,5
glf,2686,1029,-1.3842163225334738,-1657,Downregulated,100,5
wbbH,987,513,-0.9440912588493436,-474,Downregulated,100,5
wbbI,2331,592,-1.9772799234999165,-1739,Downregulated,100,5
wbbJ,1085,583,-0.8961272541313453,-502,Downregulated,100,5
wbbK,1597,283,-2.4964903545793504,-1314,Downregulated,100,5
insH7,2926,2885,-0.02035845060564203,-41,Unchanged,100,5
gnd,40426,5825,-2.7949535065669906,-34601,Downregulated,100,5
ugd,1130,905,-0.3203330753319823,-225,Downregulated,100,5
wzzB,6004,2255,-1.412796543477945,-3749,Downregulated,100,5
hisI,1914,1093,-0.808297428814121,-821,Downregulated,100,5
hisF,1889,1433,-0.39858409212622414,-456,Downregulated,100,5
hisA,1544,1471,-0.06987550601325024,-73,Unchanged,100,5
hisH,1302,1105,-0.23668307888684156,-197,Downregulated,100,5
hisB,3244,2322,-0.4824058473517066,-922,Downregulated,100,5
hisC,2844,2568,-0.1472762624971122,-276,Downregulated,100,5
hisD,3180,3383,0.0892764116222706,203,Upregulated,100,5
hisG,2132,2193,0.04069837391441764,61,Unchanged,100,5
hisL,1,1,0.0,0,Unchanged,100,5
yefM,295,285,-0.049753035197099615,-10,Unchanged,100,5
yeeZ,3853,2428,-0.6662137644038679,-1425,Downregulated,100,5
yeeY,311,1361,2.129680581373392,1050,Upregulated,100,5
plaP,1482,1908,0.36451572369967766,426,Upregulated,100,5
yeeE,251,2267,3.175025121790014,2016,Upregulated,100,5
yeeD,97,310,1.67621156308711,213,Upregulated,100,5
sbcB,2188,2526,0.20724190099499581,338,Upregulated,100,5
dacD,369,1468,1.9921592467828166,1099,Upregulated,100,5
sbmC,870,514,-0.7592470415422125,-356,Downregulated,100,5
yeeA,580,1031,0.829919527353174,451,Upregulated,100,5
yeeX,6484,1324,-2.291980968710324,-5160,Downregulated,100,5
yeeW,6,27,2.169925001442312,21,Unchanged,100,5
cbtA,9,194,4.429987840744816,185,Upregulated,100,5
cbeA,17,318,4.225420114034016,301,Upregulated,100,5
yeeT,5,88,4.137503523749935,83,Unchanged,100,5
yeeS,81,450,2.473931188332412,369,Upregulated,100,5
yeeR,1122,2184,0.9609001803110596,1062,Upregulated,100,5
flu,38462,25731,-0.5799262573462889,-12731,Downregulated,100,5
yeeP,83,557,2.746494085993107,474,Upregulated,100,5
insC3,233,153,-0.6067983019616285,-80,Unchanged,100,5
insD3,456,438,-0.05810295456356828,-18,Unchanged,100,5
insH6,511,1656,1.6963074765617039,1145,Upregulated,100,5
cobU,194,535,1.4634822391013815,341,Upregulated,100,5
cobS,373,1097,1.556315990147955,724,Upregulated,100,5
cobT,829,1589,0.9386751178527688,760,Upregulated,100,5
ldtA,1397,1039,-0.4271363665052513,-358,Downregulated,100,5
nac,79,638,3.0136318655877665,559,Upregulated,100,5
cbl,117,875,2.902774487136287,758,Upregulated,100,5
yeeO,650,1648,1.3422046192674015,998,Upregulated,100,5
yeeN,1875,761,-1.30092223676706,-1114,Downregulated,100,5
amn,4097,2585,-0.6644036122780042,-1512,Downregulated,100,5
shiA,1386,1416,0.030894007945783775,30,Unchanged,100,5
yeeJ,1294,7180,2.472146226717906,5886,Upregulated,100,5
mtfA,1449,900,-0.6870606883398924,-549,Downregulated,100,5
yodB,70,270,1.9475325801058645,200,Upregulated,100,5
zinT,51,190,1.8974302663594522,139,Upregulated,100,5
msrQ,194,536,1.4661763482706447,342,Upregulated,100,5
msrP,476,1049,1.1399811992693243,573,Upregulated,100,5
hiuH,31,173,2.4804319172498497,142,Upregulated,100,5
hprR,378,491,0.3773367900936203,113,Upregulated,100,5
hprS,416,747,0.8445247146481449,331,Upregulated,100,5
hchA,6245,911,-2.7771786126932687,-5334,Downregulated,100,5
drpB,486,353,-0.4612881303346007,-133,Downregulated,100,5
yedJ,1422,1072,-0.40761655916164274,-350,Downregulated,100,5
dcm,2938,2402,-0.2905982448506457,-536,Downregulated,100,5
vsr,225,410,0.865698908288409,185,Upregulated,100,5
yedA,31,882,4.830438535170646,851,Upregulated,100,5
yedI,806,1206,0.5813781633721175,400,Upregulated,100,5
yodC,133,80,-0.7333543406138273,-53,Unchanged,100,5
dgcQ,1065,2066,0.9559868237518588,1001,Upregulated,100,5
yedP,900,874,-0.04229172171643864,-26,Unchanged,100,5
dsrA,1,1,0.0,0,Unchanged,100,5
yodD,312,101,-1.6271907361104536,-211,Downregulated,100,5
dsrB,115,50,-1.2016338611696507,-65,Unchanged,100,5
rcsA,605,214,-1.49932434576081,-391,Downregulated,100,5
fliR,70,733,3.3883863711888456,663,Upregulated,100,5
fliQ,39,187,2.261492241025388,148,Upregulated,100,5
fliP,195,683,1.8084114545404797,488,Upregulated,100,5
fliO,160,315,0.9772799234999164,155,Upregulated,100,5
fliN,343,301,-0.1884450894131103,-42,Unchanged,100,5
fliM,895,1085,0.277735455180223,190,Upregulated,100,5
fliL,388,325,-0.25561693427131077,-63,Unchanged,100,5
fliK,341,1315,1.9472191551554923,974,Upregulated,100,5
fliJ,128,315,1.2992080183872787,187,Upregulated,100,5
fliI,526,1813,1.7852442204518557,1287,Upregulated,100,5
fliH,546,839,0.6197698595199709,293,Upregulated,100,5
fliG,755,1299,0.78285288123544,544,Upregulated,100,5
fliF,1100,2147,0.9648186674467513,1047,Upregulated,100,5
fliE,356,213,-0.7410238107405596,-143,Downregulated,100,5
intG,1,14,3.807354922057604,13,Unchanged,100,5
yedL,77,406,2.398549376490275,329,Upregulated,100,5
yedK,102,706,2.7910990312996846,604,Upregulated,100,5
yedF,150,110,-0.4474589769712214,-40,Unchanged,100,5
yedE,1585,1795,0.17950100368364416,210,Upregulated,100,5
yedD,1123,564,-0.9935908600018076,-559,Downregulated,100,5
amyA,977,1698,0.7974059915846532,721,Upregulated,100,5
fliT,50,268,2.4222330006830477,218,Upregulated,100,5
fliS,97,263,1.4390061471051747,166,Upregulated,100,5
fliD,453,1915,2.079761436766084,1462,Upregulated,100,5
fliC,4914,1763,-1.4788653830419831,-3151,Downregulated,100,5
fliA,2101,761,-1.4651078031695006,-1340,Downregulated,100,5
fliZ,827,527,-0.6500843675340601,-300,Downregulated,100,5
tcyJ,4462,4044,-0.14190751634112583,-418,Downregulated,100,5
dcyD,2511,2486,-0.01443573221901491,-25,Unchanged,100,5
tcyL,929,1102,0.24637372218850462,173,Upregulated,100,5
tcyN,1082,1431,0.4033231728998524,349,Upregulated,100,5
sdiA,168,686,2.029747343394052,518,Upregulated,100,5
yecF,153,71,-1.1076407231879697,-82,Unchanged,100,5
uvrY,2317,1116,-1.0539210170356341,-1201,Downregulated,100,5
uvrC,3224,3042,-0.08383159080347061,-182,Downregulated,100,5
pgsA,1305,840,-0.6355885737911242,-465,Downregulated,100,5
yecA,2045,1225,-0.7393190939391782,-820,Downregulated,100,5
tyrP,643,1570,1.287873916451042,927,Upregulated,100,5
yecH,461,271,-0.7664738990754665,-190,Downregulated,100,5
ftnA,20910,1511,-3.7906174963121124,-19399,Downregulated,100,5
yecR,63,203,1.6880559936852597,140,Upregulated,100,5
ftnB,1587,552,-1.5235619560570128,-1035,Downregulated,100,5
araF,121,1145,3.2422686457097116,1024,Upregulated,100,5
araG,171,2094,3.6141932120449107,1923,Upregulated,100,5
otsB,2591,1202,-1.108072119468909,-1389,Downregulated,100,5
otsA,8145,2323,-1.8099255446040725,-5822,Downregulated,100,5
uspC,284,318,0.1631358357796734,34,Unchanged,100,5
insA5,26,90,1.7914133781885826,64,Unchanged,100,5
insB5,32,769,4.586839787961827,737,Upregulated,100,5
flhD,773,319,-1.276911990159978,-454,Downregulated,100,5
flhC,1344,571,-1.2349704874159175,-773,Downregulated,100,5
motA,183,1257,2.780069096136465,1074,Upregulated,100,5
motB,154,1315,3.0940605434847632,1161,Upregulated,100,5
cheA,517,2872,2.473819563508117,2355,Upregulated,100,5
cheW,188,540,1.5222267453731935,352,Upregulated,100,5
tar,475,2445,2.363835046621286,1970,Upregulated,100,5
tap,282,2352,3.0601209924375707,2070,Upregulated,100,5
cheR,124,1158,3.2232232276023614,1034,Upregulated,100,5
cheB,99,1349,3.768318012868658,1250,Upregulated,100,5
cheY,95,346,1.864772619305777,251,Upregulated,100,5
cheZ,243,875,1.8483267031139103,632,Upregulated,100,5
flhB,506,1618,1.6770023177356674,1112,Upregulated,100,5
flhA,997,3210,1.6869078876114694,2213,Upregulated,100,5
flhE,96,337,1.8116422804607022,241,Upregulated,100,5
yecT,35,172,2.2969817377571315,137,Upregulated,100,5
argS,4800,3297,-0.5418805188254936,-1503,Downregulated,100,5
yecM,543,764,0.4926204402313871,221,Upregulated,100,5
cutC,936,1099,0.23161095136582666,163,Upregulated,100,5
torY,13,938,6.173004394374285,925,Upregulated,100,5
torZ,328,3126,3.2525500583815807,2798,Upregulated,100,5
cmoB,1181,1623,0.4586540351508142,442,Upregulated,100,5
cmoA,1152,1150,-0.0025068556105748664,-2,Unchanged,100,5
yecN,669,469,-0.5124182881260844,-200,Downregulated,100,5
yecE,315,803,1.3500481591300355,488,Upregulated,100,5
yecD,866,874,0.013266254773873592,8,Unchanged,100,5
aspS,9753,8775,-0.1524469313322267,-978,Downregulated,100,5
nudB,978,810,-0.27191255718024665,-168,Downregulated,100,5
yebC,2981,2288,-0.38170932321277934,-693,Downregulated,100,5
ruvC,1283,1176,-0.12563311025331814,-107,Downregulated,100,5
yebB,37,434,3.5520978668155294,397,Upregulated,100,5
ruvA,769,747,-0.04187535517258934,-22,Unchanged,100,5
ruvB,2052,1825,-0.16913426695231218,-227,Downregulated,100,5
znuB,644,963,0.5804751097288424,319,Upregulated,100,5
znuC,759,939,0.30702527223830817,180,Upregulated,100,5
znuA,1247,1272,0.028637205454685438,25,Unchanged,100,5
mepM,4091,3182,-0.3625197015569986,-909,Downregulated,100,5
lpxM,1591,1727,0.11833424719787643,136,Upregulated,100,5
pykA,39109,14137,-1.4680246478466752,-24972,Downregulated,100,5
yebK,829,1338,0.6906341091457104,509,Upregulated,100,5
zwf,5426,2890,-0.908819554893825,-2536,Downregulated,100,5
edd,3784,2938,-0.3650776927831154,-846,Downregulated,100,5
eda,9402,2647,-1.828609485698338,-6755,Downregulated,100,5
purT,3466,1840,-0.9135658882157943,-1626,Downregulated,100,5
yebG,1595,615,-1.3748981084256295,-980,Downregulated,100,5
yebF,1866,906,-1.0423660308055236,-960,Downregulated,100,5
yebE,617,1215,0.9776139193437254,598,Upregulated,100,5
ptrB,1446,2692,0.8966108576591993,1246,Upregulated,100,5
exoX,1039,965,-0.10659480674876895,-74,Unchanged,100,5
yobB,1053,749,-0.4914678125669659,-304,Downregulated,100,5
holE,509,130,-1.9691540330472408,-379,Downregulated,100,5
yobA,1006,736,-0.4508526337485142,-270,Downregulated,100,5
yebZ,1348,2008,0.5749387727689135,660,Upregulated,100,5
yebY,664,333,-0.9956610642756626,-331,Downregulated,100,5
pphA,105,590,2.490325626583081,485,Upregulated,100,5
yebW,76,48,-0.6629650127224294,-28,Unchanged,100,5
yebV,517,89,-2.538287039348537,-428,Downregulated,100,5
rsmF,596,1844,1.6294544199671765,1248,Upregulated,100,5
letB,2046,3532,0.7876791979031373,1486,Upregulated,100,5
letA,828,1540,0.8952276780829385,712,Upregulated,100,5
msrC,4221,843,-2.3239802930156066,-3378,Downregulated,100,5
proQ,9926,2443,-2.022558591029864,-7483,Downregulated,100,5
prc,14880,4310,-1.7876147520189332,-10570,Downregulated,100,5
htpX,5623,4150,-0.4382287104191545,-1473,Downregulated,100,5
yebQ,59,1292,4.452747305332084,1233,Upregulated,100,5
kdgR,2476,1831,-0.4353795234169275,-645,Downregulated,100,5
mgrB,45,11,-2.0324214776923775,-34,Unchanged,100,5
yebO,760,220,-1.7884958948062881,-540,Downregulated,100,5
yobF,1076,53,-4.343541907993425,-1023,Downregulated,100,5
cspC,8006,425,-4.235546869362475,-7581,Downregulated,100,5
rlmA,545,971,0.8332150657549035,426,Upregulated,100,5
mntP,177,656,1.8899464545350864,479,Upregulated,100,5
yobD,853,446,-0.9355020313979854,-407,Downregulated,100,5
manZ,23603,10209,-1.2091286842324276,-13394,Downregulated,100,5
manY,23378,10298,-1.1827873365932655,-13080,Downregulated,100,5
manX,24692,11537,-1.0977755719525577,-13155,Downregulated,100,5
yoaE,1632,2503,0.6170172337168363,871,Upregulated,100,5
pdeD,324,1715,2.40414285817555,1391,Upregulated,100,5
sdaA,1818,2541,0.4830441758592477,723,Upregulated,100,5
nudL,547,694,0.34339482978570424,147,Upregulated,100,5
pabB,1206,1971,0.7086978691434009,765,Upregulated,100,5
yoaH,124,85,-0.5448053742491735,-39,Unchanged,100,5
yoaC,291,174,-0.7419318470595556,-117,Downregulated,100,5
yoaB,2553,549,-2.21731548340192,-2004,Downregulated,100,5
yoaA,2064,3174,0.6208591574119279,1110,Upregulated,100,5
tsaB,661,1159,0.8101583894987802,498,Upregulated,100,5
yeaY,919,821,-0.16268263951122966,-98,Unchanged,100,5
fadD,671,2176,1.6972938850501558,1505,Upregulated,100,5
rnd,994,1599,0.6858521819180459,605,Upregulated,100,5
yeaX,155,953,2.6202079986357045,798,Upregulated,100,5
yeaW,107,1439,3.7493838903391508,1332,Upregulated,100,5
yeaV,86,1656,4.267222202797227,1570,Upregulated,100,5
dmlA,87244,1543,-5.8212459497692866,-85701,Downregulated,100,5
dmlR,1036,1117,0.10860518279676099,81,Unchanged,100,5
leuE,629,481,-0.38702312310924736,-148,Downregulated,100,5
yeaR,28,246,3.1351595832816357,218,Upregulated,100,5
yoaG,2,16,3.0,14,Unchanged,100,5
yeaQ,2365,186,-3.668465657118726,-2179,Downregulated,100,5
dgcP,2402,1469,-0.7094017551493541,-933,Downregulated,100,5
yoaF,80,152,0.925999418556223,72,Unchanged,100,5
yeaO,358,340,-0.07442484112655467,-18,Unchanged,100,5
nimT,144,1366,3.245816766847778,1222,Upregulated,100,5
nimR,279,908,1.7024271754617275,629,Upregulated,100,5
yeaL,294,508,0.7890123419358014,214,Upregulated,100,5
yoaI,1,1,0.0,0,Unchanged,100,5
yeaK,1322,1063,-0.31458057997658706,-259,Downregulated,100,5
dgcJ,427,1152,1.431832741821822,725,Upregulated,100,5
cdgI,122,762,2.6429098499304358,640,Upregulated,100,5
yeaH,733,1323,0.851927958144865,590,Upregulated,100,5
yeaG,2926,2511,-0.220667740866987,-415,Downregulated,100,5
mipA,4677,1445,-1.6945139360308996,-3232,Downregulated,100,5
yeaE,704,1153,0.7117451790144745,449,Upregulated,100,5
yeaD,11466,1765,-2.69962209554007,-9701,Downregulated,100,5
gapA,318154,45160,-2.8166078688035605,-272994,Downregulated,100,5
msrB,802,753,-0.09095237178299216,-49,Unchanged,100,5
yeaC,448,415,-0.11038739582331702,-33,Unchanged,100,5
ydjL,137,1262,3.203464112022022,1125,Upregulated,100,5
ydjK,106,1349,3.6697541783850687,1243,Upregulated,100,5
ydjJ,99,1112,3.4895844526438977,1013,Upregulated,100,5
ydjI,154,755,2.2935462935175397,601,Upregulated,100,5
ydjH,101,849,3.0714092608012438,748,Upregulated,100,5
ydjG,190,944,2.3127874410308937,754,Upregulated,100,5
ydjF,463,574,0.3100385434154514,111,Upregulated,100,5
ydjE,45,1157,4.6843200527778155,1112,Upregulated,100,5
pncA,444,792,0.8349407537295036,348,Upregulated,100,5
ansA,561,1260,1.167351057778486,699,Upregulated,100,5
sppA,1986,2726,0.45691993927683555,740,Upregulated,100,5
ydjA,1447,1795,0.31091892217868905,348,Upregulated,100,5
selD,6696,4166,-0.6846366885096968,-2530,Downregulated,100,5
topB,5499,5407,-0.024340930179042635,-92,Unchanged,100,5
ynjI,130,717,2.4634614956734504,587,Upregulated,100,5
gdhA,22177,12819,-0.7907804948627224,-9358,Downregulated,100,5
ynjH,44,145,1.7204774713776372,101,Upregulated,100,5
nudG,113,442,1.9677235969762439,329,Upregulated,100,5
ynjF,329,823,1.3228048466863842,494,Upregulated,100,5
ynjE,3862,2603,-0.5691728525465383,-1259,Downregulated,100,5
ynjD,428,825,0.9467833227320311,397,Upregulated,100,5
ynjC,1098,2504,1.1893565079274198,1406,Upregulated,100,5
ynjB,2106,2311,0.13401182344191415,205,Upregulated,100,5
ynjA,767,900,0.23069842371410365,133,Upregulated,100,5
ydjZ,1499,1177,-0.3488860629094155,-322,Downregulated,100,5
ydjY,2364,1050,-1.1708407076240475,-1314,Downregulated,100,5
ydjX,1211,919,-0.39806209840529433,-292,Downregulated,100,5
xthA,1677,1280,-0.38973887867698387,-397,Downregulated,100,5
astC,47,2311,5.619712692789993,2264,Upregulated,100,5
astA,31,1997,6.009422307057098,1966,Upregulated,100,5
astD,104,2929,4.815752759738275,2825,Upregulated,100,5
astB,112,2427,4.43760347109353,2315,Upregulated,100,5
astE,34,1527,5.489021505546512,1493,Upregulated,100,5
spy,1578,1880,0.25263545655154107,302,Upregulated,100,5
ves,45,807,4.1645717669481055,762,Upregulated,100,5
cho,1004,1495,0.5743862151346953,491,Upregulated,100,5
nadE,6223,2659,-1.2267264690297064,-3564,Downregulated,100,5
osmE,9861,1027,-3.2632977754832715,-8834,Downregulated,100,5
chbB,57,168,1.5594274086140185,111,Upregulated,100,5
chbC,67,1759,4.714450577014189,1692,Upregulated,100,5
chbA,79,378,2.2584616760439697,299,Upregulated,100,5
chbR,236,738,1.6448339566985548,502,Upregulated,100,5
chbF,158,1477,3.224673362587686,1319,Upregulated,100,5
chbG,370,1035,1.4840335918703755,665,Upregulated,100,5
katE,10012,3934,-1.3476613334098018,-6078,Downregulated,100,5
cedA,98,192,0.970252656605948,94,Unchanged,100,5
ydjO,10,181,4.177917792195843,171,Upregulated,100,5
tcyP,1608,4421,1.4591053277751376,2813,Upregulated,100,5
ydjM,149,714,2.260611743566938,565,Upregulated,100,5
hxpB,873,995,0.18871487180157107,122,Upregulated,100,5
yniB,1201,781,-0.6208416975636547,-420,Downregulated,100,5
yniA,3329,2044,-0.7036936742026417,-1285,Downregulated,100,5
ydiZ,485,236,-1.0391978877126489,-249,Downregulated,100,5
pfkB,5287,3339,-0.6630332333178263,-1948,Downregulated,100,5
ydiY,68,803,3.561793336266975,735,Upregulated,100,5
thrS,43564,13497,-1.6904976541053067,-30067,Downregulated,100,5
infC,37449,8442,-2.1492704605293826,-29007,Downregulated,100,5
rpmI,4477,1441,-1.6354619827287968,-3036,Downregulated,100,5
rplT,29138,6390,-2.1890140195284826,-22748,Downregulated,100,5
pheM,1,1,0.0,0,Unchanged,100,5
pheS,4551,2685,-0.7612614980954147,-1866,Downregulated,100,5
pheT,14837,8307,-0.8367999529957835,-6530,Downregulated,100,5
ihfA,4496,856,-2.392959333819779,-3640,Downregulated,100,5
btuC,858,1462,0.7688937584528917,604,Upregulated,100,5
btuE,1235,640,-0.9483672315846776,-595,Downregulated,100,5
btuD,992,1084,0.1279527309669964,92,Unchanged,100,5
nlpC,1156,574,-1.010018755824991,-582,Downregulated,100,5
rflP,650,520,-0.3219280948873623,-130,Downregulated,100,5
ydiU,550,2041,1.8917726586206973,1491,Upregulated,100,5
ydiE,1,74,6.20945336562895,73,Unchanged,100,5
aroH,2082,1991,-0.0644768475789144,-91,Unchanged,100,5
ppsR,933,1058,0.18139064126226692,125,Upregulated,100,5
ppsA,2893,4128,0.5128766474936545,1235,Upregulated,100,5
fadK,113,1821,4.010336244561651,1708,Upregulated,100,5
ydiT,12,102,3.0874628412503395,90,Unchanged,100,5
ydiS,118,1558,3.722836468699828,1440,Upregulated,100,5
ydiR,136,1197,3.1377445956931624,1061,Upregulated,100,5
ydiQ,54,838,3.955918931535883,784,Upregulated,100,5
ydiP,448,659,0.5567797329504476,211,Upregulated,100,5
ydiO,62,1285,4.373356333694366,1223,Upregulated,100,5
ydiF,35,1628,5.53960196732128,1593,Upregulated,100,5
aroD,969,1127,0.21791894475713997,158,Upregulated,100,5
ydiB,46,788,4.098489863399363,742,Upregulated,100,5
ydiN,33,1220,5.208271313091795,1187,Upregulated,100,5
ydiM,17,982,5.852116373064353,965,Upregulated,100,5
ydiL,13,279,4.423681593688095,266,Upregulated,100,5
ydiK,2717,2239,-0.2791600373693775,-478,Downregulated,100,5
ydiJ,20150,10845,-0.8937497857430559,-9305,Downregulated,100,5
menI,1683,865,-0.960263138805862,-818,Downregulated,100,5
ydiH,1107,400,-1.4685833170068274,-707,Downregulated,100,5
sufA,250,384,0.6191782160590692,134,Upregulated,100,5
sufB,1808,2407,0.4128414640593092,599,Upregulated,100,5
sufC,839,953,0.18380540347011853,114,Upregulated,100,5
sufD,1622,1911,0.23655395876018365,289,Upregulated,100,5
sufS,1259,1702,0.4349527539669462,443,Upregulated,100,5
sufE,296,350,0.24175774620337906,54,Unchanged,100,5
ldtE,3764,1416,-1.4104453626455393,-2348,Downregulated,100,5
lpp,50412,2420,-4.380688239045717,-47992,Downregulated,100,5
pykF,35641,6452,-2.465719472344591,-29189,Downregulated,100,5
fumD,568,150,-1.9209284290088013,-418,Downregulated,100,5
ydhY,1114,502,-1.1499899633892599,-612,Downregulated,100,5
ydhV,3625,2378,-0.6082322800440033,-1247,Downregulated,100,5
ydhW,684,751,0.1348165826283738,67,Unchanged,100,5
ydhX,496,720,0.5376567859427995,224,Upregulated,100,5
ydhU,539,787,0.5460783627549809,248,Upregulated,100,5
ydhT,346,1073,1.6328061331197974,727,Upregulated,100,5
ydhS,1414,1831,0.37284967098793814,417,Upregulated,100,5
ydhR,3473,845,-2.039159164212545,-2628,Downregulated,100,5
ydhQ,7311,2816,-1.3764214178071996,-4495,Downregulated,100,5
mdtK,1116,2488,1.1566494583014149,1372,Upregulated,100,5
ribC,4026,1281,-1.6520766965796931,-2745,Downregulated,100,5
cfa,31218,7370,-2.0826415887154166,-23848,Downregulated,100,5
ydhC,342,1701,2.314314910777487,1359,Upregulated,100,5
ydhB,575,1302,1.179095587333898,727,Upregulated,100,5
purR,3336,1999,-0.7388408167000359,-1337,Downregulated,100,5
ydhP,328,1712,2.383914981783063,1384,Upregulated,100,5
sodB,19516,8797,-1.1495738712222052,-10719,Downregulated,100,5
mepH,795,937,0.23709418748746908,142,Upregulated,100,5
grxD,2100,614,-1.7740787671833054,-1486,Downregulated,100,5
lhr,3450,10768,1.6420820480574232,7318,Upregulated,100,5
rnt,733,1343,0.8735742012936304,610,Upregulated,100,5
gloA,2760,1116,-1.3063312398363438,-1644,Downregulated,100,5
nemA,1073,1992,0.8925675713115591,919,Upregulated,100,5
nemR,260,775,1.5756846871331454,515,Upregulated,100,5
ydhL,172,224,0.38109016735550627,52,Unchanged,100,5
ydhF,1465,1609,0.135263661413836,144,Upregulated,100,5
sodC,1438,758,-0.923793922268206,-680,Downregulated,100,5
ydhK,254,2985,3.5548305293800015,2731,Upregulated,100,5
ydhJ,151,984,2.704109766014161,833,Upregulated,100,5
ydhI,59,160,1.439285045525521,101,Upregulated,100,5
slyA,3696,895,-2.046005169264439,-2801,Downregulated,100,5
slyB,15455,5913,-1.3861114719809438,-9542,Downregulated,100,5
anmK,1482,1821,0.2971854746710044,339,Upregulated,100,5
mliC,375,250,-0.5849625007211563,-125,Downregulated,100,5
pdxH,3123,1131,-1.4653336400307528,-1992,Downregulated,100,5
tyrS,12363,4420,-1.4839105947228617,-7943,Downregulated,100,5
pdxY,2549,1275,-0.9994341262759816,-1274,Downregulated,100,5
gstA,4497,1407,-1.676340555432483,-3090,Downregulated,100,5
dtpA,22029,2339,-3.2354402390036,-19690,Downregulated,100,5
nth,208,562,1.433986602079834,354,Upregulated,100,5
rsxE,257,834,1.6982790242507855,577,Upregulated,100,5
rsxG,225,714,1.6659990728120626,489,Upregulated,100,5
rsxD,396,1312,1.728195384538474,916,Upregulated,100,5
rsxC,1148,3059,1.4139374648825147,1911,Upregulated,100,5
rsxB,313,709,1.1796229703068979,396,Upregulated,100,5
rsxA,399,709,0.8293968810171704,310,Upregulated,100,5
ydgK,557,513,-0.1187185017329777,-44,Unchanged,100,5
cnu,105,66,-0.6698513983076693,-39,Unchanged,100,5
ydgJ,2365,1709,-0.4686877865506181,-656,Downregulated,100,5
add,2223,1743,-0.35093537890130505,-480,Downregulated,100,5
malY,1567,1316,-0.25184569073733876,-251,Downregulated,100,5
malX,318,1971,2.6318291057591305,1653,Upregulated,100,5
malI,281,1324,2.2362610865862917,1043,Upregulated,100,5
hdhA,7599,1287,-2.5617975242129556,-6312,Downregulated,100,5
uidR,854,705,-0.27661281233433443,-149,Downregulated,100,5
uidA,84,2028,4.59352451422458,1944,Upregulated,100,5
uidB,26,1201,5.529580717564542,1175,Upregulated,100,5
uidC,24,903,5.233619676759702,879,Upregulated,100,5
ydgA,7832,2741,-1.51467843677792,-5091,Downregulated,100,5
manA,6596,2470,-1.4170803569654271,-4126,Downregulated,100,5
fumA,1055,1934,0.8743447958822937,879,Upregulated,100,5
fumC,435,1574,1.8553482347713957,1139,Upregulated,100,5
tus,407,953,1.2274474196436949,546,Upregulated,100,5
rstB,1227,1378,0.16744063904138629,151,Upregulated,100,5
rstA,1658,1034,-0.6812078211808157,-624,Downregulated,100,5
ydgC,82,176,1.1018796140192137,94,Unchanged,100,5
folM,333,554,0.7343637989779263,221,Upregulated,100,5
ydgI,437,1565,1.8404574723193823,1128,Upregulated,100,5
ydgH,4232,1815,-1.2213700792309126,-2417,Downregulated,100,5
pntA,20019,7852,-1.3502378317680022,-12167,Downregulated,100,5
pntB,18260,6722,-1.4417243175635825,-11538,Downregulated,100,5
tqsA,398,1120,1.4926583964013178,722,Upregulated,100,5
mdtJ,32,278,3.1189410727235076,246,Upregulated,100,5
mdtI,18,183,3.34577483684173,165,Upregulated,100,5
ydgD,569,738,0.3751921637538141,169,Upregulated,100,5
asr,77,145,0.9131225493200331,68,Unchanged,100,5
ynfM,783,1435,0.8739665242720095,652,Upregulated,100,5
ynfL,308,1055,1.776240742899646,747,Upregulated,100,5
mlc,2569,2592,0.012858827983807924,23,Unchanged,100,5
ynfK,4051,2020,-1.0039227920472795,-2031,Downregulated,100,5
clcB,272,1077,1.985339693293868,805,Upregulated,100,5
dmsD,1985,595,-1.7381774338350142,-1390,Downregulated,100,5
ynfH,6173,964,-2.6788667397930284,-5209,Downregulated,100,5
ynfG,2804,429,-2.708436796511078,-2375,Downregulated,100,5
ynfF,19327,2400,-3.0095114041497926,-16927,Downregulated,100,5
ynfE,6240,2094,-1.5752845868188023,-4146,Downregulated,100,5
ynfD,417,167,-1.3201992809706113,-250,Downregulated,100,5
ynfC,511,625,0.2905328986118282,114,Upregulated,100,5
speG,2243,577,-1.9587863964407897,-1666,Downregulated,100,5
ynfB,1402,389,-1.8496442890244311,-1013,Downregulated,100,5
ynfA,174,244,0.487793841714158,70,Unchanged,100,5
rspA,134,1014,2.919752746545568,880,Upregulated,100,5
rspB,87,709,3.026698321390788,622,Upregulated,100,5
intQ,67,604,3.1723155488673065,537,Upregulated,100,5
insD7,6,1627,8.083036034951371,1621,Upregulated,100,5
ydfE,36,584,4.0198995574377046,548,Upregulated,100,5
ydfD,1,23,4.523561956057013,22,Unchanged,100,5
dicB,2,4,1.0,2,Unchanged,100,5
dicF,1,1,0.0,0,Unchanged,100,5
ydfC,5,56,3.4854268271702415,51,Unchanged,100,5
ydfB,1,7,2.807354922057604,6,Unchanged,100,5
ydfA,3,13,2.1154772174199357,10,Unchanged,100,5
dicA,1209,278,-2.120657456525616,-931,Downregulated,100,5
dicC,5,42,3.070389327891398,37,Unchanged,100,5
ydfX,8,104,3.700439718141092,96,Unchanged,100,5
ydfW,4,18,2.169925001442312,14,Unchanged,100,5
flxA,112,141,0.3321964303411894,29,Unchanged,100,5
ydfV,9,99,3.4594316186372973,90,Unchanged,100,5
relB,516,287,-0.8463203287475664,-229,Downregulated,100,5
relE,685,437,-0.6484707083472907,-248,Downregulated,100,5
hokD,39,29,-0.42742122373467617,-10,Unchanged,100,5
rem,29,98,1.756728848987636,69,Unchanged,100,5
ydfU,26,876,5.074347341460081,850,Upregulated,100,5
ydfT,65,486,2.9024446905773265,421,Upregulated,100,5
cspF,17,66,1.956931278108114,49,Unchanged,100,5
cspB,10,26,1.3785116232537298,16,Unchanged,100,5
essQ,1,29,4.857980995127572,28,Unchanged,100,5
ydfR,10,105,3.3923174227787602,95,Unchanged,100,5
rrrQ,11,372,5.079727192470735,361,Upregulated,100,5
rzpQ,14,292,4.382469636822413,278,Upregulated,100,5
cspI,3,22,2.8744691179161412,19,Unchanged,100,5
ynfN,1,10,3.321928094887362,9,Unchanged,100,5
gnsB,61,6,-3.34577483684173,-55,Unchanged,100,5
ydfO,32,10,-1.6780719051126376,-22,Unchanged,100,5
nohA,28,429,3.9374789154419414,401,Upregulated,100,5
stfQ,28,677,4.595657101517393,649,Upregulated,100,5
tfaQ,19,372,4.291231297664446,353,Upregulated,100,5
pinQ,37,337,3.1871514155529086,300,Upregulated,100,5
ydfK,9,10,0.15200309344505006,1,Unchanged,100,5
ydfI,132,1074,3.024384158626959,942,Upregulated,100,5
ydfZ,11569,474,-4.609233296964281,-11095,Downregulated,100,5
ydfH,1623,1352,-0.26356784826578716,-271,Downregulated,100,5
ydfG,6165,2726,-1.1773153324849919,-3439,Downregulated,100,5
dcp,6944,3189,-1.1226628501922185,-3755,Downregulated,100,5
ydeJ,316,316,0.0,0,Unchanged,100,5
ydeI,995,248,-2.004356405044136,-747,Downregulated,100,5
dgcZ,1305,637,-1.0346845292009466,-668,Downregulated,100,5
ydeE,258,884,1.7766753039681773,626,Upregulated,100,5
eamA,480,823,0.7778580248131072,343,Upregulated,100,5
marB,117,47,-1.3157758679057672,-70,Unchanged,100,5
marA,345,273,-0.337695410745679,-72,Unchanged,100,5
marR,345,380,0.13940305666541644,35,Unchanged,100,5
marC,628,766,0.2865798330333302,138,Upregulated,100,5
ydeA,837,1149,0.4570792700957695,312,Upregulated,100,5
yneK,41,390,3.249778309131527,349,Upregulated,100,5
yneJ,493,967,0.9719282430989297,474,Upregulated,100,5
sad,844,1877,1.153113746123689,1033,Upregulated,100,5
glsB,823,1337,0.7000351296717271,514,Upregulated,100,5
yneG,117,276,1.2381597371947646,159,Upregulated,100,5
dgcF,216,788,1.8671643172929078,572,Upregulated,100,5
uxaB,245,1471,2.5859435922522596,1226,Upregulated,100,5
yneE,302,639,1.0812673816219154,337,Upregulated,100,5
tam,685,640,-0.09803208296052676,-45,Unchanged,100,5
lsrG,37,132,1.8349407537295037,95,Unchanged,100,5
lsrF,253,728,1.524801065504386,475,Upregulated,100,5
lsrB,137,781,2.5111466551814527,644,Upregulated,100,5
lsrD,104,785,2.916109125637897,681,Upregulated,100,5
lsrC,109,969,3.152168530638155,860,Upregulated,100,5
lsrA,213,1472,2.7888523358311748,1259,Upregulated,100,5
lsrR,384,799,1.0570891922068204,415,Upregulated,100,5
lsrK,456,1455,1.6739134236309046,999,Upregulated,100,5
hipB,69,125,0.8572598278839181,56,Unchanged,100,5
hipA,877,1411,0.686069240152531,534,Upregulated,100,5
yneL,4,35,3.1292830169449664,31,Unchanged,100,5
ydeT,116,866,2.9002422195991526,750,Upregulated,100,5
ydeS,20,314,3.9726926540042644,294,Upregulated,100,5
ydeR,21,273,3.700439718141092,252,Upregulated,100,5
ydeQ,29,471,4.021602254485211,442,Upregulated,100,5
ydeP,375,2104,2.488172203909059,1729,Upregulated,100,5
safA,2,8,2.0,6,Unchanged,100,5
ydeO,19,215,3.500265336145875,196,Upregulated,100,5
ydeN,521,983,0.9159080440620724,462,Upregulated,100,5
ydeM,76,431,2.503616545645513,355,Upregulated,100,5
yddA,15,920,5.938599455335857,905,Upregulated,100,5
yddB,139,1547,3.4763164087255283,1408,Upregulated,100,5
pqqL,310,2170,2.807354922057604,1860,Upregulated,100,5
gadB,196014,1537,-6.994695725052132,-194477,Downregulated,100,5
gadC,146286,1329,-6.782306791089309,-144957,Downregulated,100,5
digH,2243,1294,-0.7935920030937648,-949,Downregulated,100,5
dosC,125,902,2.851199338593294,777,Upregulated,100,5
dosP,196,2354,3.586188760923236,2158,Upregulated,100,5
ddpX,9,439,5.608152128093046,430,Upregulated,100,5
ddpA,124,1410,3.5072831368992805,1286,Upregulated,100,5
ddpB,49,965,4.299675288040234,916,Upregulated,100,5
ddpC,104,842,3.017236704925304,738,Upregulated,100,5
ddpD,130,1089,3.0664204256884524,959,Upregulated,100,5
ddpF,117,907,2.954594020945118,790,Upregulated,100,5
osmC,15380,3259,-2.238554246110625,-12121,Downregulated,100,5
bdm,228,119,-0.9380722508567982,-109,Downregulated,100,5
sra,384,41,-3.2274104961030727,-343,Downregulated,100,5
maeA,13004,5143,-1.3382734023378988,-7861,Downregulated,100,5
adhP,787,1269,0.6892565283336195,482,Upregulated,100,5
yddM,248,319,0.36321630337799427,71,Unchanged,100,5
fdnI,220,621,1.4970897446958218,401,Upregulated,100,5
fdnH,172,1049,2.6085342078751697,877,Upregulated,100,5
fdnG,992,4205,2.0836937747556314,3213,Upregulated,100,5
yddG,606,731,0.27055361247948656,125,Upregulated,100,5
yddL,1,73,6.189824558880018,72,Unchanged,100,5
yddK,2,67,5.066089190457772,65,Unchanged,100,5
yddJ,2,38,4.247927513443585,36,Unchanged,100,5
narU,284,1498,2.399074788954069,1214,Upregulated,100,5
narZ,1449,5706,1.9774221520247903,4257,Upregulated,100,5
narY,439,1852,2.076791253724878,1413,Upregulated,100,5
narW,162,869,2.4233623639297757,707,Upregulated,100,5
narV,184,848,2.204358498506186,664,Upregulated,100,5
yddE,1129,1750,0.6323094359466903,621,Upregulated,100,5
nhoA,87,1204,3.7906761809109737,1117,Upregulated,100,5
yddH,151,650,2.105891168590738,499,Upregulated,100,5
pptA,161,72,-1.1609918766723046,-89,Unchanged,100,5
ydcC,27,882,5.029747343394052,855,Upregulated,100,5
yncI,103,489,2.247190127769015,386,Upregulated,100,5
ydcD,47,26,-0.8541491335365452,-21,Unchanged,100,5
rhsE,164,2170,3.725927322713758,2006,Upregulated,100,5
yncH,3,2,-0.5849625007211563,-1,Unchanged,100,5
yncG,247,715,1.533432200081074,468,Upregulated,100,5
ansP,470,2201,2.2274264833265573,1731,Upregulated,100,5
yncE,157,1340,3.093396536453508,1183,Upregulated,100,5
yncD,225,2948,3.7117396178780324,2723,Upregulated,100,5
mcbR,117,563,2.266626392496825,446,Upregulated,100,5
curA,1107,1406,0.34494137229098315,299,Upregulated,100,5
mnaT,1256,998,-0.3317247435543665,-258,Downregulated,100,5
ydcZ,302,369,0.28907226673531705,67,Unchanged,100,5
ydcY,1480,368,-2.0078195044592992,-1112,Downregulated,100,5
ortT,8,23,1.5235619560570128,15,Unchanged,100,5
patD,401,1851,2.2066307534156535,1450,Upregulated,100,5
ydcV,59,867,3.877245133859994,808,Upregulated,100,5
ydcU,128,1114,3.1215335173400316,986,Upregulated,100,5
ydcT,105,1204,3.5193741590935796,1099,Upregulated,100,5
ydcS,238,1403,2.5594815303119556,1165,Upregulated,100,5
ydcR,829,1904,1.199589471812193,1075,Upregulated,100,5
hicB,319,255,-0.32305917690601155,-64,Unchanged,100,5
yncJ,27,107,1.9865794842376783,80,Unchanged,100,5
rlhA,2155,2709,0.330072524225554,554,Upregulated,100,5
sutR,158,492,1.638733757162137,334,Upregulated,100,5
ydcO,113,1274,3.4949705998411127,1161,Upregulated,100,5
insQ,2129,1555,-0.45326136943432904,-574,Downregulated,100,5
ydcL,407,456,0.16400502989849455,49,Unchanged,100,5
tehB,1310,581,-1.1729567430202839,-729,Downregulated,100,5
tehA,539,1460,1.4376111910148741,921,Upregulated,100,5
ydcK,465,938,1.0123572065199826,473,Upregulated,100,5
rimL,682,610,-0.16096249657392386,-72,Unchanged,100,5
ydcH,605,135,-2.163975735111126,-470,Downregulated,100,5
opgD,2569,1982,-0.37424992771432875,-587,Downregulated,100,5
ydcJ,377,1726,2.194796035910291,1349,Upregulated,100,5
ydcI,125,943,2.9153296760130094,818,Upregulated,100,5
trg,288,1891,2.715008646507449,1603,Upregulated,100,5
mokB,21,28,0.41503749927884376,7,Unchanged,100,5
ydcA,97,42,-1.2075954194083673,-55,Unchanged,100,5
cybB,725,607,-0.25628447864661474,-118,Downregulated,100,5
aldA,664,2236,1.7516650414962653,1572,Upregulated,100,5
ydcF,3467,1345,-1.3660816637588469,-2122,Downregulated,100,5
hrpA,5991,8892,0.5697111148618612,2901,Upregulated,100,5
azoR,730,684,-0.09390013888148166,-46,Unchanged,100,5
ynbD,320,1442,2.17192735435346,1122,Upregulated,100,5
ynbC,313,2018,2.6886916121737388,1705,Upregulated,100,5
ynbB,10,790,6.303780748177103,780,Upregulated,100,5
ynbA,9,490,5.766712937560258,481,Upregulated,100,5
ydbD,127,1902,3.9046168440883977,1775,Upregulated,100,5
pdxI,624,1354,1.1176098047127483,730,Upregulated,100,5
insI2,24,14,-0.777607578663552,-10,Unchanged,100,5
insC2,441,166,-1.4095954142105958,-275,Downregulated,100,5
insD2,189,1633,3.1110666513406224,1444,Upregulated,100,5
paaY,519,990,0.9316939866090912,471,Upregulated,100,5
paaX,1037,1845,0.8312049221345328,808,Upregulated,100,5
paaK,236,2047,3.116652337661569,1811,Upregulated,100,5
paaJ,211,2121,3.3294297168233697,1910,Upregulated,100,5
paaI,44,434,3.302119613807182,390,Upregulated,100,5
paaH,179,2266,3.6621163685562594,2087,Upregulated,100,5
paaG,39,1114,4.836131298477784,1075,Upregulated,100,5
paaF,43,1170,4.766028059768669,1127,Upregulated,100,5
paaE,92,1689,4.198391656744373,1597,Upregulated,100,5
paaD,23,592,4.685891409571937,569,Upregulated,100,5
paaC,12,1118,6.541741972122034,1106,Upregulated,100,5
paaB,4,325,6.344295907915817,321,Upregulated,100,5
paaA,8,1296,7.339850002884624,1288,Upregulated,100,5
paaZ,61,3063,5.649992314036071,3002,Upregulated,100,5
tynA,272,3119,3.5194049961238125,2847,Upregulated,100,5
feaB,433,2687,2.633557391286441,2254,Upregulated,100,5
feaR,78,1040,3.736965594166206,962,Upregulated,100,5
ydbL,94,278,1.5643522210458702,184,Upregulated,100,5
ynbE,8,31,1.9541963103868751,23,Unchanged,100,5
ydbH,2187,4757,1.1210988049143613,2570,Upregulated,100,5
ldhA,1,3,1.584962500721156,2,Unchanged,100,5
hslJ,1511,696,-1.1183444493161008,-815,Downregulated,100,5
ydbK,6758,7839,0.21407327487737546,1081,Upregulated,100,5
ompN,37,1344,5.182864057149811,1307,Upregulated,100,5
uspF,2875,736,-1.965784284662087,-2139,Downregulated,100,5
ynaE,13,22,0.7589919004962051,9,Unchanged,100,5
pinR,38,636,4.06495544184077,598,Upregulated,100,5
tfaR,85,855,3.3303896736355583,770,Upregulated,100,5
stfR,294,6096,4.373974842656958,5802,Upregulated,100,5
insH5,215,367,0.7714434032537526,152,Upregulated,100,5
ynaA,158,1057,2.74197891320558,899,Upregulated,100,5
ydaY,19,410,4.43155258606186,391,Upregulated,100,5
ynaK,15,181,3.592955291474687,166,Upregulated,100,5
trkG,593,823,0.4728603258756221,230,Upregulated,100,5
rzpR,17,452,4.732716121164849,435,Upregulated,100,5
ydaW,51,575,3.4949928038602422,524,Upregulated,100,5
ydaV,38,1217,5.001185939270143,1179,Upregulated,100,5
ydaU,53,882,4.056714390994321,829,Upregulated,100,5
ydaT,21,424,4.335603031784439,403,Upregulated,100,5
ydaS,12,111,3.2094533656289497,99,Unchanged,100,5
racR,1145,466,-1.296945738330026,-679,Downregulated,100,5
ydaG,1,6,2.584962500721156,5,Unchanged,100,5
sieB,124,171,0.4636562044990228,47,Unchanged,100,5
kilR,1,27,4.754887502163468,26,Unchanged,100,5
racC,2,70,5.129283016944966,68,Unchanged,100,5
recE,127,3621,4.833487774704012,3494,Upregulated,100,5
recT,147,841,2.5162896454187798,694,Upregulated,100,5
ralR,2,28,3.807354922057604,26,Unchanged,100,5
rcbA,3,15,2.321928094887362,12,Unchanged,100,5
xisR,1,45,5.491853096329675,44,Unchanged,100,5
intR,85,1006,3.5650236536678253,921,Upregulated,100,5
ttcA,1511,1296,-0.2214379422802043,-215,Downregulated,100,5
dbpA,1226,1940,0.6620976733837085,714,Upregulated,100,5
zntB,1530,1780,0.2183455882737461,250,Upregulated,100,5
dgcM,564,1238,1.134244246815471,674,Upregulated,100,5
smrA,916,943,0.041910172578152605,27,Unchanged,100,5
abgR,190,914,2.266194746727122,724,Upregulated,100,5
abgA,55,1664,4.919080004616433,1609,Upregulated,100,5
abgB,104,1982,4.252301529045396,1878,Upregulated,100,5
abgT,116,1859,4.002330059791909,1743,Upregulated,100,5
ogt,310,656,1.0814275993438462,346,Upregulated,100,5
fnr,5164,3184,-0.6976486647635418,-1980,Downregulated,100,5
uspE,9296,3253,-1.5148392463633968,-6043,Downregulated,100,5
ynaJ,463,205,-1.1753882837547904,-258,Downregulated,100,5
insH4,2431,3950,0.7003027599230988,1519,Upregulated,100,5
ynaI,2268,1205,-0.9123874938249048,-1063,Downregulated,100,5
mppA,1034,2278,1.1395315613931771,1244,Upregulated,100,5
pgrR,531,962,0.8573250329658884,431,Upregulated,100,5
ycjY,243,995,2.03374021182523,752,Upregulated,100,5
mpaA,1099,1275,0.2143058607969892,176,Upregulated,100,5
ycjG,965,1995,1.0477878989542653,1030,Upregulated,100,5
tpx,5110,3004,-0.7664384783107119,-2106,Downregulated,100,5
tyrR,3765,4109,0.1261374656083659,344,Upregulated,100,5
ycjF,1053,2524,1.261206473956832,1471,Upregulated,100,5
ycjX,1446,2784,0.9450916588976105,1338,Upregulated,100,5
ycjW,963,1342,0.47877696835672423,379,Upregulated,100,5
ompG,27,1412,5.708636871107712,1385,Upregulated,100,5
ycjU,4,1343,8.391243589427443,1339,Upregulated,100,5
ycjT,176,5304,4.9134334414752905,5128,Upregulated,100,5
ycjS,120,2054,4.097329870709677,1934,Upregulated,100,5
ycjR,60,973,4.019405399172593,913,Upregulated,100,5
ycjQ,103,2082,4.337253826116199,1979,Upregulated,100,5
ycjP,47,1764,5.230045993879883,1717,Upregulated,100,5
ycjO,38,1420,5.223747700948459,1382,Upregulated,100,5
ycjN,58,2498,5.4285767664803855,2440,Upregulated,100,5
ycjM,92,2275,4.6280888739164086,2183,Upregulated,100,5
pspE,2218,2399,0.11317379213172468,181,Upregulated,100,5
pspD,430,785,0.868355994189529,355,Upregulated,100,5
pspC,2288,2807,0.29494201173413503,519,Upregulated,100,5
pspB,792,867,0.13053156314222542,75,Unchanged,100,5
pspA,15001,18263,0.2838650941409044,3262,Upregulated,100,5
pspF,596,2843,2.254029863215366,2247,Upregulated,100,5
puuE,93,3444,5.210710616288813,3351,Upregulated,100,5
puuB,76,2784,5.195015982405143,2708,Upregulated,100,5
puuC,171,3570,4.383855844030564,3399,Upregulated,100,5
puuR,311,849,1.448849973422436,538,Upregulated,100,5
puuD,89,1508,4.082687282302267,1419,Upregulated,100,5
puuA,149,2326,3.964466861011057,2177,Upregulated,100,5
puuP,70,2208,4.979241439833203,2138,Upregulated,100,5
ymjA,251,188,-0.41695470227313464,-63,Unchanged,100,5
sapA,2278,3838,0.7525869644872685,1560,Upregulated,100,5
sapB,839,1898,1.177737276581286,1059,Upregulated,100,5
sapC,546,1818,1.7353793432742548,1272,Upregulated,100,5
sapD,1390,2021,0.5399844387688656,631,Upregulated,100,5
sapF,661,1193,0.8518718661875364,532,Upregulated,100,5
ycjD,76,363,2.255898224552165,287,Upregulated,100,5
fabI,17639,4454,-1.9855953099056673,-13185,Downregulated,100,5
yciW,207,2074,3.3247132213139006,1867,Upregulated,100,5
rnb,12315,5798,-1.0867893893249263,-6517,Downregulated,100,5
pdeR,1106,2600,1.23316023768111,1494,Upregulated,100,5
yciT,1665,1086,-0.6164980741542629,-579,Downregulated,100,5
osmB,2245,259,-3.1156914419419555,-1986,Downregulated,100,5
yciH,444,235,-0.9178989197851062,-209,Downregulated,100,5
pyrF,3520,1514,-1.217210223538928,-2006,Downregulated,100,5
lapB,2581,3383,0.3903730357000183,802,Upregulated,100,5
lapA,1009,617,-0.7095837799569394,-392,Downregulated,100,5
pgpB,770,1196,0.6352870386158413,426,Upregulated,100,5
ribA,1494,1027,-0.5407439664710421,-467,Downregulated,100,5
acnA,3775,7988,1.081357688344169,4213,Upregulated,100,5
cysB,1645,1663,0.01570058466466533,18,Unchanged,100,5
topA,17377,7770,-1.1611925301497397,-9607,Downregulated,100,5
yciN,702,230,-1.6098371693601854,-472,Downregulated,100,5
sohB,3009,2016,-0.5777884678334203,-993,Downregulated,100,5
yciK,1581,1162,-0.44422729895384194,-419,Downregulated,100,5
btuR,759,692,-0.13332784777874168,-67,Unchanged,100,5
rluB,1853,1966,0.08540044031331483,113,Upregulated,100,5
yciQ,402,2066,2.361572847686131,1664,Upregulated,100,5
yciO,1248,972,-0.36058971525646744,-276,Downregulated,100,5
yciV,1408,1390,-0.01856245102642752,-18,Unchanged,100,5
trpL,1,1,0.0,0,Unchanged,100,5
trpE,447,3005,2.74901825441523,2558,Upregulated,100,5
trpD,486,2912,2.5829821365929155,2426,Upregulated,100,5
trpC,695,2552,1.8765434461539996,1857,Upregulated,100,5
trpB,1220,2652,1.1201996276623392,1432,Upregulated,100,5
trpA,961,1512,0.6538498034473221,551,Upregulated,100,5
yciG,49,48,-0.029747343394052068,-1,Unchanged,100,5
yciF,394,377,-0.06363110618771194,-17,Unchanged,100,5
yciE,421,242,-0.7988131857918015,-179,Downregulated,100,5
ompW,148,832,2.4909863525121425,684,Upregulated,100,5
yciC,1653,1078,-0.6167295465398084,-575,Downregulated,100,5
yciB,1086,695,-0.6439392201934918,-391,Downregulated,100,5
yciA,606,359,-0.7553339496498995,-247,Downregulated,100,5
tonB,291,1147,1.9787743331075411,856,Upregulated,100,5
yciI,2138,267,-3.001350206032937,-1871,Downregulated,100,5
kch,1565,1134,-0.46474201687775174,-431,Downregulated,100,5
clsA,2828,2905,0.038756043482492404,77,Unchanged,100,5
yciU,565,324,-0.8022570544179252,-241,Downregulated,100,5
oppF,19319,10416,-0.8912190649685247,-8903,Downregulated,100,5
oppD,19341,11709,-0.724044520709988,-7632,Downregulated,100,5
oppC,14520,9481,-0.614930314102267,-5039,Downregulated,100,5
oppB,12135,8750,-0.47181918643144266,-3385,Downregulated,100,5
oppA,137677,44347,-1.6343791492722417,-93330,Downregulated,100,5
ychE,552,998,0.8543715485590915,446,Upregulated,100,5
adhE,309420,108494,-1.5119511912780845,-200926,Downregulated,100,5
tdk,659,403,-0.7094986264800844,-256,Downregulated,100,5
hns,19492,1620,-3.5888164094203283,-17872,Downregulated,100,5
galU,9254,2068,-2.161840913250361,-7186,Downregulated,100,5
rssB,1397,1426,0.029641961034424947,29,Unchanged,100,5
rssA,1569,1533,-0.03348765530932006,-36,Unchanged,100,5
ychJ,1019,599,-0.7665261433770281,-420,Downregulated,100,5
purU,5913,2151,-1.458882752341581,-3762,Downregulated,100,5
tpr,1,3,1.584962500721156,2,Unchanged,100,5
narI,4057,1259,-1.6881350194872562,-2798,Downregulated,100,5
narJ,3377,1367,-1.3047289364014167,-2010,Downregulated,100,5
narH,10284,3365,-1.6117231053359766,-6919,Downregulated,100,5
narG,32374,9038,-1.840760167980422,-23336,Downregulated,100,5
narK,2637,2262,-0.22129864187473972,-375,Downregulated,100,5
narX,1510,2975,0.9783411188702269,1465,Upregulated,100,5
narL,2927,1446,-1.0173551934576328,-1481,Downregulated,100,5
ychO,668,2328,1.8011710504342318,1660,Upregulated,100,5
ychN,1650,693,-1.2515387669959646,-957,Downregulated,100,5
chaC,782,994,0.3460772442549339,212,Upregulated,100,5
chaB,163,124,-0.39453184384420226,-39,Unchanged,100,5
chaA,752,1871,1.3150049915631468,1119,Upregulated,100,5
kdsA,5904,2643,-1.1595162964188261,-3261,Downregulated,100,5
ychA,1692,1370,-0.3045536752720607,-322,Downregulated,100,5
ychQ,97,337,1.796691938994731,240,Upregulated,100,5
prmC,630,1378,1.1291521543170124,748,Upregulated,100,5
prfA,1895,1827,-0.052721214430965446,-68,Unchanged,100,5
hemA,3806,2947,-0.36902850115002167,-859,Downregulated,100,5
lolB,2723,1389,-0.9711503830624035,-1334,Downregulated,100,5
ispE,3312,1785,-0.8917785985828631,-1527,Downregulated,100,5
prs,49915,6529,-2.9345394796826705,-43386,Downregulated,100,5
dauA,3378,3270,-0.04687869241594091,-108,Downregulated,100,5
ychH,1684,846,-0.9931625699464464,-838,Downregulated,100,5
pth,1487,722,-1.0423339051652476,-765,Downregulated,100,5
ychF,4157,2428,-0.7757743263686903,-1729,Downregulated,100,5
ycgV,1025,3310,1.6912073073017717,2285,Upregulated,100,5
dhaR,704,2359,1.7445280846021654,1655,Upregulated,100,5
dhaK,9338,4852,-0.9445340381216788,-4486,Downregulated,100,5
dhaL,4879,2234,-1.1269562974427123,-2645,Downregulated,100,5
dhaM,10626,4924,-1.109695950988613,-5702,Downregulated,100,5
treA,1261,2158,0.775126589159797,897,Upregulated,100,5
ycgY,23,223,3.2773379438632917,200,Upregulated,100,5
ymgE,116,156,0.4274212237346762,40,Unchanged,100,5
ycgR,59,867,3.877245133859994,808,Upregulated,100,5
emtA,1523,729,-1.0629252221603551,-794,Downregulated,100,5
ldcA,1018,1445,0.505331931312346,427,Upregulated,100,5
cvrA,1648,2647,0.6836419523121802,999,Upregulated,100,5
dadX,727,1607,1.1443426597554995,880,Upregulated,100,5
dadA,1547,2592,0.7445925214355891,1045,Upregulated,100,5
ycgB,1043,1553,0.5743186718675356,510,Upregulated,100,5
fadR,1069,995,-0.10349342228947936,-74,Unchanged,100,5
nhaB,2823,2726,-0.05044356664448337,-97,Unchanged,100,5
dsbB,1210,749,-0.6919694237032059,-461,Downregulated,100,5
umuC,330,1658,2.328906077249935,1328,Upregulated,100,5
umuD,259,292,0.1730162711934633,33,Unchanged,100,5
hlyE,500,536,0.10030490579568548,36,Unchanged,100,5
ycgN,568,458,-0.31054333140773804,-110,Downregulated,100,5
ycgM,1868,841,-1.1513167494545176,-1027,Downregulated,100,5
ycgL,1140,307,-1.8927232636819247,-833,Downregulated,100,5
pliG,753,330,-1.1901838404261125,-423,Downregulated,100,5
ycgJ,283,188,-0.5900693911542451,-95,Unchanged,100,5
minC,5471,1875,-1.5449139601119741,-3596,Downregulated,100,5
minD,10017,2326,-2.1065274973110535,-7691,Downregulated,100,5
minE,1105,154,-2.8430441135838924,-951,Downregulated,100,5
ymgG,2792,521,-2.421943663931144,-2271,Downregulated,100,5
ymgD,4200,527,-2.9945144609162706,-3673,Downregulated,100,5
pdeG,39,1012,4.697591355832062,973,Upregulated,100,5
ymgC,1,16,4.0,15,Unchanged,100,5
ariR,4,20,2.321928094887362,16,Unchanged,100,5
ymgA,14,70,2.321928094887362,56,Unchanged,100,5
ycgZ,12,93,2.9541963103868754,81,Unchanged,100,5
bluF,89,724,3.0241124561168076,635,Upregulated,100,5
bluR,790,774,-0.029519086920054966,-16,Unchanged,100,5
ycgX,43,95,1.14359085362885,52,Unchanged,100,5
iraM,20,12,-0.7369655941662062,-8,Unchanged,100,5
mcrA,310,312,0.00927781358801065,2,Unchanged,100,5
pinE,11,477,5.4384138373682145,466,Upregulated,100,5
stfE,6,238,5.309855262586788,232,Upregulated,100,5
tfaE,22,367,4.060204634205916,345,Upregulated,100,5
tfaP,20,100,2.321928094887362,80,Unchanged,100,5
ycfK,16,424,4.727920454563199,408,Upregulated,100,5
ymfQ,13,575,5.466978427690646,562,Upregulated,100,5
jayE,48,667,3.796580450463429,619,Upregulated,100,5
beeE,27,319,3.562525111601401,292,Upregulated,100,5
ymfR,2,55,4.78135971352466,53,Unchanged,100,5
ymfM,33,267,3.0163018123291008,234,Upregulated,100,5
ymfL,69,438,2.666262602823004,369,Upregulated,100,5
ymfT,10,37,1.8875252707415875,27,Unchanged,100,5
ymfK,716,489,-0.5501251223120228,-227,Downregulated,100,5
ymfJ,44,184,2.0641303374197157,140,Upregulated,100,5
ymfI,474,126,-1.9114633253983428,-348,Downregulated,100,5
xisE,23,91,1.9842326841416833,68,Unchanged,100,5
intE,215,887,2.0445974447116035,672,Upregulated,100,5
lit,1333,669,-0.9945986644475123,-664,Downregulated,100,5
ymfE,310,184,-0.7525624492172248,-126,Downregulated,100,5
ymfD,123,188,0.6120743463383976,65,Unchanged,100,5
icd,15230,10430,-0.5461767839675266,-4800,Downregulated,100,5
rluE,640,966,0.5939512839484107,326,Upregulated,100,5
nudJ,504,685,0.44268025434797265,181,Upregulated,100,5
mnmA,4975,3828,-0.37810569583234804,-1147,Downregulated,100,5
hflD,1842,1528,-0.2696285180555868,-314,Downregulated,100,5
purB,11656,5235,-1.1548113402463418,-6421,Downregulated,100,5
phoP,4041,1957,-1.0460685955566553,-2084,Downregulated,100,5
phoQ,3668,3544,-0.049615035040036094,-124,Downregulated,100,5
roxA,5382,3228,-0.737501812362637,-2154,Downregulated,100,5
pepT,7856,2870,-1.452744192751643,-4986,Downregulated,100,5
potA,1398,2112,0.5952454739830171,714,Upregulated,100,5
potB,497,1040,1.0652657714661684,543,Upregulated,100,5
potC,524,981,0.9046863246817884,457,Upregulated,100,5
potD,3991,2167,-0.8810511254175981,-1824,Downregulated,100,5
ymfA,25,331,3.726831217032493,306,Upregulated,100,5
ycfZ,16,513,5.002815015607054,497,Upregulated,100,5
cobB,2059,1628,-0.3388431303660072,-431,Downregulated,100,5
nagK,1770,1892,0.09616272836903554,122,Upregulated,100,5
lolE,1665,2640,0.6650157522871913,975,Upregulated,100,5
lolD,730,1559,1.0946525589304053,829,Upregulated,100,5
lolC,932,2228,1.2573473726857516,1296,Upregulated,100,5
ycfT,92,1180,3.6810091881921907,1088,Upregulated,100,5
mfd,9569,9917,0.0515355907211584,348,Upregulated,100,5
ldtC,113,1452,3.683646775580563,1339,Upregulated,100,5
bhsA,272,1060,1.962385708200222,788,Upregulated,100,5
comR,320,957,1.5804470195986633,637,Upregulated,100,5
ycfJ,2616,1481,-0.8207909002092348,-1135,Downregulated,100,5
ndh,344,2117,2.621540799305491,1773,Upregulated,100,5
ycfP,4143,1870,-1.147637550204208,-2273,Downregulated,100,5
nagZ,2421,2115,-0.19494541599162438,-306,Downregulated,100,5
thiK,1191,1306,0.13298148368231688,115,Upregulated,100,5
lpoB,6500,1840,-1.8207339518588042,-4660,Downregulated,100,5
ycfL,3788,660,-2.5208984012225693,-3128,Downregulated,100,5
hinT,2215,717,-1.6272616747404758,-1498,Downregulated,100,5
fhuE,179,3044,4.087936866239289,2865,Upregulated,100,5
ptsG,40519,13391,-1.5973348683281345,-27128,Downregulated,100,5
ycfH,1022,1136,0.15256763856706065,114,Upregulated,100,5
holB,1198,2101,0.8104482538842603,903,Upregulated,100,5
tmk,837,1353,0.6928623114261934,516,Upregulated,100,5
mltG,863,1745,1.0157945719180597,882,Upregulated,100,5
pabC,698,1272,0.865799729074703,574,Upregulated,100,5
fabF,19103,5762,-1.7291576561718742,-13341,Downregulated,100,5
acpP,10587,1385,-2.9343359545643297,-9202,Downregulated,100,5
fabG,18276,3711,-2.3000704415109223,-14565,Downregulated,100,5
fabD,11227,3515,-1.6753758780002472,-7712,Downregulated,100,5
fabH,5416,3740,-0.5341894687999977,-1676,Downregulated,100,5
plsX,4789,3040,-0.6556531119050533,-1749,Downregulated,100,5
rpmF,1189,227,-2.3889845124547406,-962,Downregulated,100,5
yceD,13505,3007,-2.1670968668223263,-10498,Downregulated,100,5
yceF,1923,1187,-0.6960388276979906,-736,Downregulated,100,5
rluC,2826,1957,-0.5301177097071355,-869,Downregulated,100,5
yceQ,20,211,3.399171093819823,191,Upregulated,100,5
rne,18565,14960,-0.31147513996710374,-3605,Downregulated,100,5
flgL,901,1871,1.0542105474272454,970,Upregulated,100,5
flgK,870,3114,1.8396816383429462,2244,Upregulated,100,5
flgJ,445,1679,1.91572498908327,1234,Upregulated,100,5
flgI,756,2196,1.538419914784126,1440,Upregulated,100,5
flgH,689,1203,0.8040607544717852,514,Upregulated,100,5
flgG,2137,1575,-0.4402350793851699,-562,Downregulated,100,5
flgF,2175,1749,-0.31448511170180043,-426,Downregulated,100,5
flgE,4559,2179,-1.065051212748858,-2380,Downregulated,100,5
flgD,2647,1170,-1.1778496650246317,-1477,Downregulated,100,5
flgC,1173,455,-1.36626456294245,-718,Downregulated,100,5
flgB,1528,545,-1.4873164083714598,-983,Downregulated,100,5
flgA,978,906,-0.11032341490599867,-72,Unchanged,100,5
flgM,296,325,0.13484254228686715,29,Unchanged,100,5
flgN,360,428,0.24961389007147222,68,Unchanged,100,5
murJ,456,2851,2.644362309773211,2395,Upregulated,100,5
yceM,1690,1981,0.2292056337199397,291,Upregulated,100,5
yceH,1595,1226,-0.37959744496145026,-369,Downregulated,100,5
rimJ,1083,1019,-0.08787919144251333,-64,Unchanged,100,5
mdtH,180,1996,3.471042909007586,1816,Upregulated,100,5
grxB,9658,3604,-1.422125452359117,-6054,Downregulated,100,5
yceB,2884,1121,-1.3632848864353957,-1763,Downregulated,100,5
pyrC,18327,1994,-3.2002333314032056,-16333,Downregulated,100,5
dinI,1134,222,-2.3527890585921227,-912,Downregulated,100,5
bssS,560,174,-1.6863395210962382,-386,Downregulated,100,5
solA,2910,2255,-0.36789171965290285,-655,Downregulated,100,5
yceO,4,5,0.32192809488736235,1,Unchanged,100,5
yceJ,23,574,4.6413449706186745,551,Upregulated,100,5
yceI,120,606,2.3362833878644325,486,Upregulated,100,5
trhO,392,1377,1.812603000019756,985,Upregulated,100,5
lpxL,1470,2069,0.49311749013628287,599,Upregulated,100,5
mdtG,254,1616,2.6695267959796287,1362,Upregulated,100,5
msyB,1443,353,-2.0313312112200177,-1090,Downregulated,100,5
yceK,152,139,-0.12898644072007803,-13,Unchanged,100,5
opgH,7957,6686,-0.25108124403954035,-1271,Downregulated,100,5
opgG,10984,4937,-1.1536969804060038,-6047,Downregulated,100,5
opgC,246,1016,2.046170181432926,770,Upregulated,100,5
clsC,1044,2250,1.1078032895345151,1206,Upregulated,100,5
ymdB,428,591,0.4655473337763855,163,Upregulated,100,5
ymdA,66,241,1.868495216871508,175,Upregulated,100,5
csgC,10,153,3.9354597478052895,143,Upregulated,100,5
csgA,338,470,0.4756375102828154,132,Upregulated,100,5
csgB,12,181,3.914883386362049,169,Upregulated,100,5
csgD,125,394,1.6562675347942892,269,Upregulated,100,5
csgE,18,157,3.1246957474493144,139,Upregulated,100,5
csgF,16,249,3.960001932068081,233,Upregulated,100,5
csgG,166,1174,2.8221772617631276,1008,Upregulated,100,5
ycdZ,596,750,0.33157826492108156,154,Upregulated,100,5
ycdY,1768,1062,-0.735334508587278,-706,Downregulated,100,5
ycdX,3393,1942,-0.8050182292917843,-1451,Downregulated,100,5
ghrA,3850,3169,-0.28083078608739237,-681,Downregulated,100,5
ycdU,19,889,5.548112095386185,870,Upregulated,100,5
ymdE,3,111,5.20945336562895,108,Upregulated,100,5
insE4,99,112,0.17799830197799443,13,Unchanged,100,5
insF4,24,606,4.658211482751795,582,Upregulated,100,5
dgcT,939,1005,0.09799843841251649,66,Unchanged,100,5
pgaA,2502,3834,0.6157685475023308,1332,Upregulated,100,5
pgaB,1215,2453,1.0135909200644588,1238,Upregulated,100,5
pgaC,838,1786,1.0917099314218714,948,Upregulated,100,5
pgaD,207,334,0.690217334974727,127,Upregulated,100,5
phoH,67,1740,4.6987824002783185,1673,Upregulated,100,5
efeB,142,2756,4.278613053199609,2614,Upregulated,100,5
efeO,80,2367,4.8869158958472525,2287,Upregulated,100,5
putP,897,3399,1.9219304716224106,2502,Upregulated,100,5
putA,510,10181,4.319238215713851,9671,Upregulated,100,5
rutR,426,1339,1.6522306250984724,913,Upregulated,100,5
rutA,14,2489,7.473995592923432,2475,Upregulated,100,5
rutB,19,1458,6.261847490883352,1439,Upregulated,100,5
rutC,8,493,5.945443836377912,485,Upregulated,100,5
rutD,27,1888,6.1277555471983725,1861,Upregulated,100,5
rutE,21,1117,5.733096047704555,1096,Upregulated,100,5
rutF,18,865,5.586631321081775,847,Upregulated,100,5
rutG,202,2970,3.8780357329363335,2768,Upregulated,100,5
wrbA,8996,2543,-1.8227521990877107,-6453,Downregulated,100,5
yccJ,2763,528,-2.3876257274540382,-2235,Downregulated,100,5
agp,2559,3336,0.38253914140521716,777,Upregulated,100,5
yccE,76,289,1.9269981690570934,213,Upregulated,100,5
cbpA,11798,2480,-2.2501302885543626,-9318,Downregulated,100,5
cbpM,2625,546,-2.265344566520995,-2079,Downregulated,100,5
torD,6279,2503,-1.3268765212885334,-3776,Downregulated,100,5
torA,54276,16650,-1.7047922245065805,-37626,Downregulated,100,5
torC,17968,4504,-1.9961511003203716,-13464,Downregulated,100,5
torR,540,1436,1.4110244367722204,896,Upregulated,100,5
torT,516,2121,2.039301650107301,1605,Upregulated,100,5
torS,859,6052,2.816681951078274,5193,Upregulated,100,5
yccM,233,1706,2.87221578666401,1473,Upregulated,100,5
ymcE,1,39,5.285402218862249,38,Unchanged,100,5
cspG,21,106,2.335603031784439,85,Unchanged,100,5
cspH,2,103,5.6865005271832185,101,Upregulated,100,5
insB4,177,924,2.3841434913330604,747,Upregulated,100,5
gfcA,51,291,2.5124500009367883,240,Upregulated,100,5
gfcB,26,667,4.681103233043493,641,Upregulated,100,5
gfcC,37,1072,4.856635824828823,1035,Upregulated,100,5
gfcD,132,3691,4.805401902887155,3559,Upregulated,100,5
gfcE,118,1885,3.9977057587941855,1767,Upregulated,100,5
etp,62,444,2.840219555963231,382,Upregulated,100,5
etk,886,4143,2.2252972164241887,3257,Upregulated,100,5
appA,2363,2466,0.06155317042899224,103,Upregulated,100,5
appB,3375,2654,-0.3467191314553622,-721,Downregulated,100,5
appC,4239,3418,-0.31057156937895625,-821,Downregulated,100,5
hyaF,2995,1647,-0.8627154479497933,-1348,Downregulated,100,5
hyaE,1064,691,-0.622740535112931,-373,Downregulated,100,5
hyaD,3274,1419,-1.2061797324136019,-1855,Downregulated,100,5
hyaC,2700,1413,-0.934197941604254,-1287,Downregulated,100,5
hyaB,5664,4366,-0.37550913509220635,-1298,Downregulated,100,5
hyaA,4584,2836,-0.6927495115173888,-1748,Downregulated,100,5
yccA,4779,2897,-0.7221490829760625,-1882,Downregulated,100,5
tusE,572,379,-0.5938172986072977,-193,Downregulated,100,5
yccX,84,235,1.4841995237862393,151,Upregulated,100,5
rlmI,2482,2324,-0.09489304672582782,-158,Downregulated,100,5
hspQ,1831,1012,-0.8554225011030269,-819,Downregulated,100,5
yccU,1754,893,-0.9739166673235102,-861,Downregulated,100,5
yccT,122,1112,3.1882037351606214,990,Upregulated,100,5
mgsA,2306,1255,-0.8777051488136377,-1051,Downregulated,100,5
helD,4108,5220,0.34561362513905175,1112,Upregulated,100,5
yccF,698,628,-0.15246247731802526,-70,Unchanged,100,5
yccS,1818,3991,1.1343980793171646,2173,Upregulated,100,5
sxy,419,915,1.1268214994720533,496,Upregulated,100,5
sulA,2741,985,-1.4765066984820365,-1756,Downregulated,100,5
ompA,206754,45709,-2.1773650792051917,-161045,Downregulated,100,5
matP,515,603,0.22758556982950404,88,Unchanged,100,5
ycbZ,1931,3540,0.8744011960197096,1609,Upregulated,100,5
fabA,2426,1815,-0.41861000223739725,-611,Downregulated,100,5
rmf,19615,7006,-1.485294442162395,-12609,Downregulated,100,5
pqiC,610,825,0.43558487668292956,215,Upregulated,100,5
pqiB,1559,2700,0.7923384792404085,1141,Upregulated,100,5
pqiA,542,1941,1.8404353613597921,1399,Upregulated,100,5
uup,3146,4285,0.4457765335841755,1139,Upregulated,100,5
rlmL,3709,4931,0.41084998499810926,1222,Upregulated,100,5
ycbX,752,1959,1.3813128305899496,1207,Upregulated,100,5
zapC,1360,927,-0.5529654075121709,-433,Downregulated,100,5
pyrD,20107,1467,-3.7767570689213334,-18640,Downregulated,100,5
ycbF,119,638,2.422594850456926,519,Upregulated,100,5
ycbV,62,596,3.2649722100752863,534,Upregulated,100,5
ycbU,35,429,3.615550820554579,394,Upregulated,100,5
elfG,161,1108,2.782825287934571,947,Upregulated,100,5
elfC,175,3411,4.2847679277810755,3236,Upregulated,100,5
elfD,15,502,5.064652958342253,487,Upregulated,100,5
elfA,176,372,1.0797271924707341,196,Upregulated,100,5
ssuE,12,733,5.932706887412656,721,Upregulated,100,5
ssuA,32,1397,5.448116305409463,1365,Upregulated,100,5
ssuD,83,1896,4.513703817551335,1813,Upregulated,100,5
ssuC,44,1243,4.820178962415188,1199,Upregulated,100,5
ssuB,152,1146,2.9144638153133196,994,Upregulated,100,5
pepN,6759,6278,-0.10650478537446889,-481,Downregulated,100,5
pncB,13139,4036,-1.702857397782121,-9103,Downregulated,100,5
asnS,17274,8045,-1.1024378686737821,-9229,Downregulated,100,5
ompF,11716,2336,-2.3263679189993494,-9380,Downregulated,100,5
aspC,14428,5594,-1.3669191693113787,-8834,Downregulated,100,5
gloC,4344,1939,-1.1637112996975691,-2405,Downregulated,100,5
mepK,4820,1575,-1.6136813178426828,-3245,Downregulated,100,5
ldtD,2920,3868,0.4056194257094617,948,Upregulated,100,5
mukB,11670,10981,-0.08779511969410014,-689,Downregulated,100,5
mukE,1015,1166,0.200088061127958,151,Upregulated,100,5
mukF,1656,2238,0.43450736347706875,582,Upregulated,100,5
cmoM,1597,1617,0.017955366062429045,20,Unchanged,100,5
elyC,359,876,1.2869470257781221,517,Upregulated,100,5
ycbJ,1854,1882,0.021625384103005865,28,Unchanged,100,5
kdsB,3176,1899,-0.7419710069934603,-1277,Downregulated,100,5
ycaR,149,117,-0.34880380087875706,-32,Unchanged,100,5
ycaQ,281,1606,2.5148298572963883,1325,Upregulated,100,5
lpxK,596,1728,1.5357189817013068,1132,Upregulated,100,5
msbA,2833,3545,0.32345502574878005,712,Upregulated,100,5
ycaI,267,2883,3.4326591898073526,2616,Upregulated,100,5
ihfB,4169,543,-2.9406772690040275,-3626,Downregulated,100,5
rpsA,111197,26814,-2.0520595102282333,-84383,Downregulated,100,5
cmk,2341,1341,-0.8038156972075388,-1000,Downregulated,100,5
ycaL,158,728,2.2040138920215933,570,Upregulated,100,5
aroA,7840,2877,-1.4462884332632837,-4963,Downregulated,100,5
serC,40422,7489,-2.432295710382022,-32933,Downregulated,100,5
ycaP,358,629,0.8131004296150328,271,Upregulated,100,5
ycaO,1024,2488,1.2807707701306026,1464,Upregulated,100,5
focA,3653,2876,-0.3450180779227205,-777,Downregulated,100,5
pflA,2310,1267,-0.8664763271626105,-1043,Downregulated,100,5
ycaK,94,385,2.0341257839046265,291,Upregulated,100,5
ycaN,239,852,1.8338428122450898,613,Upregulated,100,5
ycaM,49,1510,4.945622990097233,1461,Upregulated,100,5
ycaD,1249,1714,0.45659363250454255,465,Upregulated,100,5
ycaC,1162,602,-0.9487746766448268,-560,Downregulated,100,5
dmsC,4717,1628,-1.53476890126335,-3089,Downregulated,100,5
dmsB,2469,936,-1.3993464015593775,-1533,Downregulated,100,5
dmsA,11621,4690,-1.3090743917468417,-6931,Downregulated,100,5
serS,19894,6684,-1.5735497432391965,-13210,Downregulated,100,5
rarA,1869,2732,0.5476909145449325,863,Upregulated,100,5
lolA,1526,1013,-0.5911207880333923,-513,Downregulated,100,5
ftsK,12158,10309,-0.23800152960157073,-1849,Downregulated,100,5
lrp,6467,1136,-2.509133775543195,-5331,Downregulated,100,5
trxB,5474,2431,-1.1710455413362275,-3043,Downregulated,100,5
cydD,2062,4856,1.2357240888875736,2794,Upregulated,100,5
cydC,2670,4215,0.6586928892545283,1545,Upregulated,100,5
aat,858,1389,0.694997046481847,531,Upregulated,100,5
infA,2058,307,-2.744932421523789,-1751,Downregulated,100,5
clpA,29579,21566,-0.4558146645997842,-8013,Downregulated,100,5
clpS,455,516,0.18150452033719547,61,Unchanged,100,5
cspD,1176,315,-1.9004643264490857,-861,Downregulated,100,5
macB,1094,5070,2.212373009098146,3976,Upregulated,100,5
macA,728,2767,1.9263122884112582,2039,Upregulated,100,5
ybjX,13740,3962,-1.794081218815976,-9778,Downregulated,100,5
ybjD,921,3715,2.012089149334623,2794,Upregulated,100,5
aqpZ,356,1476,2.0517435750939983,1120,Upregulated,100,5
lysO,1426,1720,0.2704345831455723,294,Upregulated,100,5
hcp,293,3690,3.6546482465255106,3397,Upregulated,100,5
hcr,312,1329,2.090723170413926,1017,Upregulated,100,5
poxB,4689,3931,-0.2543839152967266,-758,Downregulated,100,5
ltaE,3682,2458,-0.5830047109772448,-1224,Downregulated,100,5
ybjT,2111,2893,0.45463974458244355,782,Upregulated,100,5
ybjS,1614,1890,0.22774565583065481,276,Upregulated,100,5
amiD,1618,2348,0.5372208006800746,730,Upregulated,100,5
ybjQ,562,618,0.13703670768344833,56,Unchanged,100,5
ybjP,2106,1071,-0.9755469562754611,-1035,Downregulated,100,5
artP,2060,2361,0.1967537041580618,301,Upregulated,100,5
artI,3090,2655,-0.21889497710022102,-435,Downregulated,100,5
artQ,1630,1697,0.05811460042422344,67,Unchanged,100,5
artM,1040,1367,0.3944297145776055,327,Upregulated,100,5
artJ,1695,3465,1.0315700790008697,1770,Upregulated,100,5
rlmC,472,1874,1.9892621882973456,1402,Upregulated,100,5
ybjO,201,559,1.4756527816642615,358,Upregulated,100,5
potI,121,1291,3.415410048032596,1170,Upregulated,100,5
potH,31,1317,5.408843319869639,1286,Upregulated,100,5
potG,98,1611,4.03903093459136,1513,Upregulated,100,5
potF,141,1450,3.362285832503503,1309,Upregulated,100,5
ybjN,1262,543,-1.2166878071781875,-719,Downregulated,100,5
rimK,1282,1613,0.3313501765369017,331,Upregulated,100,5
nfsA,1198,1319,0.1388166564627591,121,Upregulated,100,5
ybjC,343,322,-0.09114788805819528,-21,Unchanged,100,5
grxA,159,112,-0.5055280332267513,-47,Unchanged,100,5
ybjM,592,506,-0.22645979093463967,-86,Unchanged,100,5
ybjL,2238,4070,0.8628187581772154,1832,Upregulated,100,5
rcdA,210,735,1.8073549220576042,525,Upregulated,100,5
ybjJ,517,2100,2.02215314223855,1583,Upregulated,100,5
ybjI,819,1106,0.4334160285936985,287,Upregulated,100,5
ybjH,149,235,0.6573484261028382,86,Unchanged,100,5
mdfA,472,1748,1.8888464201387571,1276,Upregulated,100,5
ybjG,2358,1221,-0.9495005179923595,-1137,Downregulated,100,5
deoR,1256,1179,-0.09127274591186439,-77,Unchanged,100,5
dacC,4569,2970,-0.6214155115203204,-1599,Downregulated,100,5
gstB,3048,1360,-1.1642562513556203,-1688,Downregulated,100,5
yliI,463,2480,2.4212560220140014,2017,Upregulated,100,5
bssR,10383,6662,-0.6401960882122527,-3721,Downregulated,100,5
rimO,1654,2378,0.5237894805743811,724,Upregulated,100,5
dgcI,654,1152,0.8167781759442299,498,Upregulated,100,5
pdeI,1556,2375,0.6100854531194805,819,Upregulated,100,5
gsiD,251,1506,2.584962500721156,1255,Upregulated,100,5
gsiC,385,1878,2.2862667120715106,1493,Upregulated,100,5
gsiB,1239,3863,1.6405454900913297,2624,Upregulated,100,5
gsiA,2083,6300,1.5966889892339944,4217,Upregulated,100,5
iaaA,1443,4880,1.7578098479590505,3437,Upregulated,100,5
moeA,2189,3195,0.5455439766534106,1006,Upregulated,100,5
moeB,916,1774,0.9535865062041199,858,Upregulated,100,5
fsaA,155,869,2.4870879615401624,714,Upregulated,100,5
ybiY,30,1492,5.636141224646719,1462,Upregulated,100,5
ybiW,265,4667,4.138431202513582,4402,Upregulated,100,5
ybiV,444,1088,1.2930469749002333,644,Upregulated,100,5
ybiU,96,2480,4.6911619045530815,2384,Upregulated,100,5
ybiT,3661,5084,0.4737262567004134,1423,Upregulated,100,5
ldtB,3104,1894,-0.7126922267187425,-1210,Downregulated,100,5
ybiR,287,1990,2.7936457887553234,1703,Upregulated,100,5
mntR,583,1156,0.9875736093001823,573,Upregulated,100,5
yliL,2,188,6.554588851677638,186,Upregulated,100,5
opgE,265,2432,3.198078963993024,2167,Upregulated,100,5
ompX,48807,9662,-2.3366943190254443,-39145,Downregulated,100,5
rhtA,180,1640,3.187627003175771,1460,Upregulated,100,5
dps,14671,2135,-2.7806592359214415,-12536,Downregulated,100,5
glnH,9754,1919,-2.3456392608404877,-7835,Downregulated,100,5
glnP,3277,1272,-1.3652770022584044,-2005,Downregulated,100,5
glnQ,3497,1503,-1.2182727867813519,-1994,Downregulated,100,5
ybiO,672,4518,2.749151132614324,3846,Upregulated,100,5
rlmF,1442,1794,0.3151087256784386,352,Upregulated,100,5
mcbA,69,224,1.698830465279435,155,Upregulated,100,5
fiu,70,4128,5.881944238478288,4058,Upregulated,100,5
ybiX,67,1146,4.096302138299133,1079,Upregulated,100,5
ybiI,51,281,2.4620009782494305,230,Upregulated,100,5
ybiJ,100,250,1.3219280948873624,150,Upregulated,100,5
hcxB,9217,4083,-1.1746676831554574,-5134,Downregulated,100,5
ybiB,2844,2333,-0.2857351576352161,-511,Downregulated,100,5
dinG,1871,6136,1.7134889242621494,4265,Upregulated,100,5
ybiA,112,859,2.9391593990808595,747,Upregulated,100,5
rhlE,751,3454,2.2013832700146523,2703,Upregulated,100,5
cecR,562,1703,1.5994363994576164,1141,Upregulated,100,5
ybhG,1149,2752,1.2601016720559846,1603,Upregulated,100,5
ybhF,2044,5108,1.3213633287651025,3064,Upregulated,100,5
ybhS,629,2785,2.146545405348105,2156,Upregulated,100,5
ybhR,485,2499,2.365294249012214,2014,Upregulated,100,5
ybhQ,351,663,0.9175378398080271,312,Upregulated,100,5
ybhP,600,1332,1.1505596765753814,732,Upregulated,100,5
clsB,877,2672,1.607271260029319,1795,Upregulated,100,5
ybhN,286,1777,2.6353566292502886,1491,Upregulated,100,5
ybhM,64,618,3.2714630279043746,554,Upregulated,100,5
ybhL,3891,1918,-1.0205382599547248,-1973,Downregulated,100,5
moaE,1752,887,-0.9819967653001095,-865,Downregulated,100,5
moaD,260,212,-0.2944473584652553,-48,Unchanged,100,5
moaC,2860,1422,-1.0080936820463364,-1438,Downregulated,100,5
moaB,3256,1582,-1.0413510997934552,-1674,Downregulated,100,5
moaA,3302,2657,-0.31354189242275143,-645,Downregulated,100,5
ybhK,1102,1725,0.6464721379817361,623,Upregulated,100,5
uvrB,5067,7051,0.4766960517334962,1984,Upregulated,100,5
bioD,627,1115,0.8305063620056281,488,Upregulated,100,5
bioC,584,1616,1.4683869238717775,1032,Upregulated,100,5
bioF,1223,3169,1.373603255854847,1946,Upregulated,100,5
bioB,1832,3375,0.8814679987286117,1543,Upregulated,100,5
bioA,1022,4147,2.02067285096834,3125,Upregulated,100,5
ybhB,1312,862,-0.6060079455289856,-450,Downregulated,100,5
ybhC,4620,3395,-0.44448127717132574,-1225,Downregulated,100,5
ybhJ,126,4432,5.136462242549272,4306,Upregulated,100,5
ybhI,19,1969,6.6953198824579685,1950,Upregulated,100,5
ybhH,9,1233,7.098032082960526,1224,Upregulated,100,5
ybhD,21,919,5.4516036285102745,898,Upregulated,100,5
pgl,5304,2024,-1.3898714854182777,-3280,Downregulated,100,5
ybhA,1185,1124,-0.07624502356469538,-61,Unchanged,100,5
modC,548,2934,2.420621072712863,2386,Upregulated,100,5
modB,333,1743,2.387978487054423,1410,Upregulated,100,5
modA,403,3138,2.96099360844013,2735,Upregulated,100,5
acrZ,112,12,-3.222392421336448,-100,Downregulated,100,5
modE,525,1642,1.6450647992243197,1117,Upregulated,100,5
modF,666,3309,2.3128012092412766,2643,Upregulated,100,5
galE,2865,2524,-0.18282322866171827,-341,Downregulated,100,5
galT,2229,2268,0.025024023682476366,39,Unchanged,100,5
galK,3675,3084,-0.2529414846960549,-591,Downregulated,100,5
galM,9684,3637,-1.4128541535433197,-6047,Downregulated,100,5
gpmA,6870,3083,-1.1559752095982874,-3787,Downregulated,100,5
aroG,13069,6744,-0.9544723133417239,-6325,Downregulated,100,5
ybgS,686,346,-0.9874365385360876,-340,Downregulated,100,5
zitB,773,1333,0.7861364611641258,560,Upregulated,100,5
pnuC,10328,1578,-2.710391795293732,-8750,Downregulated,100,5
nadA,15773,2695,-2.5490999064830935,-13078,Downregulated,100,5
cpoB,8513,2280,-1.9006338060429238,-6233,Downregulated,100,5
pal,12885,2556,-2.3337327957999876,-10329,Downregulated,100,5
tolB,13827,4672,-1.5653759941777878,-9155,Downregulated,100,5
tolA,2665,2547,-0.06533657337234353,-118,Downregulated,100,5
tolR,476,489,0.03887289164429008,13,Unchanged,100,5
tolQ,1786,1210,-0.5617250329592661,-576,Downregulated,100,5
ybgC,891,449,-0.9887099867807749,-442,Downregulated,100,5
ybgE,1043,406,-1.3611875253345895,-637,Downregulated,100,5
cydB,10697,6818,-0.6497857413838689,-3879,Downregulated,100,5
cydA,15778,9944,-0.6660161411773403,-5834,Downregulated,100,5
mngB,695,3651,2.3932067858240145,2956,Upregulated,100,5
mngA,36,3044,6.4018276420612334,3008,Upregulated,100,5
mngR,443,965,1.1232222436004242,522,Upregulated,100,5
sucD,2502,2196,-0.1882037351606212,-306,Downregulated,100,5
sucC,3330,3138,-0.08567682499052688,-192,Downregulated,100,5
sucB,4106,3606,-0.18733423067626032,-500,Downregulated,100,5
sucA,5375,7546,0.4894473454459246,2171,Upregulated,100,5
sdhB,312,1019,1.7075361173035655,707,Upregulated,100,5
sdhA,571,3693,2.693230611842771,3122,Upregulated,100,5
sdhD,45,388,3.108059745857453,343,Upregulated,100,5
sdhC,57,509,3.1586318319109536,452,Upregulated,100,5
gltA,4843,10211,1.076151253402954,5368,Upregulated,100,5
ybgD,12,709,5.88467931651836,697,Upregulated,100,5
ybgQ,17,4222,7.956248022096816,4205,Upregulated,100,5
ybgP,16,969,5.920352855415081,953,Upregulated,100,5
ybgO,33,1253,5.246776579963407,1220,Upregulated,100,5
abrB,589,2139,1.8605969433345837,1550,Upregulated,100,5
nei,1068,1807,0.7586848591770456,739,Upregulated,100,5
pxpA,1773,2091,0.23800052569089059,318,Upregulated,100,5
pxpC,3778,3246,-0.2189597018403983,-532,Downregulated,100,5
pxpB,2126,1999,-0.0888631247864771,-127,Downregulated,100,5
ybgI,2940,2890,-0.024746662335685607,-50,Unchanged,100,5
dtpD,1059,3729,1.8160862077813047,2670,Upregulated,100,5
phr,887,2930,1.7238946550085463,2043,Upregulated,100,5
ybgA,438,770,0.8139275759810903,332,Upregulated,100,5
ybfD,63,563,3.1597111885803133,500,Upregulated,100,5
ybfL,66,1104,4.064130337419716,1038,Upregulated,100,5
ybfC,106,337,1.6686843266186593,231,Upregulated,100,5
ybfO,136,2421,4.153924522748597,2285,Upregulated,100,5
ybfB,20,18,-0.15200309344504995,-2,Unchanged,100,5
rhsC,1471,10618,2.8516428948689008,9147,Upregulated,100,5
ybfA,2277,251,-3.1813750221858506,-2026,Downregulated,100,5
kdpA,42,4335,6.689498855330437,4293,Upregulated,100,5
kdpB,220,6069,4.78588339175478,5849,Upregulated,100,5
kdpC,133,1235,3.2150128909708506,1102,Upregulated,100,5
kdpD,1830,8244,2.1715008563678513,6414,Upregulated,100,5
kdpE,187,1476,2.9805825461727595,1289,Upregulated,100,5
speF,70,4158,5.892391025913404,4088,Upregulated,100,5
potE,315,2476,2.9745875808269857,2161,Upregulated,100,5
ybfG,20,713,5.155830171556525,693,Upregulated,100,5
ybfP,47,438,3.220198207923536,391,Upregulated,100,5
pgm,13779,5872,-1.2305473160988876,-7907,Downregulated,100,5
seqA,2579,1436,-0.8447560239661627,-1143,Downregulated,100,5
ybfF,1322,1348,0.028098319674166743,26,Unchanged,100,5
ybfE,227,286,0.3333228494874745,59,Unchanged,100,5
fldA,3509,1495,-1.2309144633166993,-2014,Downregulated,100,5
fur,3036,1227,-1.3070365417525613,-1809,Downregulated,100,5
chiQ,33,320,3.277533975528909,287,Upregulated,100,5
chiP,92,2127,4.531042361903659,2035,Upregulated,100,5
glnS,4970,4363,-0.18792537807314874,-607,Downregulated,100,5
nagE,1753,3834,1.1290243409086127,2081,Upregulated,100,5
nagB,1465,985,-0.5727050349658716,-480,Downregulated,100,5
nagA,2314,2567,0.1496944314679285,253,Upregulated,100,5
nagC,2087,3113,0.5768749763093446,1026,Upregulated,100,5
umpH,2473,1850,-0.4187369689862633,-623,Downregulated,100,5
asnB,11711,4559,-1.3610749582311916,-7152,Downregulated,100,5
ubiF,1014,2940,1.5357585027203864,1926,Upregulated,100,5
miaB,5129,4111,-0.31918819941338006,-1018,Downregulated,100,5
ybeZ,4419,3751,-0.2364446680955357,-668,Downregulated,100,5
ybeY,1362,1208,-0.17310624868699223,-154,Downregulated,100,5
ybeX,5542,3226,-0.7806602723257742,-2316,Downregulated,100,5
lnt,1961,3240,0.724404277579838,1279,Upregulated,100,5
insH3,5086,3668,-0.471537823095052,-1418,Downregulated,100,5
gltI,2328,1803,-0.3686916614759422,-525,Downregulated,100,5
gltJ,234,934,1.9969140201262574,700,Upregulated,100,5
gltK,302,1044,1.7895012572448055,742,Upregulated,100,5
gltL,326,1234,1.9203985249183404,908,Upregulated,100,5
rihA,1101,1559,0.5018064591334157,458,Upregulated,100,5
hscC,143,2390,4.062923566089721,2247,Upregulated,100,5
djlC,182,1910,3.391562282724415,1728,Upregulated,100,5
ybeU,39,685,4.134557958985641,646,Upregulated,100,5
ybeT,1,392,8.614709844115207,391,Upregulated,100,5
djlB,51,1784,5.128474557948809,1733,Upregulated,100,5
ybeR,15,675,5.491853096329675,660,Upregulated,100,5
ybeQ,62,1100,4.149091498025147,1038,Upregulated,100,5
ybeL,2112,889,-1.2483545105286835,-1223,Downregulated,100,5
leuS,17258,8851,-0.9633529152638997,-8407,Downregulated,100,5
lptE,2392,1202,-0.9927804934869194,-1190,Downregulated,100,5
holA,1720,1713,-0.0058834135054613625,-7,Unchanged,100,5
nadD,594,764,0.3631097072349828,170,Upregulated,100,5
cobC,294,735,1.3219280948873624,441,Upregulated,100,5
rsfS,744,401,-0.8917003846531112,-343,Downregulated,100,5
rlmH,927,984,0.0860889767137092,57,Unchanged,100,5
mrdA,1735,3095,0.8350037466360037,1360,Upregulated,100,5
mrdB,1123,1828,0.7029081426574686,705,Upregulated,100,5
rlpA,3505,2300,-0.607780583066248,-1205,Downregulated,100,5
dacA,5294,2078,-1.3491625405911867,-3216,Downregulated,100,5
ybeD,867,346,-1.3252599555851103,-521,Downregulated,100,5
lipB,1228,1057,-0.2163351839874963,-171,Downregulated,100,5
ybeF,39,933,4.580331051989511,894,Upregulated,100,5
lipA,2513,2007,-0.32437005451803846,-506,Downregulated,100,5
tatE,377,151,-1.3200159739435855,-226,Downregulated,100,5
crcB,508,397,-0.355689489629208,-111,Downregulated,100,5
cspE,9436,734,-3.68432345039625,-8702,Downregulated,100,5
pagP,592,510,-0.2150999287700918,-82,Unchanged,100,5
dcuC,806,2157,1.4201744326324868,1351,Upregulated,100,5
dpiA,1051,838,-0.3267405202628268,-213,Downregulated,100,5
dpiB,1865,2775,0.5733121409822306,910,Upregulated,100,5
citC,6544,1529,-2.097584341580944,-5015,Downregulated,100,5
citD,3627,280,-3.6952780130253133,-3347,Downregulated,100,5
citE,17565,1522,-3.5286633126061884,-16043,Downregulated,100,5
citF,35674,3061,-3.5427980392116187,-32613,Downregulated,100,5
citX,8881,920,-3.2710163668036967,-7961,Downregulated,100,5
citG,2388,1148,-1.0566801945891173,-1240,Downregulated,100,5
citT,14439,2193,-2.718993112012435,-12246,Downregulated,100,5
rna,806,1711,1.085988015961446,905,Upregulated,100,5
rnk,886,704,-0.33173126991772117,-182,Downregulated,100,5
ybdR,1588,2099,0.40249125414919645,511,Upregulated,100,5
uspG,5319,1062,-2.324371270815691,-4257,Downregulated,100,5
ahpF,5126,6331,0.30459991693185695,1205,Upregulated,100,5
ahpC,18400,7356,-1.3227123814197999,-11044,Downregulated,100,5
dsbG,491,1101,1.1650195392496758,610,Upregulated,100,5
ybdO,29,625,4.429731384421878,596,Upregulated,100,5
ybdN,47,2228,5.566944665662394,2181,Upregulated,100,5
ybdM,134,1080,3.0107264065930583,946,Upregulated,100,5
ybdL,1558,2395,0.6203304225618733,837,Upregulated,100,5
hcxA,1912,3369,0.8172379051410089,1457,Upregulated,100,5
cstA,571,6499,3.508655097282057,5928,Upregulated,100,5
entH,42,745,4.148779192570764,703,Upregulated,100,5
entA,100,1547,3.951401291674311,1447,Upregulated,100,5
entB,95,2072,4.446952679355606,1977,Upregulated,100,5
entE,47,4299,6.515196543305664,4252,Upregulated,100,5
entC,21,3096,7.20387233336565,3075,Upregulated,100,5
fepB,66,2470,5.225901207113586,2404,Upregulated,100,5
entS,14,3182,7.828363198273443,3168,Upregulated,100,5
fepD,43,2669,5.955818835439868,2626,Upregulated,100,5
fepG,48,2789,5.860569718307156,2741,Upregulated,100,5
fepC,48,1976,5.363404730863522,1928,Upregulated,100,5
fepE,14,1776,6.987060944292502,1762,Upregulated,100,5
entF,399,9184,4.524661990453342,8785,Upregulated,100,5
fes,15,2305,7.263660439708182,2290,Upregulated,100,5
fepA,159,4194,4.721228190812237,4035,Upregulated,100,5
entD,21,678,5.012824040357583,657,Upregulated,100,5
insL2,1964,1840,-0.09408916337031785,-124,Downregulated,100,5
ybdK,648,1957,1.5945780377421792,1309,Upregulated,100,5
ybdJ,47,147,1.645083493158727,100,Unchanged,100,5
ybdF,259,368,0.506753668370459,109,Upregulated,100,5
nfsB,3393,1642,-1.047107302933172,-1751,Downregulated,100,5
ybdG,4126,2928,-0.49482826760244225,-1198,Downregulated,100,5
pheP,1564,2811,0.8458429410729909,1247,Upregulated,100,5
cusA,287,6000,4.3858398587075555,5713,Upregulated,100,5
cusB,79,1771,4.486567748574811,1692,Upregulated,100,5
cusF,13,279,4.423681593688095,266,Upregulated,100,5
cusC,25,2003,6.324090516037983,1978,Upregulated,100,5
cusR,556,1128,1.020610279675286,572,Upregulated,100,5
cusS,545,2203,2.015141360036594,1658,Upregulated,100,5
nfrB,321,4022,3.647267879183049,3701,Upregulated,100,5
nfrA,834,5608,2.7493670605659597,4774,Upregulated,100,5
ybcH,181,1260,2.7993621313040737,1079,Upregulated,100,5
envY,58,650,3.4863149127882447,592,Upregulated,100,5
ompT,109949,15187,-2.855925665843311,-94762,Downregulated,100,5
appY,1342,73,-4.200344397320166,-1269,Downregulated,100,5
tfaX,2,53,4.727920454563199,51,Unchanged,100,5
ybcY,27,384,3.8300749985576874,357,Upregulated,100,5
tfaD,18,478,4.7309418065384365,460,Upregulated,100,5
nohD,39,819,4.392317422778761,780,Upregulated,100,5
ybcW,157,55,-1.5132610353669675,-102,Downregulated,100,5
ybcV,12,13,0.11547721741993588,1,Unchanged,100,5
borD,4813,257,-4.227096158770994,-4556,Downregulated,100,5
rzpD,83,548,2.722992651613602,465,Upregulated,100,5
rrrD,51,414,3.0210616155278296,363,Upregulated,100,5
essD,7,45,2.6844981742720706,38,Unchanged,100,5
insH2,5183,3326,-0.6399992250974303,-1857,Downregulated,100,5
quuD,11,242,4.459431618637297,231,Upregulated,100,5
rusA,8,352,5.459431618637297,344,Upregulated,100,5
ybcO,4,226,5.820178962415188,222,Upregulated,100,5
ninE,1,27,4.754887502163468,26,Unchanged,100,5
ybcN,7,410,5.872125177447842,403,Upregulated,100,5
ybcM,646,288,-1.1654653532516126,-358,Downregulated,100,5
ybcL,132,378,1.5178483048626192,246,Upregulated,100,5
ybcK,25,446,4.15704371014558,421,Upregulated,100,5
emrE,116,87,-0.4150374992788438,-29,Unchanged,100,5
renD,1519,5201,1.775667168094117,3682,Upregulated,100,5
insF3,23,685,4.896398221790876,662,Upregulated,100,5
insE3,132,128,-0.044394119358453395,-4,Unchanged,100,5
exoD,4,276,6.108524456778169,272,Upregulated,100,5
intD,767,1675,1.1268626127295636,908,Upregulated,100,5
fimZ,18,192,3.415037499278844,174,Upregulated,100,5
sfmF,4,395,6.625708843064465,391,Upregulated,100,5
sfmH,23,939,5.351419391596762,916,Upregulated,100,5
sfmD,114,3380,4.889917517004805,3266,Upregulated,100,5
sfmC,4,543,7.084808387804362,539,Upregulated,100,5
sfmA,28,390,3.7999753916920067,362,Upregulated,100,5
folD,4243,2476,-0.7770733640764715,-1767,Downregulated,100,5
ybcJ,447,229,-0.964927233086374,-218,Downregulated,100,5
ybcI,74,938,3.6639907468864266,864,Upregulated,100,5
cysS,3271,3113,-0.07142618261359868,-158,Downregulated,100,5
ppiB,10047,2164,-2.2149923776010567,-7883,Downregulated,100,5
lpxH,1036,1731,0.7405817216800848,695,Upregulated,100,5
purE,2789,2029,-0.4589790692716531,-760,Downregulated,100,5
purK,5606,4585,-0.2900500105500771,-1021,Downregulated,100,5
ybcF,43,1744,5.341919570074828,1701,Upregulated,100,5
ylbF,64,1818,4.828136484194107,1754,Upregulated,100,5
fdrA,18,3604,7.645458294371227,3586,Upregulated,100,5
allD,25,1896,6.244887059123535,1871,Upregulated,100,5
allC,153,2715,4.149348639999072,2562,Upregulated,100,5
allE,386,1246,1.6906313157559214,860,Upregulated,100,5
glxK,132,2210,4.06543653492034,2078,Upregulated,100,5
ybbY,37,2610,6.140380725828297,2573,Upregulated,100,5
allB,87,3142,5.174523969445468,3055,Upregulated,100,5
ybbW,10,2416,7.916476644437717,2406,Upregulated,100,5
glxR,34,1684,5.630213581816057,1650,Upregulated,100,5
hyi,25,857,5.099295204337775,832,Upregulated,100,5
gcl,150,3592,4.581752944245266,3442,Upregulated,100,5
allR,4566,2143,-1.091299009548154,-2423,Downregulated,100,5
allA,92,849,3.2060587874960254,757,Upregulated,100,5
allS,46,1785,5.278146402859449,1739,Upregulated,100,5
selU,435,2561,2.5576199468613776,2126,Upregulated,100,5
ylbG,161,616,1.9358696625802845,455,Upregulated,100,5
ybbD,2,191,6.577428828035749,189,Upregulated,100,5
ylbH,25,603,4.59215800212536,578,Upregulated,100,5
ybbC,37,51,0.4629719763425457,14,Unchanged,100,5
rhsD,795,9827,3.6277242903545646,9032,Upregulated,100,5
ybbP,851,7405,3.1212686984902476,6554,Upregulated,100,5
ybbA,447,2034,2.1859729426741823,1587,Upregulated,100,5
tesA,654,1539,1.2346306908301277,885,Upregulated,100,5
ybbO,1202,2456,1.030873664658994,1254,Upregulated,100,5
cnoX,4477,3871,-0.20982601061123315,-606,Downregulated,100,5
fetB,459,1370,1.577609834434081,911,Upregulated,100,5
fetA,512,1093,1.0940776856719046,581,Upregulated,100,5
qmcA,2072,2847,0.4584184900557117,775,Upregulated,100,5
ybbJ,542,944,0.8004940080079697,402,Upregulated,100,5
cueR,905,855,-0.08199337219730746,-50,Unchanged,100,5
ybaT,4897,3296,-0.5711819535255476,-1601,Downregulated,100,5
glsA,2707,2125,-0.3492320463025373,-582,Downregulated,100,5
copA,8910,9491,0.09113467014986153,581,Upregulated,100,5
ybaQ,782,588,-0.411352452470988,-194,Downregulated,100,5
ybaP,910,2226,1.290515142255901,1316,Upregulated,100,5
ybaK,821,1051,0.3563085421843737,230,Upregulated,100,5
ushA,3058,4611,0.5924912590511229,1553,Upregulated,100,5
fsr,250,1988,2.991317756900199,1738,Upregulated,100,5
ybaL,2669,5400,1.016660101796227,2731,Upregulated,100,5
gsk,2047,3102,0.5996875840126802,1055,Upregulated,100,5
aes,122,2060,4.0776912845076945,1938,Upregulated,100,5
hemH,478,2308,2.271560700664734,1830,Upregulated,100,5
adk,9547,2153,-2.1486991398140236,-7394,Downregulated,100,5
htpG,15235,12864,-0.24405018839491935,-2371,Downregulated,100,5
recR,3471,2292,-0.5987443210717411,-1179,Downregulated,100,5
ybaB,2425,1321,-0.8763542807150246,-1104,Downregulated,100,5
dnaX,3164,6854,1.1151965920463824,3690,Upregulated,100,5
apt,1522,1568,0.042957200611662895,46,Unchanged,100,5
ybaN,54,681,3.6566234858486024,627,Upregulated,100,5
priC,592,1368,1.2083991492569481,776,Upregulated,100,5
ybaM,23,51,1.1488633859144828,28,Unchanged,100,5
mscK,2849,9773,1.7783458699855794,6924,Upregulated,100,5
acrR,308,768,1.3181759600262548,460,Upregulated,100,5
acrA,3209,3909,0.28467579500748336,700,Upregulated,100,5
acrB,11104,11074,-0.0039030460478649926,-30,Unchanged,100,5
tomB,118,224,0.9247118726957629,106,Upregulated,100,5
hha,160,201,0.32912359629156634,41,Unchanged,100,5
maa,325,1088,1.7431669333345226,763,Upregulated,100,5
ylaC,190,787,2.0503642171765386,597,Upregulated,100,5
pdeB,384,2214,2.527477006060396,1830,Upregulated,100,5
ybaA,67,429,2.678744647041773,362,Upregulated,100,5
ffs,2,6,1.584962500721156,4,Unchanged,100,5
ybaZ,192,492,1.3575520046180838,300,Upregulated,100,5
ybaY,1105,817,-0.4356383861331104,-288,Downregulated,100,5
tesB,784,1422,0.858995905504207,638,Upregulated,100,5
amtB,390,2511,2.686715999521889,2121,Upregulated,100,5
glnK,18,403,4.484711027085655,385,Upregulated,100,5
mdlB,374,3164,3.080639424585155,2790,Upregulated,100,5
mdlA,487,3202,2.7169796304339147,2715,Upregulated,100,5
decR,226,560,1.3091040545297787,334,Upregulated,100,5
cof,159,1119,2.815111365692039,960,Upregulated,100,5
ybaE,248,2614,3.397847115408558,2366,Upregulated,100,5
queC,529,1094,1.048273110678531,565,Upregulated,100,5
fadM,61,288,2.239187663879426,227,Upregulated,100,5
ybaV,164,414,1.3359349528812416,250,Upregulated,100,5
ppiD,6756,4998,-0.434818426714682,-1758,Downregulated,100,5
hupB,11231,888,-3.6607829031649928,-10343,Downregulated,100,5
lon,16664,12308,-0.4371383957071021,-4356,Downregulated,100,5
clpX,17133,7366,-1.2178244880777658,-9767,Downregulated,100,5
clpP,7476,2654,-1.4940981983749648,-4822,Downregulated,100,5
tig,23630,7237,-1.7071559525913556,-16393,Downregulated,100,5
bolA,1498,280,-2.4195388915137848,-1218,Downregulated,100,5
yajG,2246,1235,-0.8628468859285612,-1011,Downregulated,100,5
ampG,1180,2203,0.9006826354516795,1023,Upregulated,100,5
cyoA,90,1251,3.797012977836145,1161,Upregulated,100,5
cyoB,324,2943,3.1832218240557704,2619,Upregulated,100,5
cyoC,88,694,2.9793602339409637,606,Upregulated,100,5
cyoD,81,308,1.9269365378102767,227,Upregulated,100,5
cyoE,338,1303,1.9467419322859503,965,Upregulated,100,5
yajR,608,2110,1.7950997701509621,1502,Upregulated,100,5
yajQ,6016,2713,-1.1489155193957714,-3303,Downregulated,100,5
panE,1748,1690,-0.04868193833105162,-58,Unchanged,100,5
yajL,1432,1063,-0.4298898957331517,-369,Downregulated,100,5
thiI,3164,2925,-0.11331297511466266,-239,Downregulated,100,5
xseB,1026,373,-1.4597831953518163,-653,Downregulated,100,5
ispA,3515,2312,-0.6043832914592188,-1203,Downregulated,100,5
dxs,3729,4300,0.2055478627031816,571,Upregulated,100,5
yajO,1791,1975,0.1410873159658665,184,Upregulated,100,5
pgpA,1451,1277,-0.18428899436402066,-174,Downregulated,100,5
thiL,1102,1679,0.6074780063658725,577,Upregulated,100,5
nusB,2820,1084,-1.3793304059322844,-1736,Downregulated,100,5
ribE,1881,906,-1.05391689347696,-975,Downregulated,100,5
ribD,2395,2657,0.14977257186696405,262,Upregulated,100,5
nrdR,1299,1060,-0.29333716599731957,-239,Downregulated,100,5
yajI,404,570,0.4966066263003092,166,Upregulated,100,5
tsx,8516,2793,-1.608360376172344,-5723,Downregulated,100,5
yajD,677,317,-1.0946729934355894,-360,Downregulated,100,5
secF,3967,2681,-0.5652771781627194,-1286,Downregulated,100,5
secD,7855,5854,-0.42418852977280813,-2001,Downregulated,100,5
yajC,2403,817,-1.556428664984183,-1586,Downregulated,100,5
tgt,2831,2499,-0.17996084781904326,-332,Downregulated,100,5
queA,838,2284,1.4465405016634911,1446,Upregulated,100,5
acpH,310,697,1.1688904405941856,387,Upregulated,100,5
malZ,1538,3263,1.0851434841300376,1725,Upregulated,100,5
proY,1340,2392,0.8359843888529702,1052,Upregulated,100,5
brnQ,6619,3029,-1.1277716926731132,-3590,Downregulated,100,5
phoR,294,2701,3.199605579672603,2407,Upregulated,100,5
phoB,410,1412,1.7840442737657343,1002,Upregulated,100,5
sbcD,800,2094,1.3881895371560837,1294,Upregulated,100,5
sbcC,1553,6714,2.112114707310249,5161,Upregulated,100,5
araJ,324,2030,2.647414009187914,1706,Upregulated,100,5
mak,828,1859,1.1668240974201562,1031,Upregulated,100,5
rdgC,3510,2217,-0.662862260324616,-1293,Downregulated,100,5
ykiA,42,218,2.375866901998166,176,Upregulated,100,5
ppnP,1151,423,-1.4441582650122806,-728,Downregulated,100,5
aroM,322,1160,1.8489922119003175,838,Upregulated,100,5
yaiA,130,174,0.4205756828202737,44,Unchanged,100,5
aroL,673,1756,1.3836144349250412,1083,Upregulated,100,5
yaiI,301,773,1.3607049271651455,472,Upregulated,100,5
proC,2679,1822,-0.5561716220403283,-857,Downregulated,100,5
dgcC,77,1721,4.482244841345302,1644,Upregulated,100,5
psiF,173,295,0.7699429166124789,122,Upregulated,100,5
phoA,803,3799,2.242147819147708,2996,Upregulated,100,5
iraP,1126,493,-1.191547275702318,-633,Downregulated,100,5
ddlA,3671,2020,-0.8618178214603903,-1651,Downregulated,100,5
yaiZ,47,160,1.767339243209725,113,Upregulated,100,5
yaiY,485,422,-0.20074174836730485,-63,Unchanged,100,5
yaiW,1193,2233,0.9043892081272454,1040,Upregulated,100,5
sbmA,416,2326,2.4831956633321264,1910,Upregulated,100,5
ampH,937,2269,1.2759356560131505,1332,Upregulated,100,5
iprA,15,310,4.369233809665719,295,Upregulated,100,5
insE2,79,80,0.01814734671025952,1,Unchanged,100,5
insF2,23,556,4.595379116666495,533,Upregulated,100,5
hemB,2960,2919,-0.020122965014044487,-41,Unchanged,100,5
tauD,64,1482,4.533329732305834,1418,Upregulated,100,5
tauC,34,1582,5.5400710432224525,1548,Upregulated,100,5
tauB,40,1135,4.826548487290915,1095,Upregulated,100,5
tauA,20,2129,6.734032139564932,2109,Upregulated,100,5
yaiS,7,580,6.372554167957331,573,Upregulated,100,5
yaiP,61,1842,4.91632000852845,1781,Upregulated,100,5
insD1,465,1296,1.478763096889231,831,Upregulated,100,5
insC1,425,206,-1.0448185038418458,-219,Downregulated,100,5
yaiO,70,1135,4.019193565233311,1065,Upregulated,100,5
frmR,32,571,4.157346935362843,539,Upregulated,100,5
frmA,348,3853,3.4688229748108217,3505,Upregulated,100,5
frmB,57,1424,4.642843416801656,1367,Upregulated,100,5
yaiL,674,815,0.27405146793658136,141,Upregulated,100,5
mhpT,143,2410,4.074946094338935,2267,Upregulated,100,5
mhpE,61,2177,5.15738835462532,2116,Upregulated,100,5
mhpF,51,1802,5.142957953842043,1751,Upregulated,100,5
mhpD,39,1386,5.151309323274965,1347,Upregulated,100,5
mhpC,33,1868,5.822884620351209,1835,Upregulated,100,5
mhpB,12,1865,7.279997414421444,1853,Upregulated,100,5
mhpA,22,3827,7.442566567031198,3805,Upregulated,100,5
mhpR,50,1819,5.185073637876762,1769,Upregulated,100,5
lacI,971,2684,1.4668414707809911,1713,Upregulated,100,5
lacZ,38115,24033,-0.6653421271462036,-14082,Downregulated,100,5
lacY,2799,2464,-0.18390923087801353,-335,Downregulated,100,5
lacA,2089,1009,-1.0498863179607512,-1080,Downregulated,100,5
cynX,109,3069,4.815368605689558,2960,Upregulated,100,5
cynS,55,731,3.732367882427778,676,Upregulated,100,5
cynT,44,1523,5.113268607849995,1479,Upregulated,100,5
cynR,204,2122,3.378783598943269,1918,Upregulated,100,5
codA,13627,3555,-1.9385465211399973,-10072,Downregulated,100,5
codB,16339,3201,-2.351725106555469,-13138,Downregulated,100,5
prpE,84,5617,6.06326666479985,5533,Upregulated,100,5
prpD,41,4370,6.735865559769877,4329,Upregulated,100,5
prpC,27,2690,6.638502955280518,2663,Upregulated,100,5
prpB,11,2420,7.78135971352466,2409,Upregulated,100,5
prpR,36,3530,6.61552746671623,3494,Upregulated,100,5
yahO,750,152,-2.302819271939658,-598,Downregulated,100,5
yahN,85,1264,3.8943898120394014,1179,Upregulated,100,5
yahM,12,170,3.8244284354165456,158,Upregulated,100,5
yahL,23,627,4.768759676745026,604,Upregulated,100,5
yahK,1614,2520,0.6427831551094985,906,Upregulated,100,5
yahJ,1002,3537,1.8196437105057104,2535,Upregulated,100,5
yahI,47,2160,5.522226745373193,2113,Upregulated,100,5
yahG,92,3747,5.3479583062721,3655,Upregulated,100,5
yahF,68,3626,5.7367003684938185,3558,Upregulated,100,5
yahE,35,1183,5.078951341394822,1148,Upregulated,100,5
yahD,81,639,2.9798221180623696,558,Upregulated,100,5
yahC,23,879,5.2561573990863915,856,Upregulated,100,5
yahB,192,1467,2.9336906549522337,1275,Upregulated,100,5
pdeL,2092,2088,-0.0027611396770568656,-4,Unchanged,100,5
betT,318,4523,3.8301813253470556,4205,Upregulated,100,5
betI,305,1482,2.280664299855585,1177,Upregulated,100,5
betB,866,4573,2.400701989080239,3707,Upregulated,100,5
betA,494,4160,3.074000581443777,3666,Upregulated,100,5
ykgH,5,283,5.82273014794452,278,Upregulated,100,5
ykgG,153,1321,3.110026908554176,1168,Upregulated,100,5
ykgF,427,2914,2.770692902444022,2487,Upregulated,100,5
ykgE,77,1192,3.95238197976726,1115,Upregulated,100,5
rclR,71,1419,4.320911754555869,1348,Upregulated,100,5
rclA,543,1676,1.62599804589499,1133,Upregulated,100,5
rclB,6,40,2.736965594166206,34,Unchanged,100,5
rclC,43,599,3.8001474380866878,556,Upregulated,100,5
ykgA,164,648,1.982297998266541,484,Upregulated,100,5
insF1,30,351,3.548436624696042,321,Upregulated,100,5
insE1,70,89,0.34645041402143123,19,Unchanged,100,5
eaeH,10,1059,6.726558779104974,1049,Upregulated,100,5
ykgM,6,105,4.129283016944966,99,Unchanged,100,5
ykgL,11,35,1.669851398307669,24,Unchanged,100,5
ecpR,193,312,0.6929451815941678,119,Upregulated,100,5
ecpA,1126,873,-0.36715326845078944,-253,Downregulated,100,5
ecpB,193,1083,2.4883604903402468,890,Upregulated,100,5
ecpC,469,4713,3.328985853499976,4244,Upregulated,100,5
ecpD,431,2405,2.480277119568306,1974,Upregulated,100,5
ecpE,195,1016,2.381354373022555,821,Upregulated,100,5
ykgJ,80,326,2.0268000593437154,246,Upregulated,100,5
yagU,7525,1179,-2.674127863554664,-6346,Downregulated,100,5
paoA,153,1570,3.3591610010863375,1417,Upregulated,100,5
paoB,175,2281,3.7042396194798086,2106,Upregulated,100,5
paoC,476,5693,3.5801556210832026,5217,Upregulated,100,5
paoD,214,2674,3.643316763692206,2460,Upregulated,100,5
intF,2685,3552,0.4037094934773309,867,Upregulated,100,5
yagN,1014,572,-0.8259706002249511,-442,Downregulated,100,5
yagM,18,256,3.8300749985576874,238,Upregulated,100,5
yagL,29,285,3.296837113924532,256,Upregulated,100,5
yagK,133,768,2.5296800652199667,635,Upregulated,100,5
yagJ,170,1756,3.3686861933976564,1586,Upregulated,100,5
insA3,35,320,3.192645077942396,285,Upregulated,100,5
insB3,86,1523,4.146435471785194,1437,Upregulated,100,5
argF,1092,5038,2.2058782658143885,3946,Upregulated,100,5
xynR,739,2431,1.7179036238825778,1692,Upregulated,100,5
yagH,1344,5885,2.130509277147046,4541,Upregulated,100,5
yagG,917,4804,2.3892425121105796,3887,Upregulated,100,5
yagF,553,6133,3.4712415654059843,5580,Upregulated,100,5
yagE,247,2714,3.457837773834177,2467,Upregulated,100,5
yagA,24,3061,6.994824828805835,3037,Upregulated,100,5
yagB,140,454,1.6972654703459484,314,Upregulated,100,5
insA2,49,420,3.0995356735509145,371,Upregulated,100,5
insB2,137,1026,2.9047829326465275,889,Upregulated,100,5
afuB,13,723,5.797412118810025,710,Upregulated,100,5
afuC,73,2857,5.290460762056354,2784,Upregulated,100,5
mmuM,922,2421,1.3927644235695986,1499,Upregulated,100,5
mmuP,690,3402,2.3017148739978537,2712,Upregulated,100,5
insH1,1717,3867,1.171324725080673,2150,Upregulated,100,5
ykfC,398,2407,2.596395805930848,2009,Upregulated,100,5
insI1,38,36,-0.07800251200127321,-2,Unchanged,100,5
perR,105,1528,3.8631833103696263,1423,Upregulated,100,5
ykfA,98,1401,3.83753139631561,1303,Upregulated,100,5
yafZ,13,1392,6.742503777707636,1379,Upregulated,100,5
yafY,26,405,3.9613383796308947,379,Upregulated,100,5
ykfB,199,666,1.7427537465276133,467,Upregulated,100,5
ykfF,25,264,3.400537929583729,239,Upregulated,100,5
yafX,193,841,2.123504952987064,648,Upregulated,100,5
ykfG,30,753,4.649615459063409,723,Upregulated,100,5
yafW,29,438,3.9168060644736014,409,Upregulated,100,5
ykfI,13,288,4.46948528330122,275,Upregulated,100,5
proA,4837,3447,-0.48877123907859327,-1390,Downregulated,100,5
proB,4802,3678,-0.3847139238184788,-1124,Downregulated,100,5
phoE,29,1090,5.232131424536717,1061,Upregulated,100,5
crl,1340,5219,1.961540401275384,3879,Upregulated,100,5
frsA,2630,2974,0.1773418478727541,344,Upregulated,100,5
gpt,2604,538,-2.2750513706090114,-2066,Downregulated,100,5
pepD,16229,5064,-1.6802247966312664,-11165,Downregulated,100,5
prfH,13,644,5.630477159973525,631,Upregulated,100,5
ykfJ,1,74,6.20945336562895,73,Unchanged,100,5
yafP,55,337,2.6152450676571988,282,Upregulated,100,5
yafO,81,303,1.9033239805883262,222,Upregulated,100,5
yafN,129,210,0.7030182622428686,81,Unchanged,100,5
dinB,1003,2105,1.0694986273415776,1102,Upregulated,100,5
lafU,62,898,3.8563753243542718,836,Upregulated,100,5
lfhA,70,2642,5.238131734301861,2572,Upregulated,100,5
rayT,213,419,0.9760968134735133,206,Upregulated,100,5
yafL,92,957,3.3788131584290126,865,Upregulated,100,5
dinJ,620,294,-1.0764520604378731,-326,Downregulated,100,5
yafQ,299,177,-0.7563961241151075,-122,Downregulated,100,5
ldtF,1510,934,-0.6930540945027793,-576,Downregulated,100,5
yafJ,1260,1166,-0.11185594518678231,-94,Unchanged,100,5
gmhA,3326,1753,-0.923962172527731,-1573,Downregulated,100,5
fadE,380,4336,3.512293433022924,3956,Upregulated,100,5
ivy,29038,2907,-3.3203391141626644,-26131,Downregulated,100,5
yafV,755,1097,0.5390149761907516,342,Upregulated,100,5
yafU,2,115,5.845490050944375,113,Upregulated,100,5
yafT,39,546,3.807354922057604,507,Upregulated,100,5
dnaQ,1774,1192,-0.5736217738389024,-582,Downregulated,100,5
rnhA,404,533,0.39978024000738116,129,Upregulated,100,5
yafS,498,701,0.4932687019425422,203,Upregulated,100,5
gloB,457,575,0.33136779077366796,118,Upregulated,100,5
mltD,6965,2992,-1.2190131776009787,-3973,Downregulated,100,5
yafE,268,588,1.133583154378592,320,Upregulated,100,5
yafD,2492,1788,-0.4789573318406841,-704,Downregulated,100,5
yafC,561,1334,1.2496859905757922,773,Upregulated,100,5
dkgB,225,648,1.5260688116675876,423,Upregulated,100,5
gmhB,710,586,-0.2769183599697965,-124,Downregulated,100,5
metN,10879,2560,-2.0873302345090456,-8319,Downregulated,100,5
metI,4930,1454,-1.7615603773456796,-3476,Downregulated,100,5
metQ,21292,2202,-3.273425097361117,-19090,Downregulated,100,5
rcsF,1432,673,-1.0893530826539393,-759,Downregulated,100,5
trmO,1062,1145,0.10856383218015271,83,Unchanged,100,5
proS,10167,4531,-1.1659926466917614,-5636,Downregulated,100,5
yaeF,61,896,3.876617584494718,835,Upregulated,100,5
nlpE,768,1121,0.5456080620842706,353,Upregulated,100,5
arfB,333,619,0.8944172321430025,286,Upregulated,100,5
yaeQ,566,989,0.8051684679272285,423,Upregulated,100,5
rof,1094,336,-1.7030796000137962,-758,Downregulated,100,5
tilS,1674,2348,0.4881328805597085,674,Upregulated,100,5
yaeR,330,418,0.3410369178350669,88,Unchanged,100,5
ldcC,1860,3413,0.8757377931034717,1553,Upregulated,100,5
accA,5631,2604,-1.112661702386395,-3027,Downregulated,100,5
dnaE,6065,7506,0.30753664487910326,1441,Upregulated,100,5
rnhB,1058,1287,0.282672426106676,229,Upregulated,100,5
lpxB,3900,3379,-0.20687777347317152,-521,Downregulated,100,5
lpxA,5579,3083,-0.8556716619409007,-2496,Downregulated,100,5
fabZ,3247,1462,-1.1511640733336508,-1785,Downregulated,100,5
lpxD,22317,4821,-2.2107387686637288,-17496,Downregulated,100,5
skp,13479,2175,-2.6316261616211416,-11304,Downregulated,100,5
bamA,23333,8136,-1.5199802269520264,-15197,Downregulated,100,5
rseP,7681,3889,-0.9818949148622766,-3792,Downregulated,100,5
cdsA,3120,1808,-0.7871513513344228,-1312,Downregulated,100,5
uppS,3244,1321,-1.2961433529704454,-1923,Downregulated,100,5
dxr,1423,2224,0.644221126197025,801,Upregulated,100,5
frr,9176,2046,-2.1650592462704963,-7130,Downregulated,100,5
pyrH,6446,2314,-1.4780153239520553,-4132,Downregulated,100,5
tsf,26993,6595,-2.033140762144993,-20398,Downregulated,100,5
rpsB,49068,9015,-2.4443830719278177,-40053,Downregulated,100,5
map,3894,1640,-1.2475570692148488,-2254,Downregulated,100,5
glnD,3717,4862,0.3874112051669712,1145,Upregulated,100,5
dapD,9718,3613,-1.4274621776848422,-6105,Downregulated,100,5
yaeI,218,969,2.152168530638155,751,Upregulated,100,5
yaeH,1102,437,-1.3344190390705593,-665,Downregulated,100,5
cdaR,234,1737,2.8920173191269885,1503,Upregulated,100,5
degP,8840,7139,-0.3083243676423581,-1701,Downregulated,100,5
dgt,1210,2212,0.8703443380727502,1002,Upregulated,100,5
mtn,2775,2447,-0.18147367004544102,-328,Downregulated,100,5
btuF,455,1461,1.6830177277174398,1006,Upregulated,100,5
yadS,192,945,2.299208018387279,753,Upregulated,100,5
erpA,1638,749,-1.1288977331822576,-889,Downregulated,100,5
clcA,1423,3073,1.1107121050664799,1650,Upregulated,100,5
hemL,6309,4937,-0.35377670571183883,-1372,Downregulated,100,5
fhuB,289,4831,4.063180454931398,4542,Upregulated,100,5
fhuD,183,1865,3.349260076858558,1682,Upregulated,100,5
fhuC,240,1911,2.993221467368938,1671,Upregulated,100,5
fhuA,812,4226,2.3797411347497643,3414,Upregulated,100,5
mrcB,3223,6379,0.9849260901198685,3156,Upregulated,100,5
hrpB,2277,6513,1.516187935199678,4236,Upregulated,100,5
thpR,338,842,1.3167969867842118,504,Upregulated,100,5
sfsA,796,1123,0.4965175918569524,327,Upregulated,100,5
dksA,5898,1898,-1.6357458300406276,-4000,Downregulated,100,5
gluQ,257,1532,2.575576032731079,1275,Upregulated,100,5
pcnB,7003,4320,-0.6969417750889682,-2683,Downregulated,100,5
folK,364,621,0.7706548180217851,257,Upregulated,100,5
yadN,7,534,6.25334100962995,527,Upregulated,100,5
yadV,8,686,6.422064766172812,678,Upregulated,100,5
htrE,90,2363,4.714550817644172,2273,Upregulated,100,5
yadM,45,400,3.15200309344505,355,Upregulated,100,5
yadL,68,365,2.4242898125170402,297,Upregulated,100,5
yadK,19,312,4.037474705418663,293,Upregulated,100,5
yadC,68,607,3.1580898650053424,539,Upregulated,100,5
panB,7600,4583,-0.7297071328439977,-3017,Downregulated,100,5
panC,9902,4616,-1.1010767253166782,-5286,Downregulated,100,5
rpnC,118,1048,3.150779952175609,930,Upregulated,100,5
panD,3277,590,-2.4735888132935564,-2687,Downregulated,100,5
yadE,379,1857,2.2927040617643293,1478,Upregulated,100,5
yadI,187,516,1.4643327955356173,329,Upregulated,100,5
yadH,773,1126,0.5426665081553823,353,Upregulated,100,5
yadG,974,1747,0.8428859308344173,773,Upregulated,100,5
can,1783,1054,-0.7584318359877802,-729,Downregulated,100,5
hpt,1728,1087,-0.6687512771361593,-641,Downregulated,100,5
gcd,365,4715,3.6912894017950793,4350,Upregulated,100,5
cueO,1526,2906,0.9292797407983108,1380,Upregulated,100,5
yacC,374,449,0.26367717485351017,75,Unchanged,100,5
speE,3965,2539,-0.6430604709438351,-1426,Downregulated,100,5
speD,5051,1945,-1.3767988865576484,-3106,Downregulated,100,5
yacL,367,499,0.44325975249404775,132,Upregulated,100,5
acnB,11551,12248,0.08452843305444614,697,Upregulated,100,5
yacH,108,3410,4.980668521748067,3302,Upregulated,100,5
lpd,4924,9621,0.9663560926783457,4697,Upregulated,100,5
aceF,3333,15117,2.1812786395806607,11784,Upregulated,100,5
aceE,4427,20500,2.2112226311823053,16073,Upregulated,100,5
pdhR,214,3051,3.833599478177509,2837,Upregulated,100,5
aroP,1341,3309,1.303086054408065,1968,Upregulated,100,5
ampE,966,1616,0.7423321039160216,650,Upregulated,100,5
ampD,585,977,0.7399219374976185,392,Upregulated,100,5
nadC,880,1755,0.9958956016672635,875,Upregulated,100,5
ppdD,6,668,6.798741791752896,662,Upregulated,100,5
hofB,207,2662,3.6848078984125667,2455,Upregulated,100,5
hofC,144,2558,4.150875547439325,2414,Upregulated,100,5
guaC,8293,2263,-1.8736575077294848,-6030,Downregulated,100,5
coaE,500,1018,1.0257375614136082,518,Upregulated,100,5
zapD,1011,1439,0.5092835948372834,428,Upregulated,100,5
yacG,75,157,1.0658020583957462,82,Unchanged,100,5
mutT,74,281,1.9249729545919763,207,Upregulated,100,5
secA,8479,11743,0.46983499204021323,3264,Upregulated,100,5
secM,1363,1227,-0.15165031314230443,-136,Downregulated,100,5
lpxC,40225,24484,-0.716253147691607,-15741,Downregulated,100,5
ftsZ,22718,8607,-1.4002534575093086,-14111,Downregulated,100,5
ftsA,5696,4396,-0.37375776001716665,-1300,Downregulated,100,5
ftsQ,3490,2794,-0.3208950156875514,-696,Downregulated,100,5
ddlB,5291,3034,-0.8023193321603057,-2257,Downregulated,100,5
murC,6363,4643,-0.45464984068504954,-1720,Downregulated,100,5
murG,3622,2956,-0.2931402768040169,-666,Downregulated,100,5
ftsW,3563,3704,0.05599161512693684,141,Upregulated,100,5
murD,5300,4248,-0.31920859353377024,-1052,Downregulated,100,5
mraY,3504,2775,-0.3365150034763427,-729,Downregulated,100,5
murF,6004,4034,-0.573712893007727,-1970,Downregulated,100,5
murE,7043,4850,-0.5382053354274857,-2193,Downregulated,100,5
ftsI,3873,4417,0.18961533101180636,544,Upregulated,100,5
ftsL,783,608,-0.3649409838474552,-175,Downregulated,100,5
rsmH,5264,3646,-0.5298449276961072,-1618,Downregulated,100,5
mraZ,2814,1921,-0.5507648095710056,-893,Downregulated,100,5
cra,4031,3394,-0.24815121830841616,-637,Downregulated,100,5
ilvH,1567,1606,0.03546671304473432,39,Unchanged,100,5
ilvI,6468,6503,0.007785744966595214,35,Unchanged,100,5
leuO,356,1323,1.8938639153122792,967,Upregulated,100,5
leuL,1,1,0.0,0,Unchanged,100,5
leuA,9070,4953,-0.8727999297814705,-4117,Downregulated,100,5
leuB,9512,3489,-1.4469351175512815,-6023,Downregulated,100,5
leuC,13063,5585,-1.225857073092109,-7478,Downregulated,100,5
leuD,4945,1867,-1.4052485934202712,-3078,Downregulated,100,5
setA,654,2432,1.894780687945503,1778,Upregulated,100,5
sgrR,629,4527,2.8474233843685504,3898,Upregulated,100,5
thiB,676,2262,1.7425037777076362,1586,Upregulated,100,5
thiP,254,3743,3.8812946461277957,3489,Upregulated,100,5
thiQ,147,1537,3.3862291048544066,1390,Upregulated,100,5
yabI,336,1797,2.4190572707311815,1461,Upregulated,100,5
araC,558,2223,1.9941709211978025,1665,Upregulated,100,5
araB,96,4012,5.385143389891025,3916,Upregulated,100,5
araA,169,3659,4.436354264056903,3490,Upregulated,100,5
araD,34,1458,5.422312163076597,1424,Upregulated,100,5
polB,1148,4883,2.0886451359617757,3735,Upregulated,100,5
rapA,1702,6270,1.8812344060034387,4568,Upregulated,100,5
rluA,323,1135,1.8130862274843524,812,Upregulated,100,5
djlA,683,1745,1.353269552806924,1062,Upregulated,100,5
lptD,15687,8100,-0.9535756629086479,-7587,Downregulated,100,5
surA,9386,5589,-0.7479202853654693,-3797,Downregulated,100,5
pdxA,2187,2558,0.22606304383354378,371,Upregulated,100,5
rsmA,3304,2135,-0.6299776169115925,-1169,Downregulated,100,5
apaG,1093,832,-0.3936379675308125,-261,Downregulated,100,5
apaH,1602,1895,0.2423237006497438,293,Upregulated,100,5
folA,663,764,0.2045637679231608,101,Upregulated,100,5
kefC,818,4462,2.4475177653023916,3644,Upregulated,100,5
kefF,220,912,2.0515303006400822,692,Upregulated,100,5
yaaU,31,2853,6.524067721194845,2822,Upregulated,100,5
fixX,5,294,5.877744249949002,289,Upregulated,100,5
fixC,46,2992,6.023332503830623,2946,Upregulated,100,5
fixB,59,2155,5.190829104614619,2096,Upregulated,100,5
fixA,58,1677,4.853685978436774,1619,Upregulated,100,5
caiT,36,2922,6.3428154613611865,2886,Upregulated,100,5
caiA,466,2368,2.3452672209746694,1902,Upregulated,100,5
caiB,244,2260,3.211369719739664,2016,Upregulated,100,5
caiC,312,2861,3.196901563460935,2549,Upregulated,100,5
caiD,56,1653,4.883516087234709,1597,Upregulated,100,5
caiE,49,1168,4.575114714764809,1119,Upregulated,100,5
caiF,2125,1004,-1.0817035719616543,-1121,Downregulated,100,5
carB,87261,11084,-2.976858390979492,-76177,Downregulated,100,5
carA,39642,3752,-3.4012980175830543,-35890,Downregulated,100,5
dapB,2670,1893,-0.4961653308712111,-777,Downregulated,100,5
rihC,369,2201,2.576466423831161,1832,Upregulated,100,5
ispH,3204,3048,-0.0720112449153881,-156,Downregulated,100,5
fkpB,1220,1102,-0.14675692387909103,-118,Downregulated,100,5
lspA,2428,1585,-0.6152855812289125,-843,Downregulated,100,5
ileS,26188,16243,-0.6890877684242107,-9945,Downregulated,100,5
ribF,5326,3097,-0.7821810455359511,-2229,Downregulated,100,5
yaaY,16,143,3.1598713367783895,127,Upregulated,100,5
rpsT,3080,393,-2.9703291333236574,-2687,Downregulated,100,5
insA1,18,180,3.321928094887362,162,Upregulated,100,5
insB1,37,444,3.584962500721156,407,Upregulated,100,5
nhaR,999,1918,0.9410461372257125,919,Upregulated,100,5
nhaA,4014,5155,0.36093181089285364,1141,Upregulated,100,5
mokC,20,112,2.4854268271702415,92,Unchanged,100,5
insL1,1370,2634,0.9430794524086253,1264,Upregulated,100,5
dnaJ,4436,7278,0.7142826856799565,2842,Upregulated,100,5
dnaK,59018,42708,-0.4666486929157538,-16310,Downregulated,100,5
yaaI,10,571,5.83541884047548,561,Upregulated,100,5
yaaW,51,1140,4.482392767080609,1089,Upregulated,100,5
satP,321,1268,1.981909543017104,947,Upregulated,100,5
mog,716,1296,0.8560342256203683,580,Upregulated,100,5
talB,30807,7264,-2.0844220911612354,-23543,Downregulated,100,5
yaaJ,622,2970,2.255476445557526,2348,Upregulated,100,5
yaaA,1210,1732,0.5174318825647681,522,Upregulated,100,5
yaaX,114,320,1.4890380807226207,206,Upregulated,100,5
thrC,8008,11992,0.5825584091118661,3984,Upregulated,100,5
thrB,5969,11160,0.9027758682667467,5191,Upregulated,100,5
thrA,18297,38832,1.0856388918640891,20535,Upregulated,100,5
thrL,1,1,0.0,0,Unchanged,100,5
sokX,1,1,0.0,0,Unchanged,1000,5
sokE,1,1,0.0,0,Unchanged,1000,5
fnrS,1,2,1.0,1,Unchanged,1000,5
mgrR,1,1,0.0,0,Unchanged,1000,5
yrdF,2,5,1.3219280948873624,3,Unchanged,1000,5
yneO,1069,5385,2.3326844917110794,4316,Upregulated,1000,5
aaaE,138,1397,3.339591848631294,1259,Upregulated,1000,5
oweE,13,123,3.2420747871981477,110,Unchanged,1000,5
sroH,2,16,3.0,14,Unchanged,1000,5
eyeA,1,1,0.0,0,Unchanged,1000,5
rzoQ,2,22,3.4594316186372973,20,Unchanged,1000,5
ykgS,29,83,1.5170584362193527,54,Unchanged,1000,5
shoB,1,1,0.0,0,Unchanged,1000,5
yshB,4,2,-1.0,-2,Unchanged,1000,5
yrbN,1,1,0.0,0,Unchanged,1000,5
yqfG,1,1,0.0,0,Unchanged,1000,5
yqeL,1,1,0.0,0,Unchanged,1000,5
yqcG,1,1,0.0,0,Unchanged,1000,5
ypdK,1,1,0.0,0,Unchanged,1000,5
yohP,1,1,0.0,0,Unchanged,1000,5
yoeI,1,1,0.0,0,Unchanged,1000,5
yobI,1,1,0.0,0,Unchanged,1000,5
yoaK,1,1,0.0,0,Unchanged,1000,5
yoaJ,1,1,0.0,0,Unchanged,1000,5
ynbG,1,1,0.0,0,Unchanged,1000,5
ymjD,1,1,0.0,0,Unchanged,1000,5
ymiB,1,1,0.0,0,Unchanged,1000,5
ykgR,1,1,0.0,0,Unchanged,1000,5
yjeV,1,1,0.0,0,Unchanged,1000,5
ilvX,1,1,0.0,0,Unchanged,1000,5
ibsB,1,1,0.0,0,Unchanged,1000,5
ibsA,1,1,0.0,0,Unchanged,1000,5
ibsE,1,1,0.0,0,Unchanged,1000,5
ibsC,1,1,0.0,0,Unchanged,1000,5
ibsD,1,1,0.0,0,Unchanged,1000,5
azuC,1,1,0.0,0,Unchanged,1000,5
sgrT,5,10,1.0,5,Unchanged,1000,5
yfcU,353,3690,3.385880727676578,3337,Upregulated,1000,5
yhiL,32,433,3.758223214726725,401,Unchanged,1000,5
yghX,317,1052,1.730579959152895,735,Unchanged,1000,5
yjhZ,2,70,5.129283016944966,68,Unchanged,1000,5
yjhY,311,271,-0.19862172877673107,-40,Unchanged,1000,5
ythA,1,1,0.0,0,Unchanged,1000,5
yjdQ,1,12,3.584962500721156,11,Unchanged,1000,5
yicT,1,8,3.0,7,Unchanged,1000,5
yibU,1,47,5.554588851677638,46,Unchanged,1000,5
yibW,3,83,4.7900769306257684,80,Unchanged,1000,5
yibS,3,105,5.129283016944966,102,Unchanged,1000,5
ysaD,1,79,6.303780748177103,78,Unchanged,1000,5
ysaC,1,1,0.0,0,Unchanged,1000,5
mokA,1,15,3.9068905956085187,14,Unchanged,1000,5
yrdE,18,203,3.495410915742864,185,Unchanged,1000,5
psaA,1,1,0.0,0,Unchanged,1000,5
ypjI,5,176,5.137503523749935,171,Unchanged,1000,5
pawZ,1,1,0.0,0,Unchanged,1000,5
yoeD,1,4,2.0,3,Unchanged,1000,5
yoeH,27,18,-0.5849625007211563,-9,Unchanged,1000,5
yoeG,160,321,1.0045013922349408,161,Unchanged,1000,5
yeeH,1,1,0.0,0,Unchanged,1000,5
ttcC,1,1,0.0,0,Unchanged,1000,5
uof,1,1,0.0,0,Unchanged,1000,5
ybfI,1,14,3.807354922057604,13,Unchanged,1000,5
aaaD,6,264,5.459431618637297,258,Unchanged,1000,5
xisD,77,169,1.1340928955872829,92,Unchanged,1000,5
ylbI,1,1,0.0,0,Unchanged,1000,5
ykgQ,1,1,0.0,0,Unchanged,1000,5
ykgP,1,1,0.0,0,Unchanged,1000,5
ykfK,2,92,5.523561956057013,90,Unchanged,1000,5
ykfL,8,186,4.539158811108031,178,Unchanged,1000,5
ykfN,1,1,0.0,0,Unchanged,1000,5
symR,1,1,0.0,0,Unchanged,1000,5
ryjB,1,1,0.0,0,Unchanged,1000,5
insO,334,3978,3.5741232683596915,3644,Upregulated,1000,5
ytcA,1,290,8.179909090014934,289,Unchanged,1000,5
yjbS,1,7,2.807354922057604,6,Unchanged,1000,5
yjbT,8,164,4.357552004618084,156,Unchanged,1000,5
tisB,1,1,0.0,0,Unchanged,1000,5
istR,1,21,4.392317422778761,20,Unchanged,1000,5
yibV,3,94,4.9696263509564815,91,Unchanged,1000,5
sokA,1,1,0.0,0,Unchanged,1000,5
dinQ,2,7,1.8073549220576042,5,Unchanged,1000,5
yrhD,1,2,1.0,1,Unchanged,1000,5
sibE,3,3,0.0,0,Unchanged,1000,5
ryfD,13,3,-2.115477217419936,-10,Unchanged,1000,5
ohsC,1,1,0.0,0,Unchanged,1000,5
ypfM,1,1,0.0,0,Unchanged,1000,5
yojO,1,13,3.700439718141092,12,Unchanged,1000,5
rseX,1,1,0.0,0,Unchanged,1000,5
cydH,1,1,0.0,0,Unchanged,1000,5
ydgU,1,1,0.0,0,Unchanged,1000,5
mgtS,1,1,0.0,0,Unchanged,1000,5
yncL,1,1,0.0,0,Unchanged,1000,5
rydC,1,1,0.0,0,Unchanged,1000,5
yciZ,212,57,-1.8950304403984575,-155,Unchanged,1000,5
yciY,161,39,-2.0455146592523685,-122,Unchanged,1000,5
ymgJ,6,8,0.41503749927884376,2,Unchanged,1000,5
ymgI,1,3,1.584962500721156,2,Unchanged,1000,5
appX,1,1,0.0,0,Unchanged,1000,5
ybfK,1,97,6.599912842187128,96,Unchanged,1000,5
ylcI,30,66,1.1375035237499351,36,Unchanged,1000,5
ylcH,1,3,1.584962500721156,2,Unchanged,1000,5
insN,1725,3383,0.9717068152410945,1658,Upregulated,1000,5
ykfM,6,7,0.22239242133644802,1,Unchanged,1000,5
chiX,1,1,0.0,0,Unchanged,1000,5
yoeA,384,2481,2.6917435191712746,2097,Upregulated,1000,5
ybeM,368,1091,1.5678734302665942,723,Unchanged,1000,5
yaiT,548,5158,3.234563974828687,4610,Upregulated,1000,5
yncK,14,232,4.050626073069968,218,Unchanged,1000,5
sgrS,52,86,0.7258250365610057,34,Unchanged,1000,5
insB7,37,824,4.477047161554268,787,Unchanged,1000,5
yjgX,499,1673,1.745325724701092,1174,Upregulated,1000,5
insZ,103,1383,3.7470849139672757,1280,Upregulated,1000,5
ylbE,82,3030,5.20755007374223,2948,Upregulated,1000,5
lomR,148,2885,4.284902237903895,2737,Upregulated,1000,5
yhcE,1924,8506,2.144372055855722,6582,Upregulated,1000,5
ytjA,336,72,-2.222392421336448,-264,Unchanged,1000,5
yjjZ,6,136,4.502500340529183,130,Unchanged,1000,5
topAI,23,98,2.0911478880581953,75,Unchanged,1000,5
sgcB,7,172,4.618909832644494,165,Unchanged,1000,5
insM,19,45,1.2439255828860891,26,Unchanged,1000,5
ghoT,2,6,1.584962500721156,4,Unchanged,1000,5
yifL,297,143,-1.0544477840223765,-154,Unchanged,1000,5
yidD,474,222,-1.0943273825481532,-252,Unchanged,1000,5
ysdC,69,1626,4.558587085296859,1557,Upregulated,1000,5
yicS,31,198,2.6751603096927346,167,Unchanged,1000,5
yibT,231,122,-0.9210117038531713,-109,Unchanged,1000,5
ysaB,34,230,2.7580272096940357,196,Unchanged,1000,5
yrhC,7,137,4.290677160902923,130,Unchanged,1000,5
yheV,29,32,0.14201900487242786,3,Unchanged,1000,5
arfA,59,39,-0.5972408304995929,-20,Unchanged,1000,5
ypjJ,1,78,6.285402218862249,77,Unchanged,1000,5
ypfN,80,151,0.9164766444377165,71,Unchanged,1000,5
ypeB,91,111,0.28662122615140984,20,Unchanged,1000,5
ypdJ,1,1,0.0,0,Unchanged,1000,5
arnE,34,305,3.1652025911999093,271,Unchanged,1000,5
ypaA,50,53,0.08406426478847455,3,Unchanged,1000,5
yohO,1,1,0.0,0,Unchanged,1000,5
yehK,1,94,6.554588851677638,93,Unchanged,1000,5
yoeB,153,170,0.15200309344505006,17,Unchanged,1000,5
yoeF,1,10,3.321928094887362,9,Unchanged,1000,5
yecJ,185,148,-0.3219280948873623,-37,Unchanged,1000,5
yobH,203,65,-1.6429681041567217,-138,Unchanged,1000,5
yniD,1,2,1.0,1,Unchanged,1000,5
ynfO,16,90,2.4918530963296748,74,Unchanged,1000,5
hicA,39,37,-0.07594885323329863,-2,Unchanged,1000,5
ydbJ,957,354,-1.4347695644030283,-603,Unchanged,1000,5
rzoR,4,5,0.32192809488736235,1,Unchanged,1000,5
ydaF,2,31,3.9541963103868754,29,Unchanged,1000,5
ydaE,3,9,1.584962500721156,6,Unchanged,1000,5
ymjC,2,3,0.5849625007211562,1,Unchanged,1000,5
ymjB,29,1743,5.909375858998113,1714,Upregulated,1000,5
yciX,30,29,-0.0489096004809464,-1,Unchanged,1000,5
ymiA,3,11,1.874469117916141,8,Unchanged,1000,5
ycgI,32,227,2.826548487290915,195,Unchanged,1000,5
ymgF,9,22,1.289506617194985,13,Unchanged,1000,5
icdC,3,27,3.169925001442312,24,Unchanged,1000,5
ymdF,130,61,-1.0916304754655681,-69,Unchanged,1000,5
gnsA,44,57,0.37345839552744436,13,Unchanged,1000,5
insA4,7,262,5.226068079479846,255,Unchanged,1000,5
cydX,8,4,-1.0,-4,Unchanged,1000,5
ybfQ,10,66,2.722466024471091,56,Unchanged,1000,5
kdpF,1,1,0.0,0,Unchanged,1000,5
ybdD,18,71,1.9798221180623699,53,Unchanged,1000,5
ybdZ,2,133,6.05528243550119,131,Unchanged,1000,5
rzoD,5,9,0.8479969065549501,4,Unchanged,1000,5
ylcG,1,6,2.584962500721156,5,Unchanged,1000,5
peaD,2,231,6.851749041416057,229,Unchanged,1000,5
ykgO,1,6,2.584962500721156,5,Unchanged,1000,5
insX,130,242,0.89649542424614,112,Unchanged,1000,5
ykfH,7,152,4.4405725913859815,145,Unchanged,1000,5
yafF,3,90,4.906890595608519,87,Unchanged,1000,5
yeiW,4,202,5.658211482751795,198,Unchanged,1000,5
torI,13,29,1.15754127698648,16,Unchanged,1000,5
yfaS,364,7694,4.401723474097919,7330,Upregulated,1000,5
yehH,240,5701,4.570108690524543,5461,Upregulated,1000,5
yeeL,51,389,2.931201003014696,338,Unchanged,1000,5
yedS,262,791,1.5941108829353414,529,Unchanged,1000,5
yedN,29,211,2.863118193579613,182,Unchanged,1000,5
arpB,68,987,3.8594434332060583,919,Unchanged,1000,5
gapC,14295,3808,-1.9084052362105168,-10487,Downregulated,1000,5
ydbA,5237,15549,1.5700092896565043,10312,Upregulated,1000,5
ycgH,586,1826,1.639714195561974,1240,Upregulated,1000,5
efeU,20,1857,6.536830005048058,1837,Upregulated,1000,5
ilvG,7954,14887,0.9043005867860018,6933,Upregulated,1000,5
yjdP,165,637,1.9488273480104847,472,Unchanged,1000,5
yjiV,1271,5318,2.0649197468527087,4047,Upregulated,1000,5
ytfR,175,2691,3.9427155638080884,2516,Upregulated,1000,5
cpxP,1372,2510,0.8714068826653221,1138,Upregulated,1000,5
tatD,906,1419,0.6472916340143162,513,Unchanged,1000,5
yigE,43,1044,4.601641241867787,1001,Upregulated,1000,5
wecF,834,1273,0.6101131304566944,439,Unchanged,1000,5
hdfR,1225,1064,-0.20328359838874335,-161,Unchanged,1000,5
dgoR,326,1708,2.389364105389413,1382,Upregulated,1000,5
dgoD,115,2334,4.343098794762973,2219,Upregulated,1000,5
dgoA,39,973,4.6408937759188635,934,Unchanged,1000,5
gntU,350,3078,3.1365664044958814,2728,Upregulated,1000,5
rtcA,332,2851,3.102212892591028,2519,Upregulated,1000,5
frlC,64,1370,4.419960177847889,1306,Upregulated,1000,5
smf,493,951,0.9478576944826519,458,Unchanged,1000,5
yhdP,3334,6050,0.8596810380629025,2716,Upregulated,1000,5
tdcG,127,1768,3.799217872619266,1641,Upregulated,1000,5
cyuA,278,2229,3.003239828536245,1951,Upregulated,1000,5
ygiQ,1439,3832,1.4130309689958824,2393,Upregulated,1000,5
glcE,78,2695,5.11066733877762,2617,Upregulated,1000,5
glcF,301,3146,3.3856832786559847,2845,Upregulated,1000,5
yghJ,7703,8990,0.2229006904246339,1287,Upregulated,1000,5
yggP,89,1558,4.129746087095271,1469,Upregulated,1000,5
ghxQ,238,1659,2.8012804076479196,1421,Upregulated,1000,5
ygcU,68,1934,4.829909238226501,1866,Upregulated,1000,5
ygaQ,17,946,5.798233532089056,929,Unchanged,1000,5
yfjD,652,1551,1.2502548168050134,899,Unchanged,1000,5
araH,277,1225,2.1448238678407443,948,Unchanged,1000,5
ryjA,1,16,4.0,15,Unchanged,1000,5
oxyS,1,1,0.0,0,Unchanged,1000,5
csrC,64712,3906,-4.0502694117477835,-60806,Downregulated,1000,5
glmZ,2821,925,-1.608681395181897,-1896,Downregulated,1000,5
hokA,1,3,1.584962500721156,2,Unchanged,1000,5
rdlD,1,1,0.0,0,Unchanged,1000,5
ldrD,1,1,0.0,0,Unchanged,1000,5
gadY,1,1,0.0,0,Unchanged,1000,5
ryhB,1,1,0.0,0,Unchanged,1000,5
arcZ,1,1,0.0,0,Unchanged,1000,5
sraG,1,19,4.247927513443585,18,Unchanged,1000,5
sibD,3,12,2.0,9,Unchanged,1000,5
sibC,1,7,2.807354922057604,6,Unchanged,1000,5
omrB,1,1,0.0,0,Unchanged,1000,5
omrA,1,1,0.0,0,Unchanged,1000,5
gcvB,1042,50,-4.381283372503783,-992,Unchanged,1000,5
micA,1,1,0.0,0,Unchanged,1000,5
glmY,101,54,-0.9033239805883261,-47,Unchanged,1000,5
ryfA,185,389,1.0722448844698798,204,Unchanged,1000,5
micF,1,1,0.0,0,Unchanged,1000,5
cyaR,1,1,0.0,0,Unchanged,1000,5
sibB,1,6,2.584962500721156,5,Unchanged,1000,5
sibA,2,10,2.321928094887362,8,Unchanged,1000,5
isrC,35,18,-0.9593580155026542,-17,Unchanged,1000,5
sdsR,1,1,0.0,0,Unchanged,1000,5
ryeA,331,240,-0.46379681119869925,-91,Unchanged,1000,5
rprA,1,1,0.0,0,Unchanged,1000,5
rydB,1,1,0.0,0,Unchanged,1000,5
sokB,1,1,0.0,0,Unchanged,1000,5
hokB,6,11,0.874469117916141,5,Unchanged,1000,5
micC,1,1,0.0,0,Unchanged,1000,5
mcaS,1,13,3.700439718141092,12,Unchanged,1000,5
rttR,15,132,3.137503523749935,117,Unchanged,1000,5
rdlC,1,1,0.0,0,Unchanged,1000,5
ldrC,1,1,0.0,0,Unchanged,1000,5
rdlB,1,1,0.0,0,Unchanged,1000,5
ldrB,1,3,1.584962500721156,2,Unchanged,1000,5
rdlA,1,1,0.0,0,Unchanged,1000,5
ldrA,2,1,-1.0,-1,Unchanged,1000,5
sraB,2,14,2.807354922057604,12,Unchanged,1000,5
rybB,1,1,0.0,0,Unchanged,1000,5
rybA,1,1,0.0,0,Unchanged,1000,5
hokE,3,18,2.584962500721156,15,Unchanged,1000,5
tff,75,8,-3.228818690495881,-67,Unchanged,1000,5
sokC,1,1,0.0,0,Unchanged,1000,5
hokC,1,10,3.321928094887362,9,Unchanged,1000,5
ecnB,30,24,-0.3219280948873623,-6,Unchanged,1000,5
ecnA,2,3,0.5849625007211562,1,Unchanged,1000,5
blr,16,3,-2.415037499278844,-13,Unchanged,1000,5
csrB,623178,260368,-1.2590921550619776,-362810,Downregulated,1000,5
thiS,6,71,3.564784618783526,65,Unchanged,1000,5
yaeP,974,316,-1.6239972139052394,-658,Unchanged,1000,5
yjtD,303,1091,1.8482614028506563,788,Unchanged,1000,5
yjjY,1,12,3.584962500721156,11,Unchanged,1000,5
arcA,18961,3232,-2.55253595053786,-15729,Downregulated,1000,5
creD,132,2359,4.159565583881009,2227,Upregulated,1000,5
creC,331,3081,3.2184955602321335,2750,Upregulated,1000,5
creB,419,1320,1.6555157805464642,901,Unchanged,1000,5
creA,590,815,0.4660851048692364,225,Unchanged,1000,5
rob,3855,2200,-0.8092273363903748,-1655,Downregulated,1000,5
ytjC,1339,1457,0.12184491674020201,118,Unchanged,1000,5
yjjX,410,1130,1.4626269577971038,720,Unchanged,1000,5
trpR,367,545,0.5704761668210759,178,Unchanged,1000,5
slt,3688,5047,0.4525874308690885,1359,Upregulated,1000,5
ettA,10993,4743,-1.2127133793175484,-6250,Downregulated,1000,5
nadR,1902,2532,0.4127601585677778,630,Unchanged,1000,5
radA,2676,3891,0.5400628643313947,1215,Upregulated,1000,5
serB,1260,2385,0.920565532505595,1125,Upregulated,1000,5
ytjB,442,1204,1.4457171173682706,762,Unchanged,1000,5
lplA,857,2361,1.4620309321161429,1504,Upregulated,1000,5
yjjJ,688,2642,1.9411499965447296,1954,Upregulated,1000,5
deoD,7557,3615,-1.0638179756169173,-3942,Downregulated,1000,5
deoB,10766,7437,-0.5336896532115522,-3329,Downregulated,1000,5
deoA,4885,6684,0.4523531712054403,1799,Upregulated,1000,5
deoC,2561,3892,0.6038044571836431,1331,Upregulated,1000,5
yjjI,5004,5258,0.0714323524522261,254,Unchanged,1000,5
yjjW,1294,2319,0.841665202653496,1025,Upregulated,1000,5
yjjV,529,1681,1.6679800971221417,1152,Upregulated,1000,5
yjjU,1517,2120,0.48284317920352815,603,Unchanged,1000,5
osmY,3816,1635,-1.2227705356200667,-2181,Downregulated,1000,5
prfC,3488,3339,-0.06298394671381069,-149,Unchanged,1000,5
yjjG,1035,1347,0.3801190830756155,312,Unchanged,1000,5
rimI,804,829,0.04417660031682193,25,Unchanged,1000,5
holD,946,872,-0.11751204856246883,-74,Unchanged,1000,5
rsmC,1525,2059,0.4331345872946432,534,Unchanged,1000,5
fhuF,67,1197,4.15911824648573,1130,Upregulated,1000,5
bglJ,25,477,4.2539892662307865,452,Unchanged,1000,5
yjjQ,17,629,5.20945336562895,612,Unchanged,1000,5
yjjP,456,1375,1.5923258891346426,919,Unchanged,1000,5
yjjB,206,646,1.6488898275107065,440,Unchanged,1000,5
dnaT,209,718,1.7804809017421686,509,Unchanged,1000,5
dnaC,465,1575,1.7600492072792475,1110,Upregulated,1000,5
yjjA,498,897,0.8489622428511803,399,Unchanged,1000,5
opgB,2212,5627,1.3470145778228502,3415,Upregulated,1000,5
lgoD,25,2008,6.327687364176048,1983,Upregulated,1000,5
lgoR,244,1756,2.847339791972472,1512,Upregulated,1000,5
lgoT,158,3325,4.395357877098811,3167,Upregulated,1000,5
tsr,315,4676,3.8918511961443776,4361,Upregulated,1000,5
btsT,618,7336,3.5693148956906797,6718,Upregulated,1000,5
yjiX,29,104,1.84245872301352,75,Unchanged,1000,5
yjiA,1004,2341,1.2213656651612408,1337,Upregulated,1000,5
mrr,878,1767,1.0090091950162585,889,Unchanged,1000,5
hsdR,5342,8841,0.7268295852100465,3499,Upregulated,1000,5
hsdM,1239,2944,1.2486014839164112,1705,Upregulated,1000,5
hsdS,698,1184,0.7623701394192975,486,Unchanged,1000,5
symE,93,322,1.7917580670065856,229,Unchanged,1000,5
mcrB,870,1119,0.36312273024030334,249,Unchanged,1000,5
mcrC,279,477,0.773724144176324,198,Unchanged,1000,5
yjiT,3658,2524,-0.5353431647661675,-1134,Downregulated,1000,5
yjiS,2,38,4.247927513443585,36,Unchanged,1000,5
yjiR,298,2529,3.0851828012010767,2231,Upregulated,1000,5
mdtM,575,2213,1.944369589969274,1638,Upregulated,1000,5
yjiN,588,2484,2.078777113384117,1896,Upregulated,1000,5
yjiM,4315,3389,-0.34850092258232307,-926,Unchanged,1000,5
yjiL,1152,1680,0.5443205162238102,528,Unchanged,1000,5
yjiK,240,1022,2.090288885329103,782,Unchanged,1000,5
yjiJ,100,2147,4.424250286084049,2047,Upregulated,1000,5
kptA,173,822,2.2483663560449583,649,Unchanged,1000,5
yjiH,20255,4357,-2.2168710666586313,-15898,Downregulated,1000,5
yjiG,11863,2271,-2.3850692838713368,-9592,Downregulated,1000,5
iadA,53248,9915,-2.425042661024882,-43333,Downregulated,1000,5
hypT,7998,3191,-1.3256306725308171,-4807,Downregulated,1000,5
iraD,753,575,-0.3890879088401906,-178,Unchanged,1000,5
yjiC,34,450,3.7263183499666974,416,Unchanged,1000,5
uxuR,769,1481,0.9455161373270212,712,Unchanged,1000,5
uxuB,221,3413,3.9489221397074337,3192,Upregulated,1000,5
uxuA,200,2027,3.341274183692174,1827,Upregulated,1000,5
gntP,123,2064,4.068712750084014,1941,Upregulated,1000,5
fimH,225,1241,2.4635062089133197,1016,Upregulated,1000,5
fimG,119,676,2.5060616729742407,557,Unchanged,1000,5
fimF,73,604,3.0485801804450614,531,Unchanged,1000,5
fimD,455,3930,3.1105908620599103,3475,Upregulated,1000,5
fimC,251,746,1.5714882663044658,495,Unchanged,1000,5
fimI,604,797,0.4000311746653929,193,Unchanged,1000,5
fimA,5131,1171,-2.131498949690201,-3960,Downregulated,1000,5
fimE,36,611,4.085103568376417,575,Unchanged,1000,5
fimB,453,521,0.20177232223227326,68,Unchanged,1000,5
nanC,13,540,5.376375878909739,527,Unchanged,1000,5
nanM,473,1073,1.1817379874171268,600,Unchanged,1000,5
nanS,134,1239,3.2088712816828293,1105,Upregulated,1000,5
yjhR,61,1303,4.416884031005248,1242,Upregulated,1000,5
yjhQ,164,818,2.3184050283236655,654,Unchanged,1000,5
yjhP,281,1574,2.4857935052865603,1293,Upregulated,1000,5
sgcX,106,1900,4.163863248655111,1794,Upregulated,1000,5
sgcC,109,2384,4.450984195685235,2275,Upregulated,1000,5
sgcQ,91,1421,3.964896199044084,1330,Upregulated,1000,5
sgcA,87,645,2.890211854461888,558,Unchanged,1000,5
sgcE,126,1200,3.2515387669959646,1074,Upregulated,1000,5
sgcR,141,1365,3.275133883408421,1224,Upregulated,1000,5
yjhI,52,650,3.643856189774725,598,Unchanged,1000,5
yjhH,117,1553,3.7304773948038967,1436,Upregulated,1000,5
yjhG,585,4332,2.8885247131375604,3747,Upregulated,1000,5
yjhF,68,2459,5.176393178345743,2391,Upregulated,1000,5
yjhU,1749,2834,0.6963094689963659,1085,Upregulated,1000,5
insA7,35,295,3.0752881273042374,260,Unchanged,1000,5
fecI,59,1258,4.414273157517448,1199,Upregulated,1000,5
fecR,50,2024,5.339137384919585,1974,Upregulated,1000,5
fecA,161,6076,5.2379892763874665,5915,Upregulated,1000,5
fecB,171,2314,3.758320634221592,2143,Upregulated,1000,5
fecC,87,2035,4.547869583304881,1948,Upregulated,1000,5
fecD,71,1658,4.545481171991068,1587,Upregulated,1000,5
fecE,143,1471,3.3627101944764406,1328,Upregulated,1000,5
yjhV,7,388,5.792557920129523,381,Unchanged,1000,5
insI3,26,13,-1.0,-13,Unchanged,1000,5
yjhE,4,173,5.434628227636725,169,Unchanged,1000,5
yjhD,16,125,2.965784284662087,109,Unchanged,1000,5
nanY,303,814,1.425711000793296,511,Unchanged,1000,5
nanX,73,541,2.889660224946798,468,Unchanged,1000,5
insG,539,2030,1.9131225493200332,1491,Upregulated,1000,5
yjgZ,2,370,7.531381460516312,368,Unchanged,1000,5
insD6,314,333,0.08475761817963527,19,Unchanged,1000,5
insC6,297,262,-0.18089611926331556,-35,Unchanged,1000,5
intB,473,1343,1.5055472160880472,870,Unchanged,1000,5
ahr,1429,1372,-0.0587254349230041,-57,Unchanged,1000,5
idnK,61,375,2.620009447820357,314,Unchanged,1000,5
idnD,92,1218,3.7267364618493195,1126,Upregulated,1000,5
idnO,86,678,2.978876708434246,592,Unchanged,1000,5
idnT,135,1472,3.4467463590061818,1337,Upregulated,1000,5
idnR,316,1169,1.8872784663545534,853,Unchanged,1000,5
yjgR,999,2404,1.2668803129187671,1405,Upregulated,1000,5
lptG,1926,2552,0.4060206259214101,626,Unchanged,1000,5
lptF,1531,2441,0.6729980122813661,910,Unchanged,1000,5
pepA,14790,6269,-1.238314817550709,-8521,Downregulated,1000,5
holC,1329,781,-0.7669466511341951,-548,Unchanged,1000,5
valS,23802,10327,-1.204661592068277,-13475,Downregulated,1000,5
yjgN,38,420,3.466318004222537,382,Unchanged,1000,5
yjgM,397,541,0.4464895866838575,144,Unchanged,1000,5
rraB,3370,1086,-1.6337244882648594,-2284,Downregulated,1000,5
argI,736,3290,2.160309912565591,2554,Upregulated,1000,5
yjgL,292,252,-0.21254463538010074,-40,Unchanged,1000,5
tabA,1081,416,-1.377711089593558,-665,Unchanged,1000,5
bdcR,178,385,1.112981204615866,207,Unchanged,1000,5
bdcA,106,792,2.9014361655164103,686,Unchanged,1000,5
yjgH,120,294,1.292781749227846,174,Unchanged,1000,5
pyrL,186,20,-3.217230716220669,-166,Unchanged,1000,5
pyrB,140918,1708,-6.366404119239856,-139210,Downregulated,1000,5
pyrI,71072,608,-6.869066164103395,-70464,Downregulated,1000,5
ridA,34381,897,-5.26035971204243,-33484,Downregulated,1000,5
mgtA,1319,4158,1.6564451936068254,2839,Upregulated,1000,5
treR,678,1218,0.8451569547699884,540,Unchanged,1000,5
treB,191,2014,3.398419139971036,1823,Upregulated,1000,5
treC,173,2259,3.7068403277563595,2086,Upregulated,1000,5
nrdD,2249,4026,0.8400635111435228,1777,Upregulated,1000,5
nrdG,148,440,1.5719063478957098,292,Unchanged,1000,5
cybC,227,432,0.9283390148725535,205,Unchanged,1000,5
tldE,3937,2957,-0.41296246903871686,-980,Unchanged,1000,5
yjgA,957,820,-0.22289501498057954,-137,Unchanged,1000,5
mpl,4487,3051,-0.5564690040976888,-1436,Downregulated,1000,5
fbp,5724,2020,-1.5026683790875106,-3704,Downregulated,1000,5
yjfF,105,1226,3.5454977460246586,1121,Upregulated,1000,5
ytfT,94,1494,3.9903755811115995,1400,Upregulated,1000,5
ytfQ,214,1326,2.631398073711441,1112,Upregulated,1000,5
ppa,8657,1608,-2.4285997529658547,-7049,Downregulated,1000,5
chpB,91,412,2.178705886984522,321,Unchanged,1000,5
chpS,81,184,1.183711953172388,103,Unchanged,1000,5
ytfP,1536,413,-1.894964529301711,-1123,Downregulated,1000,5
tamB,4177,7508,0.8459615066680816,3331,Upregulated,1000,5
tamA,2349,3583,0.6091213301985393,1234,Upregulated,1000,5
msrA,1422,1071,-0.4089629848691594,-351,Unchanged,1000,5
ytfL,468,2004,2.0983020736118037,1536,Upregulated,1000,5
ytfK,137,44,-1.6386004643232295,-93,Unchanged,1000,5
ytfJ,73,630,3.1093834595072614,557,Unchanged,1000,5
ytfI,28,283,3.337303320774278,255,Unchanged,1000,5
cysQ,975,1065,0.12737930647622742,90,Unchanged,1000,5
cpdB,1721,2884,0.7448240672006189,1163,Upregulated,1000,5
ytfH,43,368,3.0972972013549147,325,Unchanged,1000,5
qorB,346,1323,1.934969118641952,977,Unchanged,1000,5
ytfF,77,1433,4.2180363535672445,1356,Upregulated,1000,5
ytfE,87,834,3.2609600775959353,747,Unchanged,1000,5
cycA,2479,2784,0.16740093976200615,305,Unchanged,1000,5
fklB,5501,1399,-1.9752979404805746,-4102,Downregulated,1000,5
ytfB,1143,1018,-0.16708784213878292,-125,Unchanged,1000,5
ytfA,5,159,4.990954860396993,154,Unchanged,1000,5
yjfZ,28,551,4.298553586513553,523,Unchanged,1000,5
rplI,15234,2078,-2.87402724146445,-13156,Downregulated,1000,5
rpsR,2683,578,-2.2147056567598424,-2105,Downregulated,1000,5
priB,5540,925,-2.582360705532876,-4615,Downregulated,1000,5
rpsF,13785,2732,-2.3350698786074626,-11053,Downregulated,1000,5
yjfY,23,146,2.666262602823004,123,Unchanged,1000,5
ulaF,109,1035,3.247230727609761,926,Unchanged,1000,5
ulaE,192,1468,2.9346737521220567,1276,Upregulated,1000,5
ulaD,166,1103,2.732177644244458,937,Unchanged,1000,5
ulaC,45,499,3.471042909007586,454,Unchanged,1000,5
ulaB,14,287,4.357552004618084,273,Unchanged,1000,5
ulaA,43,2279,5.727920454563199,2236,Upregulated,1000,5
ulaG,75,1749,4.543495883425772,1674,Upregulated,1000,5
ulaR,443,1254,1.5011587442470207,811,Unchanged,1000,5
yjfP,243,1078,2.1493289591467244,835,Unchanged,1000,5
bsmA,77,285,1.8880315683572026,208,Unchanged,1000,5
yjfN,41,141,1.78199934778071,100,Unchanged,1000,5
aidB,5102,2629,-0.9565487569844264,-2473,Downregulated,1000,5
yjfC,41,1601,5.287205587898173,1560,Upregulated,1000,5
yjfM,17,759,5.480493234165127,742,Unchanged,1000,5
yjfL,6,290,5.594946589293778,284,Unchanged,1000,5
yjfK,13,675,5.698303973797101,662,Unchanged,1000,5
yjfJ,41,1164,4.8273233382902,1123,Upregulated,1000,5
yjfI,12,106,3.142957953842043,94,Unchanged,1000,5
rlmB,1045,1441,0.46356739320650253,396,Unchanged,1000,5
rnr,10457,8416,-0.31326240762558943,-2041,Downregulated,1000,5
nsrR,295,477,0.6932743117563079,182,Unchanged,1000,5
purA,23089,18152,-0.3470771762571141,-4937,Downregulated,1000,5
yjeT,5,104,4.37851162325373,99,Unchanged,1000,5
hflC,6891,3677,-0.9061841808957836,-3214,Downregulated,1000,5
hflK,9808,6222,-0.6565805841563997,-3586,Downregulated,1000,5
hflX,7991,5306,-0.5907513788716409,-2685,Downregulated,1000,5
hfq,4476,1251,-1.839128246810574,-3225,Downregulated,1000,5
miaA,10145,7422,-0.45088895894649533,-2723,Downregulated,1000,5
mutL,2299,5565,1.2753752215111418,3266,Upregulated,1000,5
amiB,1778,3773,1.0854567759803395,1995,Upregulated,1000,5
tsaE,552,824,0.5779760704050493,272,Unchanged,1000,5
nnr,2667,4200,0.6551715030025589,1533,Upregulated,1000,5
queG,779,2929,1.9107129598176977,2150,Upregulated,1000,5
orn,1620,1054,-0.6201189461347726,-566,Unchanged,1000,5
rsgA,2150,2617,0.28357726457121224,467,Unchanged,1000,5
psd,3235,3212,-0.010293819362555372,-23,Unchanged,1000,5
mscM,1887,6836,1.857057974075694,4949,Upregulated,1000,5
yjeO,23,256,3.476438043942987,233,Unchanged,1000,5
yjeN,28,239,3.0935118859231445,211,Unchanged,1000,5
yjeM,151,1858,3.6211300470575742,1707,Upregulated,1000,5
epmA,421,1287,1.6121199151543057,866,Unchanged,1000,5
frdA,38764,8131,-2.253212748243349,-30633,Downregulated,1000,5
frdB,10822,2048,-2.4016795259824515,-8774,Downregulated,1000,5
frdC,4966,751,-2.725199448662569,-4215,Downregulated,1000,5
frdD,5398,836,-2.690850129385969,-4562,Downregulated,1000,5
ampC,749,1332,0.8305564586125112,583,Unchanged,1000,5
blc,259,528,1.0275858316718995,269,Unchanged,1000,5
gdx,132,288,1.1255308820838588,156,Unchanged,1000,5
efp,7060,1073,-2.7180181074020204,-5987,Downregulated,1000,5
epmB,1192,1594,0.41926739352831016,402,Unchanged,1000,5
yjeJ,98,792,3.014646775964401,694,Unchanged,1000,5
yjeI,2567,945,-1.4416970614669833,-1622,Downregulated,1000,5
groL,60572,25188,-1.2659144754207468,-35384,Downregulated,1000,5
groS,4494,1107,-2.0213449023983547,-3387,Downregulated,1000,5
yjeH,732,1696,1.2122206162791567,964,Unchanged,1000,5
fxsA,574,839,0.5476200737641356,265,Unchanged,1000,5
aspA,7847,3180,-1.3031144346913133,-4667,Downregulated,1000,5
dcuA,11019,3961,-1.4760566955481942,-7058,Downregulated,1000,5
cutA,328,248,-0.4033556942312085,-80,Unchanged,1000,5
dsbD,2441,2656,0.12178285156577087,215,Unchanged,1000,5
yjdC,1807,825,-1.1311304817314214,-982,Unchanged,1000,5
cadC,251,870,1.7933280367853186,619,Unchanged,1000,5
cadB,32,1087,5.086136225027309,1055,Upregulated,1000,5
cadA,78,2308,4.887025289783234,2230,Upregulated,1000,5
dtpC,250,1637,2.7110543218120666,1387,Upregulated,1000,5
lysU,3428,2158,-0.6676722446244828,-1270,Downregulated,1000,5
ghoS,46,65,0.4988058569714417,19,Unchanged,1000,5
yjdJ,160,156,-0.03652587602511404,-4,Unchanged,1000,5
yjdI,58,102,0.8144443468439234,44,Unchanged,1000,5
dcuS,1229,2441,0.9899873794084922,1212,Upregulated,1000,5
dcuR,766,929,0.2783342044576957,163,Unchanged,1000,5
dcuB,9416,4483,-1.070649820987756,-4933,Downregulated,1000,5
fumB,16430,6852,-1.2617354237534377,-9578,Downregulated,1000,5
yjdF,122,849,2.798883405990152,727,Unchanged,1000,5
melB,163,1347,3.0468059812312256,1184,Upregulated,1000,5
melA,196,1969,3.3285375517863454,1773,Upregulated,1000,5
melR,202,1317,2.7048281475047196,1115,Upregulated,1000,5
adiA,168,3617,4.428260459877014,3449,Upregulated,1000,5
adiY,269,467,0.7958163771530377,198,Unchanged,1000,5
adiC,127,1957,3.945743353854638,1830,Upregulated,1000,5
eptA,83,2242,4.755531131458502,2159,Upregulated,1000,5
basR,363,1064,1.551456697505439,701,Unchanged,1000,5
basS,231,1723,2.8989579448088905,1492,Upregulated,1000,5
proP,7138,11464,0.6835187082131229,4326,Upregulated,1000,5
rdcB,118,2059,4.125085065270413,1941,Upregulated,1000,5
rdcA,329,5157,3.970372556463976,4828,Upregulated,1000,5
yjdM,620,485,-0.3542834681997476,-135,Unchanged,1000,5
yjdN,279,1028,1.8815032373646905,749,Unchanged,1000,5
phnC,5,1596,8.318316841334983,1591,Upregulated,1000,5
phnD,10,2957,8.207990433232961,2947,Upregulated,1000,5
phnF,12,1817,7.242380203512959,1805,Upregulated,1000,5
phnG,4,1004,7.971543553950772,1000,Unchanged,1000,5
phnH,2,1362,9.411510988012072,1360,Upregulated,1000,5
phnI,4,2328,9.184875342908283,2324,Upregulated,1000,5
phnJ,12,2435,7.664743556248548,2423,Upregulated,1000,5
phnK,15,1614,6.749534267669262,1599,Upregulated,1000,5
phnL,40,2108,5.719731056749852,2068,Upregulated,1000,5
phnM,29,3408,6.876728625098266,3379,Upregulated,1000,5
phnN,33,1465,5.472290829951157,1432,Upregulated,1000,5
phnO,153,1071,2.807354922057604,918,Unchanged,1000,5
phnP,181,1876,3.373598225432171,1695,Upregulated,1000,5
rpiB,45,889,4.304186512500095,844,Unchanged,1000,5
alsR,590,1545,1.3888199785425335,955,Unchanged,1000,5
alsB,88,1801,4.355150847268979,1713,Upregulated,1000,5
alsA,24,2769,6.850186837645774,2745,Upregulated,1000,5
alsC,25,2036,6.34766565630097,2011,Upregulated,1000,5
alsE,43,1228,4.835830090668082,1185,Upregulated,1000,5
alsK,110,1821,4.0491554934521785,1711,Upregulated,1000,5
yjcS,27,3694,7.09608064881897,3667,Upregulated,1000,5
mdtN,13,1986,7.255210189387282,1973,Upregulated,1000,5
mdtO,55,4169,6.24412594328373,4114,Upregulated,1000,5
mdtP,42,3298,6.295058260658707,3256,Upregulated,1000,5
fdhF,4319,4771,0.14359436977728296,452,Unchanged,1000,5
yjcO,696,1490,1.0981531195007956,794,Unchanged,1000,5
gltP,6078,5245,-0.21265390205766438,-833,Unchanged,1000,5
nrfG,73,1005,3.7831552271862736,932,Unchanged,1000,5
nrfF,53,582,3.4569548883450847,529,Unchanged,1000,5
nrfE,331,3870,3.547430444224555,3539,Upregulated,1000,5
nrfD,2101,2167,0.04462299142062747,66,Unchanged,1000,5
nrfC,1432,1468,0.035820475578956346,36,Unchanged,1000,5
nrfB,1324,871,-0.604158498208353,-453,Unchanged,1000,5
nrfA,7611,3380,-1.1710627736155488,-4231,Downregulated,1000,5
acs,65,4302,6.0484239963946065,4237,Upregulated,1000,5
yjcH,5,271,5.760220946466509,266,Unchanged,1000,5
actP,86,3293,5.25892204189325,3207,Upregulated,1000,5
yjcF,11,168,3.932885804141463,157,Unchanged,1000,5
yjcE,1302,4311,1.7272931140128571,3009,Upregulated,1000,5
ghxP,2213,3334,0.5912506531854052,1121,Upregulated,1000,5
soxR,143,614,2.10222350859179,471,Unchanged,1000,5
soxS,84,345,2.038135128886771,261,Unchanged,1000,5
pdeC,217,2160,3.3152643646063513,1943,Upregulated,1000,5
yjcB,58,378,2.7042614290935005,320,Unchanged,1000,5
ssb,1912,1466,-0.3831974198469366,-446,Unchanged,1000,5
uvrA,5169,8394,0.6994732609398051,3225,Upregulated,1000,5
yjbR,2674,610,-2.132118317643104,-2064,Downregulated,1000,5
yjbQ,4184,979,-2.0955020866432466,-3205,Downregulated,1000,5
aphA,502,1096,1.1264885290097546,594,Unchanged,1000,5
tyrB,1916,2412,0.33213234616390447,496,Unchanged,1000,5
alr,2452,2474,0.012886521285588268,22,Unchanged,1000,5
dnaB,4407,3311,-0.41252988588043665,-1096,Downregulated,1000,5
qorA,3702,2050,-0.8526809854777657,-1652,Downregulated,1000,5
pspG,511,477,-0.09933402493210979,-34,Unchanged,1000,5
dusA,1120,1642,0.5519553948328383,522,Unchanged,1000,5
yjbM,14,219,3.967432137543569,205,Unchanged,1000,5
yjbL,3,4,0.41503749927884376,1,Unchanged,1000,5
zur,717,777,0.11594147970580533,60,Unchanged,1000,5
yjbJ,1018,58,-4.1335408509481235,-960,Unchanged,1000,5
dinF,680,1930,1.504994196017741,1250,Upregulated,1000,5
lexA,4786,1260,-1.92539666315122,-3526,Downregulated,1000,5
dgkA,506,514,0.02263097449956785,8,Unchanged,1000,5
plsB,7820,5034,-0.6354633910337353,-2786,Downregulated,1000,5
ubiA,776,1208,0.6384918971379513,432,Unchanged,1000,5
ubiC,444,734,0.7252203864931068,290,Unchanged,1000,5
yjbI,18,224,3.6374299206152916,206,Unchanged,1000,5
malM,606,1216,1.0047535299706345,610,Unchanged,1000,5
lamB,1703,1893,0.15259597602516287,190,Unchanged,1000,5
malK,892,1622,0.8626582042969683,730,Unchanged,1000,5
malE,3388,2359,-0.5222584560927361,-1029,Downregulated,1000,5
malF,1100,2518,1.1947747593069946,1418,Upregulated,1000,5
malG,644,1494,1.2140475546746203,850,Unchanged,1000,5
xylE,1738,4744,1.4486759277316035,3006,Upregulated,1000,5
psiE,269,421,0.6462140605097719,152,Unchanged,1000,5
yjbH,366,3374,3.2045444200035234,3008,Upregulated,1000,5
yjbG,73,1306,4.161114622666413,1233,Upregulated,1000,5
yjbF,90,934,3.3754256433799874,844,Unchanged,1000,5
yjbE,250,121,-1.0469210473874926,-129,Unchanged,1000,5
pgi,21407,9183,-1.2210451783558893,-12224,Downregulated,1000,5
lysC,6664,3490,-0.9331613642685329,-3174,Downregulated,1000,5
yjbD,238,190,-0.3249621549769956,-48,Unchanged,1000,5
rluF,494,1309,1.4058821503605632,815,Unchanged,1000,5
pepE,2509,1372,-0.8708319892363603,-1137,Downregulated,1000,5
yjbB,443,2954,2.737291222209771,2511,Upregulated,1000,5
metH,13700,9762,-0.4889272363415674,-3938,Downregulated,1000,5
iclR,1078,1486,0.4630769377860907,408,Unchanged,1000,5
arpA,24,1138,5.567322341585426,1114,Upregulated,1000,5
aceK,4932,4807,-0.03703599626494348,-125,Unchanged,1000,5
aceA,39373,30142,-0.38543149521528347,-9231,Downregulated,1000,5
aceB,48476,32756,-0.5655114666724081,-15720,Downregulated,1000,5
metA,6858,1375,-2.31835628563625,-5483,Downregulated,1000,5
yjaB,112,468,2.0630097975258006,356,Unchanged,1000,5
yjaA,13,288,4.46948528330122,275,Unchanged,1000,5
purH,11038,4174,-1.4029762850318608,-6864,Downregulated,1000,5
purD,6179,2666,-1.2126965930140288,-3513,Downregulated,1000,5
zraR,567,2598,2.1959807905056525,2031,Upregulated,1000,5
zraS,213,2435,3.5149964367438664,2222,Upregulated,1000,5
zraP,319,591,0.8896017064126631,272,Unchanged,1000,5
yjaH,570,1236,1.1166449188522707,666,Unchanged,1000,5
hupA,5686,487,-3.5454204215951854,-5199,Downregulated,1000,5
yjaG,1224,1253,0.033782856629208644,29,Unchanged,1000,5
nfi,1213,1625,0.42186016768266893,412,Unchanged,1000,5
hemE,3464,2625,-0.40012150728587764,-839,Unchanged,1000,5
nudC,1125,1230,0.12873331412220274,105,Unchanged,1000,5
rsd,379,476,0.32876372513685176,97,Unchanged,1000,5
thiC,591,3711,2.6505779655199935,3120,Upregulated,1000,5
thiE,139,918,2.7234092706903006,779,Unchanged,1000,5
thiF,187,906,2.276472780158598,719,Unchanged,1000,5
thiG,156,1144,2.8744691179161412,988,Unchanged,1000,5
thiH,228,1708,2.9052022454557487,1480,Upregulated,1000,5
yjaZ,84,404,2.2658940599730344,320,Unchanged,1000,5
rpoC,116263,31573,-1.880628786716989,-84690,Downregulated,1000,5
rpoB,100349,30032,-1.7404537796026385,-70317,Downregulated,1000,5
rplL,47998,10674,-2.1688733758491825,-37324,Downregulated,1000,5
rplJ,38001,8268,-2.2004270898396565,-29733,Downregulated,1000,5
rplA,44628,10175,-2.132920359292172,-34453,Downregulated,1000,5
rplK,16587,2793,-2.5701654987930755,-13794,Downregulated,1000,5
nusG,7247,1625,-2.156944176181562,-5622,Downregulated,1000,5
secE,4402,956,-2.203076621910809,-3446,Downregulated,1000,5
tufB,124091,9085,-3.771768159629583,-115006,Downregulated,1000,5
coaA,1280,570,-1.1671099858352583,-710,Unchanged,1000,5
birA,972,1054,0.11684664803143371,82,Unchanged,1000,5
murB,1710,1051,-0.7022336558110819,-659,Unchanged,1000,5
murI,1263,1275,0.01364260795866807,12,Unchanged,1000,5
btuB,5171,2278,-1.1826755577752772,-2893,Downregulated,1000,5
trmA,2850,1745,-0.7077348828424518,-1105,Downregulated,1000,5
yijD,1185,541,-1.1311865599588062,-644,Unchanged,1000,5
fabR,1822,1364,-0.41767931477787823,-458,Unchanged,1000,5
sthA,1523,3118,1.0337049862104926,1595,Upregulated,1000,5
oxyR,3882,2868,-0.436755094011759,-1014,Downregulated,1000,5
argH,2694,6244,1.2127206865156057,3550,Upregulated,1000,5
argB,873,2858,1.7109523574663763,1985,Upregulated,1000,5
argC,1060,4182,1.9801287971390178,3122,Upregulated,1000,5
argE,1712,2751,0.6842734379150636,1039,Upregulated,1000,5
ppc,57960,21570,-1.4260314183964753,-36390,Downregulated,1000,5
eptC,2362,2543,0.10652249729294909,181,Unchanged,1000,5
yijO,313,1320,2.0763033673131974,1007,Upregulated,1000,5
frwD,15,370,4.624490864907794,355,Unchanged,1000,5
pflC,71,1403,4.3045521741152175,1332,Upregulated,1000,5
pflD,215,3525,4.0352146925840575,3310,Upregulated,1000,5
frwB,15,292,4.282933963271499,277,Unchanged,1000,5
frwC,24,1926,6.3264294871223035,1902,Upregulated,1000,5
ptsA,64,5236,6.354249381945241,5172,Upregulated,1000,5
fsaB,58,1113,4.262256882214388,1055,Upregulated,1000,5
gldA,4373,3057,-0.5165067961942377,-1316,Downregulated,1000,5
yijF,41,1245,4.924378022337359,1204,Upregulated,1000,5
yijE,232,2071,3.15813084309294,1839,Upregulated,1000,5
katG,12988,8272,-0.6508711989711533,-4716,Downregulated,1000,5
metF,9695,1797,-2.431650489484213,-7898,Downregulated,1000,5
metL,6845,6356,-0.10693141679674281,-489,Unchanged,1000,5
metB,3035,2976,-0.028321990035013005,-59,Unchanged,1000,5
metJ,1479,629,-1.2334901302197785,-850,Unchanged,1000,5
yiiX,291,1184,2.024578022720666,893,Unchanged,1000,5
rpmE,2756,248,-3.474163862317416,-2508,Downregulated,1000,5
priA,1969,5388,1.4522867395607493,3419,Upregulated,1000,5
cytR,1719,2338,0.4437053850535952,619,Unchanged,1000,5
ftsN,3531,2793,-0.33826124747965053,-738,Unchanged,1000,5
hslV,1400,1369,-0.03230438057442922,-31,Unchanged,1000,5
hslU,6710,4604,-0.5434249329553156,-2106,Downregulated,1000,5
menA,336,1485,2.143929792909368,1149,Upregulated,1000,5
rraA,3976,1609,-1.30515343083884,-2367,Downregulated,1000,5
zapB,2193,353,-2.6351657234024133,-1840,Downregulated,1000,5
glpF,859,2218,1.3685293290232465,1359,Upregulated,1000,5
glpK,3569,5846,0.71192992775703,2277,Upregulated,1000,5
glpX,1094,1723,0.6553099634323917,629,Unchanged,1000,5
fpr,1073,1284,0.2589951263657812,211,Unchanged,1000,5
uspD,2255,405,-2.4771336203707564,-1850,Downregulated,1000,5
yiiS,752,232,-1.6966078565500653,-520,Unchanged,1000,5
yiiR,154,406,1.3985493764902748,252,Unchanged,1000,5
yiiQ,930,718,-0.3732468721723423,-212,Unchanged,1000,5
tpiA,23875,4031,-2.566291044846756,-19844,Downregulated,1000,5
cdh,263,737,1.4866018198027673,474,Unchanged,1000,5
sbp,188,1385,2.8810814092589134,1197,Upregulated,1000,5
pfkA,23466,6406,-1.873076238679418,-17060,Downregulated,1000,5
fieF,1262,1614,0.3549286682952314,352,Unchanged,1000,5
cpxR,3536,1738,-1.0246901925770315,-1798,Downregulated,1000,5
cpxA,5040,3645,-0.4675049191729794,-1395,Downregulated,1000,5
yiiM,550,882,0.6813470371454985,332,Unchanged,1000,5
kdgT,125,1308,3.3873625408359955,1183,Upregulated,1000,5
sodA,141,699,2.3095972929766426,558,Unchanged,1000,5
rhaT,82,1367,4.059245522987976,1285,Upregulated,1000,5
rhaR,66,853,3.6920078119598365,787,Unchanged,1000,5
rhaS,56,951,4.085946608802959,895,Unchanged,1000,5
rhaB,29,1677,5.853685978436774,1648,Upregulated,1000,5
rhaA,52,1817,5.1269029860930235,1765,Upregulated,1000,5
rhaD,20,1098,5.778734244117836,1078,Upregulated,1000,5
rhaM,6,192,5.0,186,Unchanged,1000,5
frvA,4,396,6.6293566200796095,392,Unchanged,1000,5
frvB,43,1811,5.39630607624807,1768,Upregulated,1000,5
frvX,155,1366,3.139617363015853,1211,Upregulated,1000,5
frvR,66,1954,4.887820632609932,1888,Upregulated,1000,5
yiiG,38,1003,4.7221783771685955,965,Unchanged,1000,5
fdhD,786,1084,0.4637635390952651,298,Unchanged,1000,5
fdoG,2541,8206,1.6912827788391802,5665,Upregulated,1000,5
fdoH,474,1652,1.8012547225211863,1178,Upregulated,1000,5
fdoI,222,822,1.888578717331577,600,Unchanged,1000,5
fdhE,1278,1682,0.3962898693081497,404,Unchanged,1000,5
yiiF,26,65,1.3219280948873624,39,Unchanged,1000,5
yiiE,2,97,5.599912842187128,95,Unchanged,1000,5
fabY,2113,1982,-0.09233580474845246,-131,Unchanged,1000,5
dtd,706,729,0.046250631055756906,23,Unchanged,1000,5
yihY,840,1367,0.7025520099399374,527,Unchanged,1000,5
yihX,974,1073,0.13965639867417973,99,Unchanged,1000,5
csqR,594,1412,1.2492052524704145,818,Unchanged,1000,5
yihV,218,1613,2.887346398378716,1395,Upregulated,1000,5
yihU,85,1370,4.010569241710187,1285,Upregulated,1000,5
yihT,130,1527,3.5541165337683966,1397,Upregulated,1000,5
yihS,193,1833,3.2475340332718052,1640,Upregulated,1000,5
yihR,26,1212,5.542734265331859,1186,Upregulated,1000,5
yihQ,73,2759,5.240105182473256,2686,Upregulated,1000,5
yihP,59,1762,4.900355159558573,1703,Upregulated,1000,5
yihO,49,1320,4.751612370130608,1271,Upregulated,1000,5
ompL,23,310,3.7525624492172245,287,Unchanged,1000,5
yihN,30,1034,5.107129874706416,1004,Upregulated,1000,5
yihM,202,784,1.9564983613634135,582,Unchanged,1000,5
yihL,123,686,2.479550260833572,563,Unchanged,1000,5
bipA,15404,6513,-1.241910896460685,-8891,Downregulated,1000,5
glnA,37650,4026,-3.2252307875253132,-33624,Downregulated,1000,5
glnL,2170,1207,-0.8462693665768202,-963,Unchanged,1000,5
glnG,2812,1939,-0.5362837909657429,-873,Unchanged,1000,5
hemN,3168,2152,-0.5578942575229855,-1016,Downregulated,1000,5
yihI,1747,591,-1.563649572739227,-1156,Downregulated,1000,5
yihA,1405,982,-0.5167752007935955,-423,Unchanged,1000,5
spf,1,1,0.0,0,Unchanged,1000,5
polA,6942,4346,-0.6756631906473631,-2596,Downregulated,1000,5
yihG,94,663,2.81827620843495,569,Unchanged,1000,5
yihF,73,909,3.6383119253140896,836,Unchanged,1000,5
dsbA,3208,1199,-1.4198424830406966,-2009,Downregulated,1000,5
srkA,1460,1400,-0.060541541935050854,-60,Unchanged,1000,5
yihD,1200,263,-2.1898997012035784,-937,Unchanged,1000,5
mobA,482,536,0.15319985422781088,54,Unchanged,1000,5
mobB,199,411,1.046369963138034,212,Unchanged,1000,5
hemG,824,961,0.22189209359053216,137,Unchanged,1000,5
trkH,2179,2871,0.39788713409127496,692,Unchanged,1000,5
yigZ,910,988,0.11864449649861893,78,Unchanged,1000,5
pepQ,7192,4804,-0.5821568698088132,-2388,Downregulated,1000,5
fadB,83,4238,5.674128441025245,4155,Upregulated,1000,5
fadA,113,1989,4.137648598418556,1876,Upregulated,1000,5
fre,2208,2326,0.07511092469504942,118,Unchanged,1000,5
ubiD,3612,3922,0.11879164271129077,310,Unchanged,1000,5
rfaH,413,538,0.38146439113717884,125,Unchanged,1000,5
tatC,2151,1476,-0.5433148033626648,-675,Unchanged,1000,5
tatB,2415,1601,-0.5930498812068785,-814,Unchanged,1000,5
tatA,1202,482,-1.318331844481224,-720,Unchanged,1000,5
ubiB,2176,2923,0.4257712725557133,747,Unchanged,1000,5
ubiJ,1465,1552,0.08322789287751733,87,Unchanged,1000,5
ubiE,2522,1969,-0.3571051644266662,-553,Unchanged,1000,5
rmuC,764,2777,1.8618826337830974,2013,Upregulated,1000,5
udp,4338,3195,-0.44121412183791714,-1143,Downregulated,1000,5
ysgA,990,1785,0.85042364394949,795,Unchanged,1000,5
metE,151815,8934,-4.086864277642487,-142881,Downregulated,1000,5
metR,1649,1797,0.12399901007247463,148,Unchanged,1000,5
bioP,168,1461,3.120423040024738,1293,Upregulated,1000,5
yigL,1041,1303,0.3238670152687173,262,Unchanged,1000,5
pldB,1659,1719,0.05125565852219775,60,Unchanged,1000,5
rhtB,317,927,1.5480864984861236,610,Unchanged,1000,5
rhtC,1200,1291,0.1054545948113099,91,Unchanged,1000,5
recQ,2236,4352,0.9607583684071493,2116,Upregulated,1000,5
pldA,1157,1401,0.2760680913233281,244,Unchanged,1000,5
yigI,35,564,4.010268335453827,529,Unchanged,1000,5
rarD,35,1308,5.223863808553117,1273,Upregulated,1000,5
yigG,19,41,1.1096244911744981,22,Unchanged,1000,5
yigF,51,39,-0.38702312310924736,-12,Unchanged,1000,5
corA,1730,1625,-0.09033231972090777,-105,Unchanged,1000,5
uvrD,4390,4846,0.1425734650286259,456,Unchanged,1000,5
yigB,1270,1401,0.14162845877128982,131,Unchanged,1000,5
xerC,1449,1497,0.04701662650148736,48,Unchanged,1000,5
yigA,1139,1302,0.19296170145752364,163,Unchanged,1000,5
dapF,2502,1799,-0.4758866029143375,-703,Unchanged,1000,5
cyaY,526,360,-0.5470658929626278,-166,Unchanged,1000,5
cyaA,19913,8497,-1.228685117159587,-11416,Downregulated,1000,5
hemC,4656,3040,-0.6150197345773359,-1616,Downregulated,1000,5
hemD,2000,1464,-0.4500844463780446,-536,Unchanged,1000,5
hemX,3758,2514,-0.5799804169995477,-1244,Downregulated,1000,5
hemY,3585,2489,-0.5264068886082314,-1096,Downregulated,1000,5
aslA,190,1831,3.268560467466389,1641,Upregulated,1000,5
aslB,67,1339,4.320851054866538,1272,Upregulated,1000,5
yifK,1189,1944,0.7092795038601252,755,Unchanged,1000,5
rffM,364,754,1.0506260730699681,390,Unchanged,1000,5
wzyE,423,1677,1.9871531204443966,1254,Upregulated,1000,5
wzxE,861,1705,0.9856865965146908,844,Unchanged,1000,5
wecE,1198,1202,0.004808987922399752,4,Unchanged,1000,5
rffC,535,801,0.5822633511202008,266,Unchanged,1000,5
rffH,1371,1245,-0.1390828288237825,-126,Unchanged,1000,5
rffG,1148,1197,0.06030051026781422,49,Unchanged,1000,5
wecC,1649,1850,0.1659338719662074,201,Unchanged,1000,5
wecB,1558,1501,-0.05377125644098082,-57,Unchanged,1000,5
wzzE,1756,1541,-0.1884259830205729,-215,Unchanged,1000,5
rfe,2529,1782,-0.5050697001413166,-747,Unchanged,1000,5
rho,16327,6259,-1.3832556462639225,-10068,Downregulated,1000,5
trxA,4974,1611,-1.6264500135103377,-3363,Downregulated,1000,5
rhlB,9617,4307,-1.1589035953510602,-5310,Downregulated,1000,5
gpp,4838,3572,-0.437678688858702,-1266,Downregulated,1000,5
rep,2378,3712,0.6424479953819163,1334,Upregulated,1000,5
yifN,148,317,1.0988856645104577,169,Unchanged,1000,5
ppiC,458,285,-0.68438567904484,-173,Unchanged,1000,5
ilvC,6527,7258,0.15315201751530103,731,Unchanged,1000,5
ilvY,298,1789,2.5857691515897465,1491,Upregulated,1000,5
ilvA,2139,6251,1.5471505200137825,4112,Upregulated,1000,5
ilvD,2843,7254,1.3513626462927524,4411,Upregulated,1000,5
ilvE,2849,3534,0.31084641822776565,685,Unchanged,1000,5
ilvM,57,152,1.4150374992788437,95,Unchanged,1000,5
ilvL,5,1,-2.321928094887362,-4,Unchanged,1000,5
yifB,119,1868,3.9724609764017185,1749,Upregulated,1000,5
maoP,2495,247,-3.336456868639945,-2248,Downregulated,1000,5
yieP,1498,800,-0.9049657186840264,-698,Unchanged,1000,5
hsrA,532,1203,1.177138491674887,671,Unchanged,1000,5
rbsR,261,826,1.6620919748495608,565,Unchanged,1000,5
rbsK,955,894,-0.09522590173979334,-61,Unchanged,1000,5
rbsB,965,1040,0.10798268087301181,75,Unchanged,1000,5
rbsC,372,847,1.1870593482241671,475,Unchanged,1000,5
rbsA,354,1341,1.9214879718214766,987,Unchanged,1000,5
rbsD,178,276,0.6327910258117713,98,Unchanged,1000,5
kup,1100,2089,0.9253089686550864,989,Unchanged,1000,5
ravA,3473,2132,-0.7039749726229158,-1341,Downregulated,1000,5
viaA,1679,1845,0.13601858601072842,166,Unchanged,1000,5
asnA,9999,1668,-2.583664529386741,-8331,Downregulated,1000,5
asnC,246,265,0.10733404411132155,19,Unchanged,1000,5
mioC,1426,709,-1.008116449204372,-717,Unchanged,1000,5
mnmG,5984,3809,-0.6516978873242968,-2175,Downregulated,1000,5
rsmG,492,515,0.0659141167313407,23,Unchanged,1000,5
atpI,2245,1032,-1.121272474205255,-1213,Downregulated,1000,5
atpB,9110,2765,-1.7201715735673437,-6345,Downregulated,1000,5
atpE,5496,1686,-1.7047774678760177,-3810,Downregulated,1000,5
atpF,13857,5874,-1.2381997812453418,-7983,Downregulated,1000,5
atpH,7853,2508,-1.6467065489612145,-5345,Downregulated,1000,5
atpA,51387,15621,-1.7179166167467441,-35766,Downregulated,1000,5
atpG,16560,4776,-1.7938279311218825,-11784,Downregulated,1000,5
atpD,33969,10488,-1.6954791572393584,-23481,Downregulated,1000,5
atpC,6559,1406,-2.2218792806442558,-5153,Downregulated,1000,5
glmU,7570,2271,-1.7369655941662063,-5299,Downregulated,1000,5
glmS,12007,3506,-1.7759778313677734,-8501,Downregulated,1000,5
pstS,1038,2492,1.2634976246661211,1454,Upregulated,1000,5
pstC,536,1468,1.4535470623854403,932,Unchanged,1000,5
pstA,473,1526,1.6898428734951354,1053,Upregulated,1000,5
pstB,650,1187,0.8688083117260899,537,Unchanged,1000,5
phoU,715,840,0.23244608600037084,125,Unchanged,1000,5
bglG,5,424,6.405992359675837,419,Unchanged,1000,5
bglF,59,1846,4.967543788283933,1787,Upregulated,1000,5
bglB,45,1355,4.9122240399115595,1310,Upregulated,1000,5
bglH,41,1037,4.660648174195142,996,Unchanged,1000,5
yieL,57,1066,4.225101708594434,1009,Upregulated,1000,5
yieK,52,704,3.758991900496205,652,Unchanged,1000,5
cbrC,123,406,1.7228214118459364,283,Unchanged,1000,5
cbrB,41,199,2.279072615925565,158,Unchanged,1000,5
yieH,349,562,0.6873430940112738,213,Unchanged,1000,5
adeP,3864,2057,-0.9095533003108393,-1807,Downregulated,1000,5
yieF,2244,796,-1.495232340065144,-1448,Downregulated,1000,5
yieE,1616,1097,-0.5588636723486019,-519,Unchanged,1000,5
yidZ,274,1110,2.0183118782769416,836,Unchanged,1000,5
mdtL,89,1617,4.183370532507264,1528,Upregulated,1000,5
tnaB,83,1333,4.005421633742048,1250,Upregulated,1000,5
tnaA,470,1770,1.9130166984053603,1300,Upregulated,1000,5
tnaC,1,1,0.0,0,Unchanged,1000,5
mnmE,1854,3190,0.7829151800267009,1336,Upregulated,1000,5
yidC,10512,5470,-0.9424244426424108,-5042,Downregulated,1000,5
rnpA,2093,1162,-0.8489622428511804,-931,Unchanged,1000,5
rpmH,189,26,-2.8618027060799807,-163,Unchanged,1000,5
dnaA,5764,6098,0.08126581483500073,334,Unchanged,1000,5
dnaN,3270,3696,0.17667412103061272,426,Unchanged,1000,5
recF,909,2547,1.4864467600800875,1638,Upregulated,1000,5
gyrB,7976,8286,0.05501041058101118,310,Unchanged,1000,5
yidB,364,505,0.4723449374404608,141,Unchanged,1000,5
yidA,1879,1853,-0.020102185392789726,-26,Unchanged,1000,5
yidX,161,616,1.9358696625802845,455,Unchanged,1000,5
dgoK,141,1492,3.4034804678564443,1351,Upregulated,1000,5
dgoT,128,2796,4.449148645375437,2668,Upregulated,1000,5
cbrA,60,1845,4.94251450533924,1785,Upregulated,1000,5
yidR,743,2342,1.656306959962619,1599,Upregulated,1000,5
yidQ,507,566,0.15881630582854173,59,Unchanged,1000,5
ibpA,1901,1915,0.010585860163767334,14,Unchanged,1000,5
ibpB,1602,1879,0.2300909190113455,277,Unchanged,1000,5
yidE,1562,3542,1.181169758609935,1980,Upregulated,1000,5
yidP,33,1110,5.0719498418790145,1077,Upregulated,1000,5
glvC,49,3064,5.966490737809749,3015,Upregulated,1000,5
yidL,84,792,3.237039197300849,708,Unchanged,1000,5
yidK,33,3442,6.70463726268175,3409,Upregulated,1000,5
yidJ,85,2930,5.1072940131719085,2845,Upregulated,1000,5
yidI,157,881,2.4883774600287865,724,Unchanged,1000,5
yidH,104,569,2.4518451241654895,465,Unchanged,1000,5
yidG,69,634,3.199814573361238,565,Unchanged,1000,5
yidF,118,977,3.049571702606544,859,Unchanged,1000,5
emrD,362,2620,2.8555052093416076,2258,Upregulated,1000,5
ivbL,2,1,-1.0,-1,Unchanged,1000,5
ilvB,2579,4890,0.923022692050382,2311,Upregulated,1000,5
ilvN,261,440,0.7534537169547751,179,Unchanged,1000,5
uhpA,1530,1855,0.2778875339281514,325,Unchanged,1000,5
uhpB,725,3971,2.4534494606221715,3246,Upregulated,1000,5
uhpC,293,2916,3.3150181499046893,2623,Upregulated,1000,5
uhpT,121,2792,4.528219988935057,2671,Upregulated,1000,5
adeD,284,3768,3.729836130108101,3484,Upregulated,1000,5
adeQ,29,2189,6.238075244053374,2160,Upregulated,1000,5
yicN,133,757,2.508867054484542,624,Unchanged,1000,5
nepI,74,2570,5.1180992784522905,2496,Upregulated,1000,5
nlpA,741,1189,0.682203267439822,448,Unchanged,1000,5
yicL,776,1500,0.9508339431961156,724,Unchanged,1000,5
setC,33,1329,5.3317312699177215,1296,Upregulated,1000,5
yicJ,417,2121,2.3466253320858916,1704,Upregulated,1000,5
yicI,1128,3650,1.6941293962559485,2522,Upregulated,1000,5
yicH,2902,3471,0.25830384576190163,569,Unchanged,1000,5
xanP,2237,4150,0.8915460800625307,1913,Upregulated,1000,5
gltS,1632,2468,0.5967013371779223,836,Unchanged,1000,5
recG,2589,3699,0.514740335223884,1110,Upregulated,1000,5
trmH,1288,1093,-0.23683919244271237,-195,Unchanged,1000,5
spoT,8066,4697,-0.7801138121480885,-3369,Downregulated,1000,5
rpoZ,1832,499,-1.8763077827596835,-1333,Downregulated,1000,5
gmk,1941,875,-1.1494451959939727,-1066,Downregulated,1000,5
ligB,164,2345,3.837820202784655,2181,Upregulated,1000,5
yicG,59,579,3.294776488627395,520,Unchanged,1000,5
dinD,187,612,1.7104933828050153,425,Unchanged,1000,5
yicC,2695,1634,-0.7218772894941843,-1061,Downregulated,1000,5
rph,1482,1167,-0.3447408865984856,-315,Unchanged,1000,5
pyrE,218,712,1.7075491061894714,494,Unchanged,1000,5
slmA,1552,783,-0.9870443448960871,-769,Unchanged,1000,5
dut,2074,802,-1.3707417523583054,-1272,Downregulated,1000,5
dfp,1410,2259,0.6799891081069284,849,Unchanged,1000,5
yicR,125,535,2.097610796626422,410,Unchanged,1000,5
rpmB,4413,578,-2.9326183494753075,-3835,Downregulated,1000,5
rpmG,394,33,-3.5776577000979226,-361,Unchanged,1000,5
mutM,346,964,1.4782611085932371,618,Unchanged,1000,5
coaD,486,455,-0.09508976851972227,-31,Unchanged,1000,5
waaA,1954,1881,-0.0549306184451902,-73,Unchanged,1000,5
waaQ,1321,1036,-0.3506064635602737,-285,Unchanged,1000,5
waaG,1122,1171,0.06166839989242229,49,Unchanged,1000,5
waaP,522,600,0.2009126939259963,78,Unchanged,1000,5
waaS,596,124,-2.2649722100752863,-472,Unchanged,1000,5
waaB,819,655,-0.3223685452161959,-164,Unchanged,1000,5
waaO,758,478,-0.6651872301903431,-280,Unchanged,1000,5
waaJ,573,241,-1.2495019925269433,-332,Unchanged,1000,5
waaY,324,199,-0.703225382340976,-125,Unchanged,1000,5
waaZ,462,191,-1.2743202133803089,-271,Unchanged,1000,5
waaU,601,230,-1.3857311297668102,-371,Unchanged,1000,5
waaL,965,267,-1.8536892004678887,-698,Unchanged,1000,5
waaC,1000,1429,0.5150059164337295,429,Unchanged,1000,5
waaF,2318,1918,-0.273277845988341,-400,Unchanged,1000,5
rfaD,5066,2415,-1.0688238879893655,-2651,Downregulated,1000,5
htrL,436,534,0.29251160691062766,98,Unchanged,1000,5
kbl,2767,2368,-0.2246535629810049,-399,Unchanged,1000,5
tdh,2485,1837,-0.43589422533829897,-648,Unchanged,1000,5
waaH,48,1252,4.705056346211462,1204,Upregulated,1000,5
yibQ,874,1777,1.02373849652808,903,Unchanged,1000,5
envC,2596,2798,0.10810557916561489,202,Unchanged,1000,5
gpmM,25148,9653,-1.3813943842068739,-15495,Downregulated,1000,5
yibN,1884,721,-1.3857278003719606,-1163,Downregulated,1000,5
grxC,501,377,-0.4102460799265441,-124,Unchanged,1000,5
secB,4683,1272,-1.8803343674147095,-3411,Downregulated,1000,5
gpsA,6796,3582,-0.9239205151982594,-3214,Downregulated,1000,5
cysE,2197,2354,0.09957945061516768,157,Unchanged,1000,5
trmL,404,793,0.9729655729521837,389,Unchanged,1000,5
lldD,149,2275,3.9324823095112595,2126,Upregulated,1000,5
lldR,36,1328,5.205114429904612,1292,Upregulated,1000,5
lldP,71,2903,5.35358173712198,2832,Upregulated,1000,5
yibL,587,565,-0.05510963580750217,-22,Unchanged,1000,5
mtlR,485,1057,1.123918724308193,572,Unchanged,1000,5
mtlD,2605,3431,0.39734575339178413,826,Unchanged,1000,5
mtlA,2167,4386,1.0172066585799198,2219,Upregulated,1000,5
yibI,10,368,5.20163386116965,358,Unchanged,1000,5
yibH,98,2041,4.380350622917511,1943,Upregulated,1000,5
yibG,16,49,1.6147098441152081,33,Unchanged,1000,5
yibJ,130,1063,3.03155806850265,933,Unchanged,1000,5
yibA,450,424,-0.08586073665383794,-26,Unchanged,1000,5
rhsA,366,10019,4.774751061072336,9653,Upregulated,1000,5
yibF,208,1199,2.5271762252731316,991,Unchanged,1000,5
selA,1966,3509,0.835796626061586,1543,Upregulated,1000,5
selB,3610,4915,0.4451925794534096,1305,Upregulated,1000,5
yiaY,28,1916,6.096526923678576,1888,Upregulated,1000,5
aldB,438,3256,2.8940979246650738,2818,Upregulated,1000,5
yiaW,9,268,4.89616418901546,259,Unchanged,1000,5
yiaV,35,2012,5.845131572860561,1977,Upregulated,1000,5
yiaU,248,1570,2.6623525333921143,1322,Upregulated,1000,5
yiaT,41,1021,4.638215146259718,980,Unchanged,1000,5
sgbE,76,1240,4.028196891830652,1164,Upregulated,1000,5
sgbU,34,1839,5.7572429231615985,1805,Upregulated,1000,5
sgbH,30,1274,5.408258966647782,1244,Upregulated,1000,5
lyxK,57,3738,6.035160839580416,3681,Upregulated,1000,5
yiaO,19,1897,6.64157644996789,1878,Upregulated,1000,5
yiaN,5,1823,8.510170751151772,1818,Upregulated,1000,5
yiaM,4,369,6.527477006060396,365,Unchanged,1000,5
yiaL,4,501,6.968666793195208,497,Unchanged,1000,5
yiaK,31,1747,5.816467582529884,1716,Upregulated,1000,5
plaR,1332,1498,0.1694435413874888,166,Unchanged,1000,5
ysaA,128,592,2.2094533656289497,464,Unchanged,1000,5
avtA,4799,3973,-0.27250501962809504,-826,Unchanged,1000,5
malS,638,3422,2.423211430724544,2784,Upregulated,1000,5
bax,3282,3500,0.09277968320597837,218,Unchanged,1000,5
xylR,869,1948,1.1645655952679421,1079,Upregulated,1000,5
xylH,947,2923,1.6260134983376677,1976,Upregulated,1000,5
xylG,1210,3135,1.3734583955274444,1925,Upregulated,1000,5
xylF,2117,3345,0.659984941521234,1228,Upregulated,1000,5
xylA,13390,26193,0.9680253467260126,12803,Upregulated,1000,5
xylB,2209,6519,1.5612572565471643,4310,Upregulated,1000,5
yiaB,29,203,2.807354922057604,174,Unchanged,1000,5
yiaA,38,225,2.5658536777734517,187,Unchanged,1000,5
wecH,152,1242,3.0305219447768956,1090,Upregulated,1000,5
glyQ,3658,2820,-0.37535991246256056,-838,Unchanged,1000,5
glyS,11607,7367,-0.6558459868776659,-4240,Downregulated,1000,5
insK,34,542,3.994686200103532,508,Unchanged,1000,5
insJ,54,442,3.033015057227963,388,Unchanged,1000,5
cspA,215,104,-1.0477531314483681,-111,Unchanged,1000,5
yiaG,504,202,-1.3190684407481217,-302,Unchanged,1000,5
yiaF,4325,1494,-1.5335199846222123,-2831,Downregulated,1000,5
ghrB,4650,2724,-0.7715040128706849,-1926,Downregulated,1000,5
yiaD,712,957,0.4266416835196278,245,Unchanged,1000,5
bisC,2467,4695,0.9283674422410138,2228,Upregulated,1000,5
yiaC,184,610,1.7291034763932356,426,Unchanged,1000,5
tag,423,891,1.074767768401972,468,Unchanged,1000,5
yhjY,306,945,1.6267826764157833,639,Unchanged,1000,5
yhjX,239,2161,3.1766165488787586,1922,Upregulated,1000,5
eptB,570,3013,2.4021668485423593,2443,Upregulated,1000,5
dppA,43323,15745,-1.4602393916424727,-27578,Downregulated,1000,5
dppB,4233,3361,-0.33278994601041856,-872,Unchanged,1000,5
dppC,3717,2966,-0.32562009040712725,-751,Unchanged,1000,5
dppD,4792,3524,-0.44341398386837216,-1268,Downregulated,1000,5
dppF,5587,3683,-0.6011924230542905,-1904,Downregulated,1000,5
yhjV,149,2135,3.8408518340456914,1986,Upregulated,1000,5
bcsG,551,3352,2.604897925128194,2801,Upregulated,1000,5
bcsF,22,87,1.983511877211431,65,Unchanged,1000,5
bcsE,1412,3250,1.2026996295319987,1838,Upregulated,1000,5
yhjR,8,50,2.643856189774725,42,Unchanged,1000,5
bcsQ,98,1274,3.700439718141092,1176,Upregulated,1000,5
bcsA,220,6265,4.831739080684563,6045,Upregulated,1000,5
bcsB,286,5746,4.328470940754134,5460,Upregulated,1000,5
bcsZ,122,2522,4.369615222765334,2400,Upregulated,1000,5
bcsC,901,9157,3.3452760114038442,8256,Upregulated,1000,5
pdeK,1176,4903,2.0597767014493207,3727,Upregulated,1000,5
dctA,854,3817,2.1601312115950675,2963,Upregulated,1000,5
yhjJ,1582,3047,0.9456399002136937,1465,Upregulated,1000,5
kdgK,2716,2589,-0.06908851434462052,-127,Unchanged,1000,5
pdeH,154,1466,3.2508828474389104,1312,Upregulated,1000,5
yhjG,561,4057,2.85434062659748,3496,Upregulated,1000,5
yhjE,679,3384,2.3172460888752178,2705,Upregulated,1000,5
yhjD,1063,1813,0.7702373282130534,750,Unchanged,1000,5
rcdB,615,1504,1.2901462514510351,889,Unchanged,1000,5
yhjB,72,636,3.142957953842043,564,Unchanged,1000,5
treF,1655,3234,0.9664884617790815,1579,Upregulated,1000,5
ccp,626,2106,1.7502708740930986,1480,Upregulated,1000,5
gadA,84374,2314,-5.188337728783573,-82060,Downregulated,1000,5
gadX,7380,635,-3.5387923192882305,-6745,Downregulated,1000,5
gadW,1920,597,-1.6853034743437136,-1323,Downregulated,1000,5
mdtF,23634,5264,-2.1666324285999576,-18370,Downregulated,1000,5
mdtE,10863,1846,-2.5569481245515595,-9017,Downregulated,1000,5
gadE,8655,52,-7.378878386112909,-8603,Downregulated,1000,5
hdeD,19860,681,-4.866067014403665,-19179,Downregulated,1000,5
hdeA,47430,300,-7.304693557471008,-47130,Downregulated,1000,5
hdeB,21226,176,-6.914113284587107,-21050,Downregulated,1000,5
yhiD,1758,442,-1.9918167957519726,-1316,Downregulated,1000,5
dctR,778,294,-1.4039540001498274,-484,Unchanged,1000,5
slp,18758,480,-5.288327798153594,-18278,Downregulated,1000,5
insH11,2861,6302,1.1392902566943568,3441,Upregulated,1000,5
yhiS,30,1163,5.276744785864699,1133,Upregulated,1000,5
arsC,73,546,2.9029325820398353,473,Unchanged,1000,5
arsB,114,2219,4.28280393803227,2105,Upregulated,1000,5
arsR,52,495,3.25084499682588,443,Unchanged,1000,5
gor,3774,2762,-0.4503811033423945,-1012,Downregulated,1000,5
rlmJ,707,1402,0.9877042292012244,695,Unchanged,1000,5
prlC,5483,5545,0.01622198675227321,62,Unchanged,1000,5
rsmJ,413,1425,1.786748232520021,1012,Upregulated,1000,5
dtpB,380,2238,2.5581387126454462,1858,Upregulated,1000,5
uspA,13688,2505,-2.4500291564068424,-11183,Downregulated,1000,5
uspB,357,352,-0.020348645391802367,-5,Unchanged,1000,5
pitA,5346,3507,-0.6082224069902658,-1839,Downregulated,1000,5
yhiN,643,2561,1.993816610269521,1918,Upregulated,1000,5
yhiM,3659,1478,-1.3078031461929363,-2181,Downregulated,1000,5
yhiJ,177,922,2.3810173903463405,745,Unchanged,1000,5
yhiI,3338,4509,0.433823555274922,1171,Upregulated,1000,5
rbbA,5282,9113,0.7868417659846224,3831,Upregulated,1000,5
yhhJ,1056,3283,1.6364049152145272,2227,Upregulated,1000,5
yhhI,45,1287,4.837943241891027,1242,Upregulated,1000,5
yhhH,12,43,1.8413022539809418,31,Unchanged,1000,5
rhsB,323,9201,4.832184597294251,8878,Upregulated,1000,5
nikR,249,865,1.7965543904560062,616,Unchanged,1000,5
nikE,172,2038,3.566673581463716,1866,Upregulated,1000,5
nikD,159,1933,3.6037429669268803,1774,Upregulated,1000,5
nikC,118,2243,4.248570855724431,2125,Upregulated,1000,5
nikB,152,2281,3.907523217868552,2129,Upregulated,1000,5
nikA,585,4397,2.9100110027418804,3812,Upregulated,1000,5
acpT,303,1152,1.9267510179693614,849,Unchanged,1000,5
yhhT,245,2363,3.269765974971276,2118,Upregulated,1000,5
yhhS,753,3765,2.321928094887362,3012,Upregulated,1000,5
dcrB,2236,1765,-0.3412520046846474,-471,Unchanged,1000,5
yhhQ,321,1525,2.248164040215308,1204,Upregulated,1000,5
tusA,421,386,-0.12521938579831574,-35,Unchanged,1000,5
zntA,3321,8642,1.3797475080870254,5321,Upregulated,1000,5
yhhN,1888,1916,0.021238796374339088,28,Unchanged,1000,5
yhhM,339,570,0.7496766459157601,231,Unchanged,1000,5
yhhL,50,302,2.594548549550354,252,Unchanged,1000,5
rsmD,412,1156,1.4884251553174606,744,Unchanged,1000,5
ftsY,2698,5500,1.0275412703511169,2802,Upregulated,1000,5
ftsE,1354,2543,0.9093037231151095,1189,Upregulated,1000,5
ftsX,2279,3607,0.6623984985222731,1328,Upregulated,1000,5
rpoH,8677,7277,-0.2538525184568444,-1400,Downregulated,1000,5
livJ,931,5040,2.436570660828485,4109,Upregulated,1000,5
panZ,261,666,1.3514723705013778,405,Unchanged,1000,5
livK,1281,3323,1.375215817350385,2042,Upregulated,1000,5
livH,460,2082,2.178264302355042,1622,Upregulated,1000,5
livM,750,3537,2.2375637183176758,2787,Upregulated,1000,5
livG,384,1971,2.3597495603223297,1587,Upregulated,1000,5
livF,367,1917,2.3849983688249377,1550,Upregulated,1000,5
ugpB,66,3358,5.668992395578576,3292,Upregulated,1000,5
ugpA,14,1800,7.006426269159433,1786,Upregulated,1000,5
ugpE,16,1914,6.902375114486025,1898,Upregulated,1000,5
ugpC,224,3157,3.816983623255381,2933,Upregulated,1000,5
ugpQ,405,1696,2.0661423567912123,1291,Upregulated,1000,5
yhhA,691,681,-0.02103091237618736,-10,Unchanged,1000,5
ggt,726,4134,2.5094969354296968,3408,Upregulated,1000,5
yrhB,29,196,2.756728848987636,167,Unchanged,1000,5
insB6,27,582,4.429987840744816,555,Unchanged,1000,5
insA6,19,138,2.8605969433345835,119,Unchanged,1000,5
yrhA,64,1403,4.454299293619899,1339,Upregulated,1000,5
yhhZ,7,378,5.754887502163468,371,Unchanged,1000,5
yhhY,429,721,0.7490216117412769,292,Unchanged,1000,5
yhhX,2696,2337,-0.20616276239903314,-359,Unchanged,1000,5
yhhW,680,1364,1.0042369928864707,684,Unchanged,1000,5
gntR,1344,2156,0.6818240399737453,812,Unchanged,1000,5
gntK,215,998,2.2147031557478,783,Unchanged,1000,5
yhgN,306,1086,1.8274205451117096,780,Unchanged,1000,5
asd,23151,4703,-2.299421274271237,-18448,Downregulated,1000,5
glgB,28851,8488,-1.7651247633993101,-20363,Downregulated,1000,5
glgX,13428,6106,-1.13694494749077,-7322,Downregulated,1000,5
glgC,8727,4002,-1.1247646299157215,-4725,Downregulated,1000,5
glgA,10568,4664,-1.1800626780463312,-5904,Downregulated,1000,5
glgP,16457,6670,-1.3029426996386781,-9787,Downregulated,1000,5
yzgL,47,115,1.2909011992667379,68,Unchanged,1000,5
glpD,30707,17890,-0.7794141839751701,-12817,Downregulated,1000,5
glpE,324,612,0.9175378398080271,288,Unchanged,1000,5
glpG,1232,2371,0.9444934067871066,1139,Upregulated,1000,5
glpR,657,2284,1.7975973750405132,1627,Upregulated,1000,5
rtcR,143,4617,5.0128686802709765,4474,Upregulated,1000,5
rtcB,370,3291,3.152928850608037,2921,Upregulated,1000,5
malT,10083,14588,0.5328571563069545,4505,Upregulated,1000,5
malP,5521,6437,0.22145886771777157,916,Unchanged,1000,5
malQ,4684,5326,0.18531135270939908,642,Unchanged,1000,5
gntT,1015,3421,1.7529383766953612,2406,Upregulated,1000,5
nfuA,2759,1924,-0.520036657583231,-835,Unchanged,1000,5
yhgH,629,1596,1.3433287293430567,967,Unchanged,1000,5
bioH,668,1764,1.4009305530834684,1096,Upregulated,1000,5
rpnA,177,1433,3.0172173441791483,1256,Upregulated,1000,5
feoC,56,215,1.9408379275318561,159,Unchanged,1000,5
feoB,2414,5919,1.2939277806896936,3505,Upregulated,1000,5
feoA,72,142,0.9798221180623697,70,Unchanged,1000,5
yhgF,6540,7440,0.18601198560994894,900,Unchanged,1000,5
greB,449,909,1.01756484945296,460,Unchanged,1000,5
ompR,1923,2016,0.06813687616001932,93,Unchanged,1000,5
envZ,1475,3630,1.299254593746547,2155,Upregulated,1000,5
pck,8165,6843,-0.25482393841576373,-1322,Downregulated,1000,5
yhgE,711,2977,2.065937756618621,2266,Upregulated,1000,5
hslO,1596,2535,0.667525095668357,939,Unchanged,1000,5
hslR,435,945,1.1192989283723445,510,Unchanged,1000,5
yrfG,707,1153,0.705610392842373,446,Unchanged,1000,5
igaA,1772,5675,1.6792417885106214,3903,Upregulated,1000,5
nudE,580,1060,0.8699394594356271,480,Unchanged,1000,5
mrcA,1704,6041,1.8258620510107209,4337,Upregulated,1000,5
hofM,105,1517,3.852759852580911,1412,Upregulated,1000,5
hofN,39,875,4.487736987857443,836,Unchanged,1000,5
hofO,34,698,4.359620384959313,664,Unchanged,1000,5
hofP,36,553,3.9412106687923947,517,Unchanged,1000,5
hofQ,161,2253,3.806714720120811,2092,Upregulated,1000,5
aroK,3467,1619,-1.0985848509002676,-1848,Downregulated,1000,5
aroB,5938,3294,-0.8501365382603008,-2644,Downregulated,1000,5
damX,6548,4044,-0.6952713245711387,-2504,Downregulated,1000,5
dam,905,1159,0.3568908690359041,254,Unchanged,1000,5
rpe,2973,1410,-1.0762243006214884,-1563,Downregulated,1000,5
gph,2327,1466,-0.6665861072715368,-861,Unchanged,1000,5
trpS,5478,2391,-1.1960351359937502,-3087,Downregulated,1000,5
yhfZ,213,1677,2.976957353338508,1464,Upregulated,1000,5
yhfY,42,335,2.9956998625663744,293,Unchanged,1000,5
yhfX,59,2288,5.277228287416548,2229,Upregulated,1000,5
yhfW,50,2553,5.674121632632394,2503,Upregulated,1000,5
php,52,1707,5.036807624886646,1655,Upregulated,1000,5
yhfU,23,377,4.034858757211651,354,Unchanged,1000,5
yhfT,140,3035,4.438197784198078,2895,Upregulated,1000,5
yhfS,110,2446,4.474848975002727,2336,Upregulated,1000,5
frlR,517,1397,1.4340958350945283,880,Unchanged,1000,5
frlD,136,1943,3.8366073443350053,1807,Upregulated,1000,5
frlB,61,1723,4.819969648662062,1662,Upregulated,1000,5
frlA,19,2478,7.027032958697016,2459,Upregulated,1000,5
yhfL,5,10,1.0,5,Unchanged,1000,5
cysG,1554,2510,0.6917008604304243,956,Unchanged,1000,5
nirC,657,1034,0.6542709099926051,377,Unchanged,1000,5
nirD,656,394,-0.7355001851617075,-262,Unchanged,1000,5
nirB,10239,5867,-0.8033799231486566,-4372,Downregulated,1000,5
tsgA,224,1621,2.8553134534599374,1397,Upregulated,1000,5
ppiA,1448,1023,-0.5012554573378766,-425,Unchanged,1000,5
yhfG,38,34,-0.1604646721932461,-4,Unchanged,1000,5
fic,842,660,-0.3513542088205804,-182,Unchanged,1000,5
pabA,146,719,2.300023401559281,573,Unchanged,1000,5
argD,1848,6525,1.8200131449285517,4677,Upregulated,1000,5
yhfK,1403,2709,0.9492453845821154,1306,Upregulated,1000,5
crp,6168,1746,-1.8207492062855943,-4422,Downregulated,1000,5
yhfA,1356,527,-1.3634823114991292,-829,Unchanged,1000,5
prkB,1319,1280,-0.043300754364182376,-39,Unchanged,1000,5
yheU,93,68,-0.45169596985769195,-25,Unchanged,1000,5
yheT,1403,1497,0.0935592124385177,94,Unchanged,1000,5
yheS,3561,3585,0.009690683226204215,24,Unchanged,1000,5
kefG,71,510,2.844606317354176,439,Unchanged,1000,5
kefB,229,2317,3.338838540767878,2088,Upregulated,1000,5
slyD,10267,2496,-2.040324850873917,-7771,Downregulated,1000,5
slyX,499,96,-2.3779335046161045,-403,Unchanged,1000,5
fkpA,5129,1554,-1.7226910675696074,-3575,Downregulated,1000,5
yheO,2832,1316,-1.1056617763477559,-1516,Downregulated,1000,5
tusD,1063,721,-0.5600704322902822,-342,Unchanged,1000,5
tusC,439,369,-0.250600123474962,-70,Unchanged,1000,5
tusB,318,223,-0.5119830553640508,-95,Unchanged,1000,5
rpsL,12880,2267,-2.5062762972611936,-10613,Downregulated,1000,5
rpsG,40203,8973,-2.16364084490506,-31230,Downregulated,1000,5
fusA,259693,76012,-1.772508027192603,-183681,Downregulated,1000,5
tufA,160805,46439,-1.79190345454288,-114366,Downregulated,1000,5
chiA,831,2716,1.7085630974743873,1885,Upregulated,1000,5
bfd,22,34,0.6280312226130421,12,Unchanged,1000,5
bfr,3471,318,-3.4482526945442906,-3153,Downregulated,1000,5
gspO,53,459,3.1144298888506086,406,Unchanged,1000,5
gspM,31,274,3.1438357725736514,243,Unchanged,1000,5
gspL,78,964,3.6274871173677132,886,Unchanged,1000,5
gspK,37,703,4.247927513443585,666,Unchanged,1000,5
gspJ,16,389,4.603626344986192,373,Unchanged,1000,5
gspI,9,213,4.564784618783526,204,Unchanged,1000,5
gspH,16,345,4.430452551665532,329,Unchanged,1000,5
gspG,8,222,4.794415866350106,214,Unchanged,1000,5
gspF,51,1045,4.356861884996749,994,Unchanged,1000,5
gspE,44,1138,4.692853223669284,1094,Upregulated,1000,5
gspD,161,1577,3.2920500666758934,1416,Upregulated,1000,5
gspC,25,343,3.7782085763980877,318,Unchanged,1000,5
gspA,50,1087,4.442280035252584,1037,Upregulated,1000,5
gspB,54,179,1.728928275100788,125,Unchanged,1000,5
rpsJ,10057,3779,-1.4121235901216238,-6278,Downregulated,1000,5
rplC,42078,15345,-1.455297488040335,-26733,Downregulated,1000,5
rplD,31887,10386,-1.618328241472831,-21501,Downregulated,1000,5
rplW,8356,3575,-1.224869250513994,-4781,Downregulated,1000,5
rplB,39272,12341,-1.6700417699882626,-26931,Downregulated,1000,5
rpsS,11292,3428,-1.7198620193371932,-7864,Downregulated,1000,5
rplV,5558,1516,-1.8742960810294704,-4042,Downregulated,1000,5
rpsC,44308,14383,-1.6232025832147647,-29925,Downregulated,1000,5
rplP,22826,6892,-1.7276834589420342,-15934,Downregulated,1000,5
rpmC,3854,1490,-1.3710442409461971,-2364,Downregulated,1000,5
rpsQ,9771,1997,-2.2906718876730867,-7774,Downregulated,1000,5
rplN,31865,7634,-2.061461569083948,-24231,Downregulated,1000,5
rplX,12642,2961,-2.0940683243609084,-9681,Downregulated,1000,5
rplE,55153,19803,-1.4777203582025369,-35350,Downregulated,1000,5
rpsN,16351,6471,-1.337318288921691,-9880,Downregulated,1000,5
rpsH,20946,9110,-1.2011518035844966,-11836,Downregulated,1000,5
rplF,39469,15343,-1.3631393680768504,-24126,Downregulated,1000,5
rplR,16562,6565,-1.3350099846171433,-9997,Downregulated,1000,5
rpsE,31390,10710,-1.5513465488318592,-20680,Downregulated,1000,5
rpmD,1969,803,-1.2939912183842393,-1166,Downregulated,1000,5
rplO,38072,15326,-1.3127491487962615,-22746,Downregulated,1000,5
secY,81723,25549,-1.677475340973498,-56174,Downregulated,1000,5
rpmJ,14,8,-0.8073549220576042,-6,Unchanged,1000,5
rpsM,22470,6025,-1.8989669780625833,-16445,Downregulated,1000,5
rpsK,20635,6328,-1.705271933421605,-14307,Downregulated,1000,5
rpsD,39080,11165,-1.8074472161459116,-27915,Downregulated,1000,5
rpoA,81897,23791,-1.783394691518744,-58106,Downregulated,1000,5
rplQ,10483,1884,-2.476180772934456,-8599,Downregulated,1000,5
yhdN,514,336,-0.6133071264151178,-178,Unchanged,1000,5
zntR,422,374,-0.1742047288195484,-48,Unchanged,1000,5
mscL,1527,334,-2.192780054322799,-1193,Downregulated,1000,5
trkA,1754,1350,-0.3776893405065398,-404,Unchanged,1000,5
rsmB,1846,1650,-0.16193652851259613,-196,Unchanged,1000,5
fmt,2838,1732,-0.7124356593338266,-1106,Downregulated,1000,5
def,1586,634,-1.322838025564571,-952,Unchanged,1000,5
smg,2402,915,-1.3923925025342294,-1487,Downregulated,1000,5
yrdD,1185,647,-0.8730494417931141,-538,Unchanged,1000,5
tsaC,588,550,-0.09638453642434239,-38,Unchanged,1000,5
aroE,882,771,-0.19404779564248634,-111,Unchanged,1000,5
yrdB,113,102,-0.1477536204436922,-11,Unchanged,1000,5
yrdA,1919,639,-1.586466875248386,-1280,Downregulated,1000,5
yhdZ,82,517,2.6564684656968507,435,Unchanged,1000,5
yhdY,42,886,4.398845465776258,844,Unchanged,1000,5
yhdX,40,807,4.334496768390418,767,Unchanged,1000,5
yhdW,87,801,3.202714936559982,714,Unchanged,1000,5
yhdV,77,61,-0.33604920313201503,-16,Unchanged,1000,5
acrF,280,3050,3.4453105103926442,2770,Upregulated,1000,5
acrE,8,1076,7.071462362556624,1068,Upregulated,1000,5
envR,6,359,5.902877533101895,353,Unchanged,1000,5
yhdU,6,13,1.1154772174199359,7,Unchanged,1000,5
yhdJ,87,856,3.2985234905524186,769,Unchanged,1000,5
fis,2042,284,-2.8460200313731194,-1758,Downregulated,1000,5
dusB,5968,1842,-1.6959744741639022,-4126,Downregulated,1000,5
prmA,614,1175,0.9363501960821826,561,Unchanged,1000,5
panF,300,1753,2.5467915902636573,1453,Upregulated,1000,5
yhdT,35,112,1.6780719051126378,77,Unchanged,1000,5
accC,15629,4037,-1.9528699805079672,-11592,Downregulated,1000,5
accB,4322,1068,-2.0167874251719535,-3254,Downregulated,1000,5
yhdH,1520,1361,-0.1594042568269532,-159,Unchanged,1000,5
csrD,2543,2901,0.19001883350789106,358,Unchanged,1000,5
mreB,10632,4009,-1.4070986871254039,-6623,Downregulated,1000,5
mreC,2373,1876,-0.33905227267857135,-497,Unchanged,1000,5
mreD,621,560,-0.14916644127551495,-61,Unchanged,1000,5
yhdE,929,892,-0.05863488646234817,-37,Unchanged,1000,5
rng,2994,2528,-0.2440777578813138,-466,Unchanged,1000,5
tldD,3850,2725,-0.4986022159179751,-1125,Downregulated,1000,5
aaeR,571,1150,1.0100712104688947,579,Unchanged,1000,5
aaeX,7,59,3.0752881273042374,52,Unchanged,1000,5
aaeA,88,979,3.4757334309663976,891,Unchanged,1000,5
aaeB,184,2827,3.9414942117741627,2643,Upregulated,1000,5
yhcO,68,108,0.667424660913129,40,Unchanged,1000,5
yhcN,39,171,2.1324502960236495,132,Unchanged,1000,5
argR,2895,1486,-0.9621292323380028,-1409,Downregulated,1000,5
mdh,52912,3353,-3.9800705623973305,-49559,Downregulated,1000,5
degS,984,1573,0.6767884500764468,589,Unchanged,1000,5
degQ,1658,2030,0.2920357205767883,372,Unchanged,1000,5
yhcB,3230,1259,-1.3592558818622706,-1971,Downregulated,1000,5
zapE,1290,1824,0.4997346638541252,534,Unchanged,1000,5
rplM,14631,2459,-2.5728847381609414,-12172,Downregulated,1000,5
rpsI,24032,3493,-2.7824181701194073,-20539,Downregulated,1000,5
sspA,7161,3029,-1.2413194890075603,-4132,Downregulated,1000,5
sspB,3922,1919,-1.0312348239967688,-2003,Downregulated,1000,5
dcuD,47,1991,5.404688654042865,1944,Upregulated,1000,5
nanR,1477,1729,0.2272680428774925,252,Unchanged,1000,5
nanA,112,1531,3.7729036454421836,1419,Upregulated,1000,5
nanT,149,3044,4.3525841230413835,2895,Upregulated,1000,5
nanE,107,1248,3.5439352324611013,1141,Upregulated,1000,5
nanK,343,1588,2.2109304309701456,1245,Upregulated,1000,5
yhcH,175,441,1.3334237337251917,266,Unchanged,1000,5
yhcG,71,1640,4.529732980000764,1569,Upregulated,1000,5
yhcF,131,553,2.0777126686972567,422,Unchanged,1000,5
insH10,4199,3723,-0.17358017198350417,-476,Unchanged,1000,5
yhcD,160,2481,3.9547779250050685,2321,Upregulated,1000,5
yhcA,21,409,4.2836396101629886,388,Unchanged,1000,5
gltF,128,612,2.2573878426926517,484,Unchanged,1000,5
gltD,13762,7198,-0.9350221414734571,-6564,Downregulated,1000,5
gltB,43846,23742,-0.885003762782498,-20104,Downregulated,1000,5
yhcC,678,1574,1.2150783623711425,896,Unchanged,1000,5
arcB,2328,4031,0.7920467249427957,1703,Upregulated,1000,5
elbB,1816,1414,-0.36098208248151614,-402,Unchanged,1000,5
mtgA,490,1060,1.113210610447991,570,Unchanged,1000,5
yrbL,13706,5128,-1.418339425042558,-8578,Downregulated,1000,5
npr,157,161,0.03629612922298996,4,Unchanged,1000,5
rapZ,4030,2115,-0.9301221754080176,-1915,Downregulated,1000,5
ptsN,2341,1144,-1.0330378823336233,-1197,Downregulated,1000,5
hpf,2711,892,-1.6037094979174071,-1819,Downregulated,1000,5
rpoN,7574,5098,-0.5711240478622175,-2476,Downregulated,1000,5
lptB,2771,1705,-0.7006349715698823,-1066,Downregulated,1000,5
lptA,2797,1472,-0.9261025824191789,-1325,Downregulated,1000,5
lptC,1520,1064,-0.5145731728297583,-456,Unchanged,1000,5
kdsC,1998,1443,-0.46948528330122025,-555,Unchanged,1000,5
kdsD,2932,2230,-0.39484139332614476,-702,Unchanged,1000,5
yrbG,1016,1370,0.43127549107572327,354,Unchanged,1000,5
mlaF,2567,2111,-0.2821567172282624,-456,Unchanged,1000,5
mlaE,2524,2167,-0.22001275688887545,-357,Unchanged,1000,5
mlaD,1460,1055,-0.4687253701728321,-405,Unchanged,1000,5
mlaC,3345,1922,-0.7993978747550728,-1423,Downregulated,1000,5
mlaB,737,497,-0.5684187675327834,-240,Unchanged,1000,5
ibaG,791,237,-1.7387906355745328,-554,Unchanged,1000,5
murA,4837,2509,-0.94700006703669,-2328,Downregulated,1000,5
sfsB,58,246,2.0845335102116676,188,Unchanged,1000,5
ispB,3351,1721,-0.9613445891642675,-1630,Downregulated,1000,5
rplU,8615,2069,-2.057917151252301,-6546,Downregulated,1000,5
rpmA,5837,1321,-2.1435966016354113,-4516,Downregulated,1000,5
yhbE,700,1310,0.9041399845924838,610,Unchanged,1000,5
obgE,1606,3346,1.0589655525210382,1740,Upregulated,1000,5
dacB,1392,1814,0.3820152446797941,422,Unchanged,1000,5
greA,624,583,-0.0980501456617519,-41,Unchanged,1000,5
yhbY,719,377,-0.9314272471706336,-342,Unchanged,1000,5
rlmE,3352,2370,-0.5001350899137301,-982,Unchanged,1000,5
ftsH,20778,14521,-0.5169159842939776,-6257,Downregulated,1000,5
folP,2274,1280,-0.8290884440048853,-994,Unchanged,1000,5
glmM,6991,3076,-1.1844433316791783,-3915,Downregulated,1000,5
secG,4618,641,-2.848871911155374,-3977,Downregulated,1000,5
yhbX,129,1075,3.0588936890535687,946,Unchanged,1000,5
argG,3641,5672,0.6395227917950013,2031,Upregulated,1000,5
rimP,2598,1236,-1.0717226875435064,-1362,Downregulated,1000,5
nusA,11192,7760,-0.5283393100902632,-3432,Downregulated,1000,5
infB,31405,17363,-0.8549780294361183,-14042,Downregulated,1000,5
rbfA,1438,1041,-0.46609360713988074,-397,Unchanged,1000,5
truB,2889,2497,-0.21037438263640323,-392,Unchanged,1000,5
rpsO,5789,553,-3.387962770994172,-5236,Downregulated,1000,5
pnp,29966,11315,-1.4050899345052204,-18651,Downregulated,1000,5
nlpI,9908,3930,-1.334064556100394,-5978,Downregulated,1000,5
deaD,5729,8287,0.5325665844045654,2558,Upregulated,1000,5
mtr,727,2577,1.8256652679400254,1850,Upregulated,1000,5
yhbW,269,1946,2.8548336322244876,1677,Upregulated,1000,5
ubiV,1423,1744,0.2934643782504439,321,Unchanged,1000,5
ubiU,1769,2243,0.34249557239581396,474,Unchanged,1000,5
ubiT,3518,1679,-1.0671532525349308,-1839,Downregulated,1000,5
yhbS,2449,1725,-0.5055964120110843,-724,Unchanged,1000,5
yhbQ,85,508,2.579293750634464,423,Unchanged,1000,5
yhbP,213,737,1.7908111888692315,524,Unchanged,1000,5
yhbO,578,736,0.34863627355633403,158,Unchanged,1000,5
yraR,222,1063,2.259510015180999,841,Unchanged,1000,5
yraQ,471,2233,2.2451842862096902,1762,Upregulated,1000,5
yraP,1666,1291,-0.36789940005835703,-375,Unchanged,1000,5
diaA,1427,1028,-0.4731450702818853,-399,Unchanged,1000,5
yraN,346,640,0.8872998672506377,294,Unchanged,1000,5
lpoA,3959,5243,0.40525647848625845,1284,Upregulated,1000,5
rsmI,692,1425,1.0421179763027415,733,Unchanged,1000,5
yraK,109,1207,3.469025635978095,1098,Upregulated,1000,5
yraJ,163,3021,4.212082314496864,2858,Upregulated,1000,5
yraI,12,449,5.225609134019991,437,Unchanged,1000,5
yraH,59,597,3.3389440719029637,538,Unchanged,1000,5
agaI,21,875,5.380821783940931,854,Unchanged,1000,5
agaD,18,995,5.788627713988699,977,Unchanged,1000,5
agaC,9,770,6.4187896341399515,761,Unchanged,1000,5
agaB,10,321,5.004501392234941,311,Unchanged,1000,5
kbaY,11,1421,7.013259220605483,1410,Upregulated,1000,5
agaS,19,1984,6.70626879694329,1965,Upregulated,1000,5
agaA,67,841,3.6498727997973717,774,Unchanged,1000,5
agaW,26,328,3.6571122864769916,302,Unchanged,1000,5
agaV,32,553,4.111135670234707,521,Unchanged,1000,5
kbaZ,38,2119,5.801240358928585,2081,Upregulated,1000,5
agaR,1420,1559,0.13472999830574028,139,Unchanged,1000,5
yhaV,555,633,0.18971772819087288,78,Unchanged,1000,5
prlF,314,392,0.32008909522358114,78,Unchanged,1000,5
garD,643,2624,2.0288770772901366,1981,Upregulated,1000,5
garP,21,2163,6.6865005271832185,2142,Upregulated,1000,5
garL,42,927,4.464108105846771,885,Unchanged,1000,5
garR,216,1252,2.53513134476915,1036,Upregulated,1000,5
garK,299,1832,2.615202113898839,1533,Upregulated,1000,5
rnpB,949408,275071,-1.7872241582140715,-674337,Downregulated,1000,5
yhaC,11,117,3.4109331009461075,106,Unchanged,1000,5
yhaB,7,86,3.6189098326444937,79,Unchanged,1000,5
tdcR,2,15,2.9068905956085187,13,Unchanged,1000,5
tdcA,40,605,3.9188632372745946,565,Unchanged,1000,5
tdcB,36,1199,5.057690941971911,1163,Upregulated,1000,5
tdcC,202,1948,3.2695664793305474,1746,Upregulated,1000,5
tdcD,57,1434,4.6529392945371635,1377,Upregulated,1000,5
tdcE,222,3579,4.010924962066278,3357,Upregulated,1000,5
tdcF,30,425,3.8244284354165456,395,Unchanged,1000,5
cyuP,131,1930,3.8809621306179922,1799,Upregulated,1000,5
yhaL,111,66,-0.7500217469916525,-45,Unchanged,1000,5
yhaK,139,1084,2.963207968630364,945,Unchanged,1000,5
yhaJ,943,1548,0.7150757954693138,605,Unchanged,1000,5
yhaI,16,271,4.082149041353872,255,Unchanged,1000,5
yhaH,548,468,-0.22766736337712226,-80,Unchanged,1000,5
yqjG,576,1330,1.2072855289462394,754,Unchanged,1000,5
yqjF,83,468,2.49532528823648,385,Unchanged,1000,5
yqjK,5091,625,-3.02602097071437,-4466,Downregulated,1000,5
yqjE,7344,706,-3.3788259701426275,-6638,Downregulated,1000,5
yqjD,3018,458,-2.7201733024297394,-2560,Downregulated,1000,5
yqjC,2697,650,-2.0528438983197868,-2047,Downregulated,1000,5
mzrA,327,492,0.5893676798411575,165,Unchanged,1000,5
yqjA,831,1014,0.287137270232996,183,Unchanged,1000,5
exuR,1427,1820,0.35095311561029513,393,Unchanged,1000,5
exuT,368,2439,2.7285120867391712,2071,Upregulated,1000,5
uxaC,489,2861,2.5486131273709494,2372,Upregulated,1000,5
uxaA,383,2925,2.933020327433172,2542,Upregulated,1000,5
ygjV,107,638,2.5759456273637227,531,Unchanged,1000,5
sstT,12868,4460,-1.5286722258450713,-8408,Downregulated,1000,5
alx,105,1615,3.9430729319151645,1510,Upregulated,1000,5
ygjR,700,1752,1.3235759477688445,1052,Upregulated,1000,5
ygjQ,17,893,5.715053523870884,876,Unchanged,1000,5
ygjP,190,618,1.7016074195734268,428,Unchanged,1000,5
rlmG,328,2153,2.71458059954915,1825,Upregulated,1000,5
higB,38,164,2.109624491174498,126,Unchanged,1000,5
higA,160,706,2.1415962783838176,546,Unchanged,1000,5
fadH,130,3960,4.928916901938518,3830,Upregulated,1000,5
ygjK,111,4518,5.347052689042978,4407,Upregulated,1000,5
ygjJ,7,1654,7.884388597113671,1647,Upregulated,1000,5
ygjI,12,2141,7.479106579664354,2129,Upregulated,1000,5
ebgC,9,445,5.627736524411448,436,Unchanged,1000,5
ebgA,111,5640,5.66706358093605,5529,Upregulated,1000,5
ebgR,444,1662,1.9042888004202385,1218,Upregulated,1000,5
ygjH,6,380,5.984893107609792,374,Unchanged,1000,5
patA,306,2431,2.989946335336077,2125,Upregulated,1000,5
aer,185,2941,3.990709608370752,2756,Upregulated,1000,5
nfeR,1179,1221,0.05049948200764056,42,Unchanged,1000,5
nfeF,133,1323,3.314314910777487,1190,Upregulated,1000,5
mug,1050,1094,0.05922341023907156,44,Unchanged,1000,5
rpoD,12120,7711,-0.6523998257123927,-4409,Downregulated,1000,5
dnaG,4439,4268,-0.05667453250066833,-171,Unchanged,1000,5
rpsU,3308,384,-3.1067810184501186,-2924,Downregulated,1000,5
tsaD,2887,2215,-0.3822644087936013,-672,Unchanged,1000,5
ttdT,78,2873,5.202940058670276,2795,Upregulated,1000,5
ttdB,137,1004,2.873511470990245,867,Unchanged,1000,5
ttdA,194,1390,2.840956325423742,1196,Upregulated,1000,5
ttdR,134,1392,3.376854305390956,1258,Upregulated,1000,5
plsY,481,899,0.9022842217444054,418,Unchanged,1000,5
folB,235,528,1.1678771727934538,293,Unchanged,1000,5
bacA,997,1647,0.7241751453281589,650,Unchanged,1000,5
cca,2899,2989,0.044107563616697605,90,Unchanged,1000,5
ygiM,3729,2044,-0.8673936008360197,-1685,Downregulated,1000,5
ygiF,1686,2589,0.618790428958029,903,Unchanged,1000,5
glnE,4421,6303,0.5116659284401358,1882,Upregulated,1000,5
hldE,2863,3195,0.15828826083500397,332,Unchanged,1000,5
yqiK,77,2629,5.093511885923145,2552,Upregulated,1000,5
yqiJ,19,397,4.385067683699372,378,Unchanged,1000,5
glgS,276,80,-1.7865963618908067,-196,Unchanged,1000,5
yqiI,47,517,3.4594316186372973,470,Unchanged,1000,5
yqiH,40,361,3.1739269319998087,321,Unchanged,1000,5
yqiG,258,3301,3.677460167799282,3043,Upregulated,1000,5
insD5,419,649,0.631268234299787,230,Unchanged,1000,5
insC5,388,374,-0.05301838229949099,-14,Unchanged,1000,5
ygiL,11,351,4.9958956016672635,340,Unchanged,1000,5
ubiK,1100,370,-1.5719063478957098,-730,Unchanged,1000,5
ribB,4708,1358,-1.7936308407937125,-3350,Downregulated,1000,5
zupT,1120,1151,0.03938910118726399,31,Unchanged,1000,5
ygiD,168,1069,2.6697287149417304,901,Unchanged,1000,5
ygiC,4783,2546,-0.9096833720849474,-2237,Downregulated,1000,5
ygiB,3032,1622,-0.9024959339538187,-1410,Downregulated,1000,5
tolC,11961,4410,-1.439487450273604,-7551,Downregulated,1000,5
nudF,1144,892,-0.35897143685808475,-252,Unchanged,1000,5
yqiB,709,558,-0.3455205054103285,-151,Unchanged,1000,5
cpdA,2709,1885,-0.5231958700459878,-824,Unchanged,1000,5
yqiA,967,941,-0.039321166748304485,-26,Unchanged,1000,5
parE,4327,4059,-0.09224278072419789,-268,Unchanged,1000,5
ygiN,3693,622,-2.5698067770750113,-3071,Downregulated,1000,5
mdaB,921,842,-0.12938092302493956,-79,Unchanged,1000,5
ygiZ,9,59,2.712718047919529,50,Unchanged,1000,5
qseC,371,2323,2.6464980621880043,1952,Upregulated,1000,5
qseB,184,911,2.3077452877450377,727,Unchanged,1000,5
ygiW,2630,545,-2.270734664515376,-2085,Downregulated,1000,5
ygiV,424,532,0.32736198093799046,108,Unchanged,1000,5
mqsR,432,412,-0.06838697498025013,-20,Unchanged,1000,5
mqsA,613,779,0.3457362543708877,166,Unchanged,1000,5
ygiS,629,2644,2.071590254628403,2015,Upregulated,1000,5
parC,6193,5018,-0.3035259753083543,-1175,Downregulated,1000,5
plsC,947,891,-0.087938993946463,-56,Unchanged,1000,5
ftsP,2332,2706,0.2145940507760408,374,Unchanged,1000,5
yqhH,15,163,3.441837558622559,148,Unchanged,1000,5
yqhG,108,1103,3.352329573427914,995,Unchanged,1000,5
dkgA,3767,3626,-0.05503710820323461,-141,Unchanged,1000,5
yqhD,7937,12203,0.6205701546581761,4266,Upregulated,1000,5
yqhC,450,1404,1.6415460290875237,954,Unchanged,1000,5
yghB,859,888,0.04790154521164227,29,Unchanged,1000,5
metC,3522,1898,-0.891914916810099,-1624,Downregulated,1000,5
exbB,410,941,1.1985708132230906,531,Unchanged,1000,5
exbD,152,357,1.2318527505855144,205,Unchanged,1000,5
yghA,3921,1504,-1.3824170748389522,-2417,Downregulated,1000,5
yqhA,1118,1033,-0.11407993397813058,-85,Unchanged,1000,5
gpr,1742,2642,0.600885842647963,900,Unchanged,1000,5
yghW,10,275,4.78135971352466,265,Unchanged,1000,5
hybO,9003,6137,-0.552872236181934,-2866,Downregulated,1000,5
hybA,6466,4321,-0.5815082765363517,-2145,Downregulated,1000,5
hybB,4812,3264,-0.5599955852045808,-1548,Downregulated,1000,5
hybC,7003,6707,-0.06230548542503315,-296,Unchanged,1000,5
hybD,1761,1393,-0.3381996512299555,-368,Unchanged,1000,5
hybE,1558,1264,-0.3016987698845663,-294,Unchanged,1000,5
hybF,270,331,0.2938718097563867,61,Unchanged,1000,5
hybG,260,180,-0.5305147166987798,-80,Unchanged,1000,5
yghU,2035,1817,-0.16347037491949354,-218,Unchanged,1000,5
gss,6278,3983,-0.6564495492179292,-2295,Downregulated,1000,5
pitB,49,2667,5.766292265435718,2618,Upregulated,1000,5
yghT,11,860,6.288761230952163,849,Unchanged,1000,5
yghS,23,980,5.413075982945558,957,Unchanged,1000,5
yghR,22,1246,5.823656734386705,1224,Upregulated,1000,5
yghQ,28,1654,5.884388597113671,1626,Upregulated,1000,5
insH9,8435,3459,-1.286033054802,-4976,Downregulated,1000,5
yghO,58,2245,5.274518734500937,2187,Upregulated,1000,5
glcC,36,1427,5.308844618033451,1391,Upregulated,1000,5
glcD,108,3740,5.11393505261153,3632,Upregulated,1000,5
glcG,194,630,1.6992951762001511,436,Unchanged,1000,5
glcB,1975,5449,1.4641388376246995,3474,Upregulated,1000,5
glcA,80,2929,5.194264382992005,2849,Upregulated,1000,5
pppA,608,1301,1.0974777332742098,693,Unchanged,1000,5
yghG,100,363,1.859969548221026,263,Unchanged,1000,5
yghF,109,1375,3.657031578522458,1266,Upregulated,1000,5
yghE,429,1651,1.9442905674137125,1222,Upregulated,1000,5
yghD,63,678,3.4278615396364276,615,Unchanged,1000,5
yqgA,202,1036,2.358596804934759,834,Unchanged,1000,5
speC,4947,3646,-0.4402393381194889,-1301,Downregulated,1000,5
nupG,776,2199,1.5027190466678404,1423,Upregulated,1000,5
mltC,1057,1697,0.6830111881599804,640,Unchanged,1000,5
yggX,571,233,-1.2931607907085627,-338,Unchanged,1000,5
mutY,1232,2016,0.7104933828050152,784,Unchanged,1000,5
trmB,1644,1293,-0.3464880238714287,-351,Unchanged,1000,5
yggL,1162,400,-1.5385381636298043,-762,Unchanged,1000,5
yggN,575,1372,1.2546466203410749,797,Unchanged,1000,5
ansB,3176,2156,-0.5588537343904522,-1020,Downregulated,1000,5
yggM,43,1205,4.808552676415226,1162,Upregulated,1000,5
hemW,835,2153,1.3665002168058191,1318,Upregulated,1000,5
rdgB,792,1168,0.5604679388004076,376,Unchanged,1000,5
yggU,186,265,0.5106897383425302,79,Unchanged,1000,5
yggT,1213,916,-0.40516004702356645,-297,Unchanged,1000,5
yggS,575,1072,0.898671044626035,497,Unchanged,1000,5
yggR,43,1759,5.354275012769863,1716,Upregulated,1000,5
yqgF,396,591,0.5776577000979228,195,Unchanged,1000,5
yqgE,1563,1407,-0.15169544976313168,-156,Unchanged,1000,5
gshB,1785,1954,0.13050639305192333,169,Unchanged,1000,5
rsmE,922,1206,0.38739125147074693,284,Unchanged,1000,5
endA,144,930,2.6911619045530815,786,Unchanged,1000,5
yggI,237,550,1.214544559513763,313,Unchanged,1000,5
galP,6076,3254,-0.9009076188295557,-2822,Downregulated,1000,5
metK,44281,4382,-3.3370264134996166,-39899,Downregulated,1000,5
yqgC,53,60,0.1789701410453193,7,Unchanged,1000,5
yqgB,4,3,-0.4150374992788438,-1,Unchanged,1000,5
speA,8034,4151,-0.9526595294418588,-3883,Downregulated,1000,5
speB,1381,1420,0.04017761013399361,39,Unchanged,1000,5
loiP,1397,1491,0.09394823687397919,94,Unchanged,1000,5
tktA,40006,8739,-2.194676280715382,-31267,Downregulated,1000,5
cmtB,7,241,5.105534414172357,234,Unchanged,1000,5
cmtA,42,1733,5.366738516381409,1691,Upregulated,1000,5
yggF,58,1365,4.556704240679642,1307,Upregulated,1000,5
fumE,555,924,0.7354050801785893,369,Unchanged,1000,5
yggC,563,1177,1.0639074929582146,614,Unchanged,1000,5
epd,15423,4216,-1.8711366458342684,-11207,Downregulated,1000,5
pgk,58834,15751,-1.9012066999993138,-43083,Downregulated,1000,5
fbaA,127930,16826,-2.926590466055984,-111104,Downregulated,1000,5
mscS,16583,3317,-2.3217541085098135,-13266,Downregulated,1000,5
argO,334,855,1.3560763172992079,521,Unchanged,1000,5
yggE,6522,1741,-1.9053982380973644,-4781,Downregulated,1000,5
ygfI,231,959,2.0536379636020734,728,Unchanged,1000,5
scpC,118,2210,4.227187604916953,2092,Upregulated,1000,5
scpB,81,979,3.59531504671907,898,Unchanged,1000,5
argK,68,1382,4.34507905913792,1314,Upregulated,1000,5
scpA,140,3559,4.667973200564819,3419,Upregulated,1000,5
argP,1776,1544,-0.20195882908202553,-232,Unchanged,1000,5
yqfE,17,187,3.4594316186372973,170,Unchanged,1000,5
rpiA,7654,2989,-1.3565510039904012,-4665,Downregulated,1000,5
serA,48418,9691,-2.3208260392246167,-38727,Downregulated,1000,5
fau,364,706,0.955729733072484,342,Unchanged,1000,5
ssrS,6382,624,-3.3543906744170635,-5758,Downregulated,1000,5
zapA,1183,460,-1.362744307395413,-723,Unchanged,1000,5
ygfB,4239,1617,-1.390404287581434,-2622,Downregulated,1000,5
pepP,10390,4728,-1.1358937136140417,-5662,Downregulated,1000,5
ubiH,4132,3224,-0.3579885103370922,-908,Unchanged,1000,5
ubiI,3056,2643,-0.20946811839417878,-413,Unchanged,1000,5
gcvT,2759,2186,-0.3358520556813683,-573,Unchanged,1000,5
gcvH,1286,556,-1.2097338546044398,-730,Unchanged,1000,5
gcvP,4765,5353,0.16787143851768954,588,Unchanged,1000,5
ygfF,137,1043,2.928491359559239,906,Unchanged,1000,5
bglA,3541,2603,-0.443981531986804,-938,Unchanged,1000,5
yqfB,500,296,-0.7563309190331373,-204,Unchanged,1000,5
yqfA,468,1126,1.266626392496825,658,Unchanged,1000,5
ygfZ,5845,3029,-0.9483614466236463,-2816,Downregulated,1000,5
sdhE,872,598,-0.5441826505788212,-274,Unchanged,1000,5
ygfX,1050,993,-0.08052370502511108,-57,Unchanged,1000,5
fldB,1045,708,-0.5616816768852476,-337,Unchanged,1000,5
xerD,2425,1805,-0.425985910187319,-620,Unchanged,1000,5
dsbC,2407,1563,-0.6229183634748325,-844,Unchanged,1000,5
recJ,4869,4760,-0.03266392707382181,-109,Unchanged,1000,5
prfB,6706,3578,-0.9062990957418762,-3128,Downregulated,1000,5
lysS,11239,5398,-1.0580167942800915,-5841,Downregulated,1000,5
idi,181,509,1.49167595899249,328,Unchanged,1000,5
uacT,14,1355,6.59672221418363,1341,Upregulated,1000,5
ygfT,170,2332,3.777961137062795,2162,Upregulated,1000,5
ygfS,41,420,3.356693513048039,379,Unchanged,1000,5
guaD,321,1480,2.204951973394009,1159,Upregulated,1000,5
xanQ,81,1283,3.985455452205058,1202,Upregulated,1000,5
xdhD,412,3601,3.127681357007062,3189,Upregulated,1000,5
ygfM,55,791,3.846174170948132,736,Unchanged,1000,5
ssnA,48,1502,4.967706596793116,1454,Upregulated,1000,5
ygfK,131,3110,4.569275863480515,2979,Upregulated,1000,5
mocA,72,366,2.34577483684173,294,Unchanged,1000,5
yqeC,68,788,3.534588978206037,720,Unchanged,1000,5
yqeB,312,1897,2.604101744549227,1585,Upregulated,1000,5
yqeA,155,781,2.333054332867742,626,Unchanged,1000,5
hyuA,67,1470,4.455511249265954,1403,Upregulated,1000,5
ygeY,108,1108,3.3588546638857197,1000,Unchanged,1000,5
ygeX,68,1344,4.304854581528421,1276,Upregulated,1000,5
ygeW,39,1194,4.936184902402557,1155,Upregulated,1000,5
ygeV,542,1615,1.5751694082274157,1073,Upregulated,1000,5
xdhC,85,400,2.234465253637023,315,Unchanged,1000,5
xdhB,119,982,3.0447614510067496,863,Unchanged,1000,5
xdhA,362,2539,2.8101987925643006,2177,Upregulated,1000,5
ygeR,833,936,0.16819203421785683,103,Unchanged,1000,5
ygeQ,169,600,1.8279392542136965,431,Unchanged,1000,5
insC4,261,494,0.9204612350147932,233,Unchanged,1000,5
insD4,297,752,1.3402697308768716,455,Unchanged,1000,5
ygeO,36,68,0.9175378398080271,32,Unchanged,1000,5
ygeN,36,39,0.11547721741993588,3,Unchanged,1000,5
ygeL,9,132,3.8744691179161412,123,Unchanged,1000,5
pbl,2,58,4.857980995127572,56,Unchanged,1000,5
ygeI,2,3,0.5849625007211562,1,Unchanged,1000,5
ygeH,12,130,3.4374053123072983,118,Unchanged,1000,5
ygeG,4,20,2.321928094887362,16,Unchanged,1000,5
ygeF,5,52,3.37851162325373,47,Unchanged,1000,5
yqeK,5,7,0.48542682717024166,2,Unchanged,1000,5
yqeJ,45,37,-0.282399730700725,-8,Unchanged,1000,5
yqeI,222,245,0.14222207265246467,23,Unchanged,1000,5
yqeH,37,138,1.8990710911492192,101,Unchanged,1000,5
yqeG,393,779,0.9870940158030628,386,Unchanged,1000,5
yqeF,130,1295,3.3163685695454617,1165,Upregulated,1000,5
kduI,78,740,3.2459792416540636,662,Unchanged,1000,5
kduD,153,772,2.3350691945754285,619,Unchanged,1000,5
araE,535,1642,1.6178433304892954,1107,Upregulated,1000,5
ygeA,439,672,0.6142402932434021,233,Unchanged,1000,5
lysR,267,1107,2.0517435750939983,840,Unchanged,1000,5
lysA,718,1585,1.1424270912037182,867,Unchanged,1000,5
galR,663,1519,1.1960410943894957,856,Unchanged,1000,5
aas,1936,2778,0.5209676467067981,842,Unchanged,1000,5
lplT,801,1632,1.0267669095627856,831,Unchanged,1000,5
tas,3231,2100,-0.6215914227118787,-1131,Downregulated,1000,5
ygdR,408,99,-2.043068721891886,-309,Unchanged,1000,5
ygdQ,382,1163,1.6062065534374697,781,Unchanged,1000,5
mutH,409,1181,1.5298362164554085,772,Unchanged,1000,5
rppH,3547,1514,-1.228234124949457,-2033,Downregulated,1000,5
ptsP,6027,5486,-0.13568544260617083,-541,Unchanged,1000,5
lgt,796,1141,0.5194584557450329,345,Unchanged,1000,5
thyA,1386,1144,-0.27684020535882436,-242,Unchanged,1000,5
ppdA,46,565,3.618545101245537,519,Unchanged,1000,5
ppdB,135,734,2.442820655792382,599,Unchanged,1000,5
ygdB,95,409,2.106101424610801,314,Unchanged,1000,5
ppdC,58,262,2.1754420064098783,204,Unchanged,1000,5
recC,3896,6288,0.6906075401762644,2392,Upregulated,1000,5
ptrA,3035,5745,0.9206103763904312,2710,Upregulated,1000,5
recB,4763,9327,0.9695425686981982,4564,Upregulated,1000,5
recD,1512,3949,1.385029228239276,2437,Upregulated,1000,5
argA,2043,5720,1.4853259429325243,3677,Upregulated,1000,5
amiC,3720,2741,-0.44060029316961863,-979,Unchanged,1000,5
mltA,2422,1986,-0.28633324216595485,-436,Unchanged,1000,5
tcdA,309,1510,2.2888698063080666,1201,Upregulated,1000,5
csdE,474,826,0.8012547225211862,352,Unchanged,1000,5
csdA,2838,3493,0.29959205333431327,655,Unchanged,1000,5
ygdI,787,166,-2.2451803941605615,-621,Unchanged,1000,5
gcvA,1154,1751,0.6015358597880753,597,Unchanged,1000,5
ygdD,429,674,0.6517709436823129,245,Unchanged,1000,5
rlmM,1847,2280,0.30384995806966586,433,Unchanged,1000,5
fucR,551,939,0.7690728390826168,388,Unchanged,1000,5
fucU,454,560,0.3027345296540515,106,Unchanged,1000,5
fucK,235,2406,3.355903980611077,2171,Upregulated,1000,5
fucI,240,3344,3.8004685364723643,3104,Upregulated,1000,5
fucP,40,1792,5.485426827170242,1752,Upregulated,1000,5
fucA,37,822,4.473541218052733,785,Unchanged,1000,5
fucO,1239,2308,0.8974670365048809,1069,Upregulated,1000,5
ygdG,509,1252,1.2984970008569232,743,Unchanged,1000,5
sdaB,1306,2363,0.855464732427416,1057,Upregulated,1000,5
sdaC,3225,2429,-0.40893667056211386,-796,Unchanged,1000,5
ppnN,5017,3382,-0.5689482783543135,-1635,Downregulated,1000,5
queF,935,1189,0.3467104449706569,254,Unchanged,1000,5
syd,688,840,0.28798076296402464,152,Unchanged,1000,5
yqcC,227,274,0.2714835956696118,47,Unchanged,1000,5
truC,600,1086,0.8559896973084807,486,Unchanged,1000,5
yqcA,1328,630,-1.0758314129596458,-698,Unchanged,1000,5
gudP,63,1746,4.792557920129523,1683,Upregulated,1000,5
gudX,179,1748,3.287673692236342,1569,Upregulated,1000,5
gudD,447,2124,2.248437029620836,1677,Upregulated,1000,5
barA,1859,3721,1.001163620206291,1862,Upregulated,1000,5
rlmD,961,2028,1.0774493162295902,1067,Upregulated,1000,5
relA,4341,4857,0.1620380637708414,516,Unchanged,1000,5
mazE,228,461,1.0157329262645964,233,Unchanged,1000,5
mazF,274,358,0.3857836943037298,84,Unchanged,1000,5
mazG,1247,2351,0.9148130738233513,1104,Upregulated,1000,5
pyrG,25298,7476,-1.7586848591770456,-17822,Downregulated,1000,5
eno,95671,30399,-1.6540578123284673,-65272,Downregulated,1000,5
ygcG,13,321,4.625989768981211,308,Unchanged,1000,5
queE,539,1103,1.0330756128388772,564,Unchanged,1000,5
ygcE,81,1673,4.368371727153728,1592,Upregulated,1000,5
yqcE,24,1512,5.977279923499917,1488,Upregulated,1000,5
ygcW,14,671,5.582814034142579,657,Unchanged,1000,5
ygcS,56,1777,4.987873043971074,1721,Upregulated,1000,5
ygcR,42,1244,4.888453347351843,1202,Upregulated,1000,5
ygcQ,80,1208,3.9164766444377164,1128,Upregulated,1000,5
ygcP,85,530,2.6404576133128597,445,Unchanged,1000,5
ygcO,10,142,3.8278190246173196,132,Unchanged,1000,5
ygcN,370,1949,2.3971369147415778,1579,Upregulated,1000,5
queD,429,405,-0.08305573972755852,-24,Unchanged,1000,5
cysJ,422,5213,3.626798955888827,4791,Upregulated,1000,5
cysI,469,5428,3.5327608929034775,4959,Upregulated,1000,5
cysH,236,1489,2.6574849892202588,1253,Upregulated,1000,5
cas3,306,2941,3.264703226194412,2635,Upregulated,1000,5
casA,164,1734,3.4023361786037514,1570,Upregulated,1000,5
casB,92,504,2.4537179674429037,412,Unchanged,1000,5
casC,353,1240,1.8126000320030573,887,Unchanged,1000,5
casD,180,898,2.3187185384114724,718,Unchanged,1000,5
casE,222,731,1.7193117296023313,509,Unchanged,1000,5
cas1,318,1412,2.150641417986825,1094,Upregulated,1000,5
cas2,60,276,2.2016338611696504,216,Unchanged,1000,5
iap,545,1587,1.5419739931708931,1042,Upregulated,1000,5
cysD,382,3783,3.3078862330136274,3401,Upregulated,1000,5
cysN,880,6089,2.7906298840799177,5209,Upregulated,1000,5
cysC,130,1389,3.417463070952938,1259,Upregulated,1000,5
ygbE,61,298,2.2884311828992754,237,Unchanged,1000,5
ftsB,714,479,-0.5758984182929195,-235,Unchanged,1000,5
ispD,1716,1620,-0.08305573972755852,-96,Unchanged,1000,5
ispF,1077,709,-0.6031607173046915,-368,Unchanged,1000,5
truD,3937,2572,-0.6142060698310937,-1365,Downregulated,1000,5
umpG,2166,1754,-0.30438449516359406,-412,Unchanged,1000,5
pcm,1324,1128,-0.23113605440842414,-196,Unchanged,1000,5
nlpD,8032,12648,0.6550780984075988,4616,Upregulated,1000,5
rpoS,26810,22547,-0.24983573142950463,-4263,Downregulated,1000,5
ygbN,132,1960,3.892243819644117,1828,Upregulated,1000,5
ygbM,92,1072,3.5425272344007595,980,Unchanged,1000,5
ygbL,54,1100,4.3484003062485534,1046,Upregulated,1000,5
ygbK,103,2074,4.331699651630007,1971,Upregulated,1000,5
ygbJ,62,1604,4.693262116068045,1542,Upregulated,1000,5
ygbI,471,1357,1.5266217558060708,886,Unchanged,1000,5
pphB,34,493,3.8579809951275723,459,Unchanged,1000,5
mutS,2242,5382,1.2633561128349906,3140,Upregulated,1000,5
ygbA,37,463,3.6454150176312865,426,Unchanged,1000,5
fhlA,1088,4631,2.089645200453354,3543,Upregulated,1000,5
hypE,1891,2273,0.2654483208680863,382,Unchanged,1000,5
hypD,2762,3198,0.21145661922228126,436,Unchanged,1000,5
hypC,262,377,0.5249977117312139,115,Unchanged,1000,5
hypB,2678,2636,-0.022805590316258825,-42,Unchanged,1000,5
hypA,168,614,1.869777422591419,446,Unchanged,1000,5
hycA,178,814,2.1931515532998493,636,Unchanged,1000,5
hycB,153,1186,2.954500451853352,1033,Upregulated,1000,5
hycC,477,4998,3.389289730081192,4521,Upregulated,1000,5
hycD,215,2287,3.4110478008222125,2072,Upregulated,1000,5
hycE,590,4908,3.0563483894137016,4318,Upregulated,1000,5
hycF,162,1198,2.886562189904161,1036,Upregulated,1000,5
hycG,319,1666,2.3847600716006783,1347,Upregulated,1000,5
hycH,180,694,1.9469387562485863,514,Unchanged,1000,5
hycI,257,836,1.7017345828870047,579,Unchanged,1000,5
ascB,431,3340,2.9540883282723165,2909,Upregulated,1000,5
ascF,310,3787,3.610715300610182,3477,Upregulated,1000,5
ascG,412,2505,2.6040943608993525,2093,Upregulated,1000,5
hydN,207,768,1.8914755432218309,561,Unchanged,1000,5
hypF,1876,6526,1.7985391595764877,4650,Upregulated,1000,5
norW,116,2928,4.65771884315647,2812,Upregulated,1000,5
norV,249,3637,3.868531278387536,3388,Upregulated,1000,5
norR,792,3969,2.3252032269202236,3177,Upregulated,1000,5
gutQ,1080,2405,1.1550055816065732,1325,Upregulated,1000,5
srlR,672,1493,1.1516810273557812,821,Unchanged,1000,5
gutM,45,461,3.356769844099663,416,Unchanged,1000,5
srlD,346,1916,2.4692536180994558,1570,Upregulated,1000,5
srlB,36,591,4.03708931873522,555,Unchanged,1000,5
srlE,87,1760,4.338416217675931,1673,Upregulated,1000,5
srlA,41,699,4.091596640757353,658,Unchanged,1000,5
mltB,1378,2250,0.7073491134001081,872,Unchanged,1000,5
pncC,685,778,0.18366616713830297,93,Unchanged,1000,5
recA,17576,4915,-1.8383434531953335,-12661,Downregulated,1000,5
recX,112,628,2.487265826834023,516,Unchanged,1000,5
alaS,28405,11168,-1.3467740563194006,-17237,Downregulated,1000,5
csrA,1690,209,-3.015448399088664,-1481,Downregulated,1000,5
yqaB,769,951,0.3064617428987369,182,Unchanged,1000,5
yqaA,623,484,-0.36422511574940736,-139,Unchanged,1000,5
gshA,5324,3238,-0.7174075856093258,-2086,Downregulated,1000,5
luxS,7464,1341,-2.4766397489472847,-6123,Downregulated,1000,5
emrB,1165,2349,1.0117167584705542,1184,Upregulated,1000,5
emrA,1958,1855,-0.07796157809552932,-103,Unchanged,1000,5
mprA,4158,1218,-1.7713756249520376,-2940,Downregulated,1000,5
ygaH,691,555,-0.3161979391507903,-136,Unchanged,1000,5
ygaZ,3482,2195,-0.6656952632283807,-1287,Downregulated,1000,5
ygaY,261,2112,3.016488122788569,1851,Upregulated,1000,5
proX,21168,17839,-0.24685022229369336,-3329,Downregulated,1000,5
proW,20183,20659,0.0336297896684495,476,Unchanged,1000,5
proV,29020,25379,-0.19341229512175842,-3641,Downregulated,1000,5
nrdF,34,1274,5.227686721005961,1240,Upregulated,1000,5
nrdE,114,3660,5.004737919006663,3546,Upregulated,1000,5
nrdI,10,348,5.121015400961366,338,Unchanged,1000,5
nrdH,7,179,4.676460855206653,172,Unchanged,1000,5
ygaM,2129,484,-2.1370969971776996,-1645,Downregulated,1000,5
ygaC,795,346,-1.200182822534993,-449,Unchanged,1000,5
alaE,143,446,1.6410285631419153,303,Unchanged,1000,5
stpA,7718,1603,-2.2674526183867063,-6115,Downregulated,1000,5
ygaP,221,666,1.5914758076798305,445,Unchanged,1000,5
ygaV,67,246,1.8764253148814674,179,Unchanged,1000,5
yqaE,34,44,0.37196877738695794,10,Unchanged,1000,5
kbp,3208,787,-2.0272386009474337,-2421,Downregulated,1000,5
glaR,326,1185,1.861943189554544,859,Unchanged,1000,5
gabP,140,2040,3.8650704199138914,1900,Upregulated,1000,5
gabT,630,2902,2.2036237856794654,2272,Upregulated,1000,5
gabD,737,3073,2.0599112424978925,2336,Upregulated,1000,5
lhgD,230,2559,3.475874381095071,2329,Upregulated,1000,5
glaH,222,1571,2.8230515989440903,1349,Upregulated,1000,5
ypjC,10,184,4.20163386116965,174,Unchanged,1000,5
pinH,1,97,6.599912842187128,96,Unchanged,1000,5
ypjA,579,5165,3.1571330957631853,4586,Upregulated,1000,5
ypjF,12,137,3.5130695822393703,125,Unchanged,1000,5
yfjZ,3,115,5.260527550223219,112,Unchanged,1000,5
yfjY,9,350,5.281286110390016,341,Unchanged,1000,5
yfjX,10,488,5.608809242675524,478,Unchanged,1000,5
yfjW,751,237,-1.6639258486160127,-514,Unchanged,1000,5
yfjV,226,1065,2.236458752698013,839,Unchanged,1000,5
yfjU,3,2,-0.5849625007211563,-1,Unchanged,1000,5
yfjT,47,384,3.030373649043519,337,Unchanged,1000,5
yfjS,14,289,4.3675707604430745,275,Unchanged,1000,5
ypjK,7,109,3.9608294027193223,102,Unchanged,1000,5
yfjR,27,593,4.457000792382535,566,Unchanged,1000,5
yfjQ,18,800,5.473931188332412,782,Unchanged,1000,5
yfjP,75,952,3.665999072812063,877,Unchanged,1000,5
rnlB,396,325,-0.28506071216379275,-71,Unchanged,1000,5
rnlA,4217,1619,-1.3811140359765677,-2598,Downregulated,1000,5
yfjM,14,109,2.9608294027193223,95,Unchanged,1000,5
abpA,1810,1794,-0.01280980705130656,-16,Unchanged,1000,5
abpB,1926,2173,0.1740804713378237,247,Unchanged,1000,5
yfjJ,25,146,2.5459683691052923,121,Unchanged,1000,5
yfjI,45,437,3.2796363731709235,392,Unchanged,1000,5
alpA,7,62,3.146841388329271,55,Unchanged,1000,5
yfjH,292,345,0.2406279927855141,53,Unchanged,1000,5
intA,1577,1368,-0.20511442990461237,-209,Unchanged,1000,5
ssrA,836700,230403,-1.8605509333377752,-606297,Downregulated,1000,5
smpB,1129,586,-0.9460729163507529,-543,Unchanged,1000,5
ratA,1459,749,-0.9619422594591398,-710,Unchanged,1000,5
yfjF,337,212,-0.6686843266186594,-125,Unchanged,1000,5
bamE,2178,451,-2.271804615461526,-1727,Downregulated,1000,5
recN,4802,2374,-1.0163154685885099,-2428,Downregulated,1000,5
nadK,1039,895,-0.21523606675259307,-144,Unchanged,1000,5
grpE,13820,4361,-1.6640267201940149,-9459,Downregulated,1000,5
ypjD,620,749,0.2726975031845134,129,Unchanged,1000,5
ffh,7914,4949,-0.677270023105698,-2965,Downregulated,1000,5
rpsP,3736,790,-2.241569896645197,-2946,Downregulated,1000,5
rimM,20347,4125,-2.302350072026451,-16222,Downregulated,1000,5
trmD,22564,4815,-2.2284151388740416,-17749,Downregulated,1000,5
rplS,6860,906,-2.9206256210139396,-5954,Downregulated,1000,5
yfiB,519,272,-0.9321278871075415,-247,Unchanged,1000,5
dgcN,547,986,0.8500468135853549,439,Unchanged,1000,5
yfiR,386,430,0.1557358123213798,44,Unchanged,1000,5
yfiL,47,144,1.615336149764675,97,Unchanged,1000,5
aroF,1014,3907,1.9460036031803325,2893,Upregulated,1000,5
tyrA,1266,3519,1.4748881093213233,2253,Upregulated,1000,5
pheA,2987,1816,-0.7179330350198756,-1171,Downregulated,1000,5
pheL,1,1,0.0,0,Unchanged,1000,5
raiA,10047,3287,-1.6119214203475616,-6760,Downregulated,1000,5
bamD,6003,1875,-1.6787930723562918,-4128,Downregulated,1000,5
rluD,2293,1726,-0.40980389040183846,-567,Unchanged,1000,5
pgeF,778,832,0.0968133731549001,54,Unchanged,1000,5
clpB,36074,29838,-0.27380856564118633,-6236,Downregulated,1000,5
kgtP,3210,4043,0.3328529062620291,833,Unchanged,1000,5
yfiM,100,301,1.5897634869849773,201,Unchanged,1000,5
pssA,4784,2306,-1.0528248765463333,-2478,Downregulated,1000,5
patZ,2061,4108,0.9950916767789388,2047,Upregulated,1000,5
tapT,142,783,2.4631213777863588,641,Unchanged,1000,5
trxC,116,351,1.5973462251769885,235,Unchanged,1000,5
yfiF,2027,1938,-0.06477751805181789,-89,Unchanged,1000,5
ung,1231,1055,-0.22258776288990983,-176,Unchanged,1000,5
grcA,2592,1976,-0.39148277129994696,-616,Unchanged,1000,5
eamB,196,795,2.0201012060565096,599,Unchanged,1000,5
yfiE,174,1283,2.882361959240954,1109,Upregulated,1000,5
srmB,3008,3387,0.17120341981651963,379,Unchanged,1000,5
yfiC,508,1020,1.005668750086692,512,Unchanged,1000,5
nadB,16222,3755,-2.1110668866170283,-12467,Downregulated,1000,5
rpoE,9016,2998,-1.5884871322243617,-6018,Downregulated,1000,5
rseA,13743,5654,-1.2813531804079885,-8089,Downregulated,1000,5
rseB,7779,2854,-1.4465993720986874,-4925,Downregulated,1000,5
rseC,2917,1030,-1.5018410488275968,-1887,Downregulated,1000,5
lepA,10039,5222,-0.9429412046435173,-4817,Downregulated,1000,5
lepB,3404,1888,-0.8503722723241213,-1516,Downregulated,1000,5
rnc,2100,1337,-0.6513898624601321,-763,Unchanged,1000,5
era,3271,2582,-0.3412427587755877,-689,Unchanged,1000,5
recO,630,1027,0.7050124479309162,397,Unchanged,1000,5
pdxJ,2397,1487,-0.6888252615967143,-910,Unchanged,1000,5
acpS,605,552,-0.13226687538378784,-53,Unchanged,1000,5
yfhL,99,112,0.17799830197799443,13,Unchanged,1000,5
yfhH,425,1286,1.597355896302883,861,Unchanged,1000,5
pgpC,1126,1457,0.3717940499842829,331,Unchanged,1000,5
tadA,684,952,0.4769652484220457,268,Unchanged,1000,5
mltF,354,2764,2.964936350305261,2410,Upregulated,1000,5
purL,26525,18325,-0.533539552780953,-8200,Downregulated,1000,5
glrK,1115,3405,1.6106110880917666,2290,Upregulated,1000,5
qseG,780,1496,0.9395641461380261,716,Unchanged,1000,5
glrR,1138,3048,1.4213623451867403,1910,Upregulated,1000,5
glnB,1054,452,-1.2214801892220268,-602,Unchanged,1000,5
hmp,402,2387,2.569931159902848,1985,Upregulated,1000,5
glyA,93445,9592,-3.2842139072946566,-83853,Downregulated,1000,5
yphH,303,2184,2.8495831574469017,1881,Upregulated,1000,5
yphG,152,6405,5.397055341785423,6253,Upregulated,1000,5
yphF,51,1392,4.770518153877233,1341,Upregulated,1000,5
yphE,52,3191,5.93935317513822,3139,Upregulated,1000,5
yphD,58,1914,5.044394119358453,1856,Upregulated,1000,5
yphC,290,2141,2.884159990370575,1851,Upregulated,1000,5
yphB,183,1595,3.1236408703681895,1412,Upregulated,1000,5
yphA,471,473,0.006113123726612006,2,Unchanged,1000,5
hcaD,206,2111,3.3572103361639374,1905,Upregulated,1000,5
hcaB,180,1745,3.27715822476734,1565,Upregulated,1000,5
hcaC,50,475,3.2479275134435857,425,Unchanged,1000,5
hcaF,53,665,3.649290075825353,612,Unchanged,1000,5
hcaE,854,3166,1.8903532805166907,2312,Upregulated,1000,5
hcaR,164,1769,3.4311663280723748,1605,Upregulated,1000,5
hcaT,380,2506,2.7213150909909127,2126,Upregulated,1000,5
csiE,616,2389,1.955404597761431,1773,Upregulated,1000,5
yfhR,49,1977,5.334387311614,1928,Upregulated,1000,5
suhB,2777,1927,-0.5271706055231249,-850,Unchanged,1000,5
trmJ,2986,4118,0.463729664497713,1132,Upregulated,1000,5
iscR,525,1270,1.274439169106043,745,Unchanged,1000,5
iscS,4420,5898,0.41617945278294277,1478,Upregulated,1000,5
iscU,1186,1325,0.1598883497919203,139,Unchanged,1000,5
iscA,1381,1280,-0.10956950937068856,-101,Unchanged,1000,5
hscB,757,1434,0.9216798187161731,677,Unchanged,1000,5
hscA,5431,7576,0.48021846754418435,2145,Upregulated,1000,5
fdx,758,794,0.06694115897186609,36,Unchanged,1000,5
iscX,121,228,0.9140267768901471,107,Unchanged,1000,5
pepB,2829,5045,0.8345620925974669,2216,Upregulated,1000,5
sseB,1007,1602,0.6698104644019254,595,Unchanged,1000,5
sseA,2118,2089,-0.019890096925228282,-29,Unchanged,1000,5
yfhM,7373,14354,0.9611291637400687,6981,Upregulated,1000,5
pbpC,591,5700,3.269731883761934,5109,Upregulated,1000,5
ndk,263,834,1.6649845841523612,571,Unchanged,1000,5
rlmN,1606,2891,0.848096715959735,1285,Upregulated,1000,5
rodZ,3168,3074,-0.043455170388838255,-94,Unchanged,1000,5
ispG,5829,4374,-0.41429518125840753,-1455,Downregulated,1000,5
hisS,7522,4323,-0.7990834701444027,-3199,Downregulated,1000,5
yfgM,3246,1861,-0.8025849444888199,-1385,Downregulated,1000,5
bamB,9072,4553,-0.9946031809230298,-4519,Downregulated,1000,5
der,2925,3850,0.3964218211114968,925,Unchanged,1000,5
yfgJ,25,92,1.8797057662822882,67,Unchanged,1000,5
xseA,2388,2775,0.21668493486002566,387,Unchanged,1000,5
guaB,42100,4813,-3.1288119048762484,-37287,Downregulated,1000,5
guaA,43232,4688,-3.205055104903437,-38544,Downregulated,1000,5
yfgI,48,854,4.153129758899334,806,Unchanged,1000,5
yfgH,25,453,4.17951105027151,428,Unchanged,1000,5
yfgG,37,84,1.1828640571498104,47,Unchanged,1000,5
pdeF,214,3472,4.020084246043332,3258,Upregulated,1000,5
ppx,3634,3416,-0.0892504446136255,-218,Unchanged,1000,5
ppk,6678,5093,-0.39090037616558193,-1585,Downregulated,1000,5
purN,3619,1701,-1.0892079667091537,-1918,Downregulated,1000,5
purM,12455,5024,-1.3098166522365717,-7431,Downregulated,1000,5
upp,17025,1252,-3.7653483308541777,-15773,Downregulated,1000,5
uraA,7735,2163,-1.8383676263744193,-5572,Downregulated,1000,5
hda,1509,1751,0.21458627790687457,242,Unchanged,1000,5
yfgD,1555,699,-1.1535502196425285,-856,Unchanged,1000,5
bepA,3959,4232,0.09620356008392907,273,Unchanged,1000,5
yfgO,1210,2575,1.0895653847959863,1365,Upregulated,1000,5
focB,97,1824,4.232977171977614,1727,Upregulated,1000,5
hyfR,167,4278,4.679016474690992,4111,Upregulated,1000,5
hyfJ,33,563,4.092596992721776,530,Unchanged,1000,5
hyfI,71,1370,4.270213058343207,1299,Upregulated,1000,5
hyfH,61,982,4.008841876751807,921,Unchanged,1000,5
hyfG,231,3849,4.0585189143947815,3618,Upregulated,1000,5
hyfF,92,2853,4.954702075524707,2761,Upregulated,1000,5
hyfE,19,1270,6.062685268215943,1251,Upregulated,1000,5
hyfD,34,2758,6.341943900263641,2724,Upregulated,1000,5
hyfC,10,1798,7.490249210627085,1788,Upregulated,1000,5
hyfB,105,4560,5.4405725913859815,4455,Upregulated,1000,5
hyfA,13,1186,6.511448576404911,1173,Upregulated,1000,5
bcp,4909,1094,-2.1658164285734918,-3815,Downregulated,1000,5
gcvR,2622,1276,-1.0390393564568852,-1346,Downregulated,1000,5
dapA,12848,5392,-1.252651396335456,-7456,Downregulated,1000,5
bamC,10846,6171,-0.8135868757691186,-4675,Downregulated,1000,5
purC,16539,4418,-1.9044066834569928,-12121,Downregulated,1000,5
ypfJ,1889,2527,0.41980296255640537,638,Unchanged,1000,5
tmcA,1729,5079,1.5546066049745162,3350,Upregulated,1000,5
ypfH,1234,1969,0.6741207167521358,735,Unchanged,1000,5
dapE,1373,2801,1.028610357927406,1428,Upregulated,1000,5
yffB,299,509,0.7675201718775903,210,Unchanged,1000,5
acrD,590,7637,3.694219164132008,7047,Upregulated,1000,5
narQ,1044,3821,1.8718285457876267,2777,Upregulated,1000,5
aegA,577,4592,2.9924794180302055,4015,Upregulated,1000,5
nudK,547,1258,1.2015191840867327,711,Unchanged,1000,5
ypfG,1168,2779,1.2505255603205445,1611,Upregulated,1000,5
tktB,9029,5549,-0.7023384089773067,-3480,Downregulated,1000,5
talA,4121,1996,-1.045882742943239,-2125,Downregulated,1000,5
maeB,3955,7260,0.8762918535229589,3305,Upregulated,1000,5
eutS,3,592,7.624490864907794,589,Unchanged,1000,5
eutP,8,762,6.573647187493322,754,Unchanged,1000,5
eutQ,28,1891,6.077578725892158,1863,Upregulated,1000,5
eutT,34,2262,6.0559203727394815,2228,Upregulated,1000,5
eutD,40,3074,6.263973354803409,3034,Upregulated,1000,5
eutM,22,300,3.7693870718585836,278,Unchanged,1000,5
eutN,1,410,8.679480099505446,409,Unchanged,1000,5
eutE,41,3690,6.491853096329675,3649,Upregulated,1000,5
eutJ,17,2236,7.0392416315928505,2219,Upregulated,1000,5
eutG,58,3404,5.87503432655839,3346,Upregulated,1000,5
eutH,64,3375,5.720671786825555,3311,Upregulated,1000,5
eutA,68,3885,5.8362360420447335,3817,Upregulated,1000,5
yffS,1061,1909,0.8473924464891729,848,Unchanged,1000,5
yffR,350,616,0.8155754288625726,266,Unchanged,1000,5
yffQ,19,335,4.1400897719015495,316,Unchanged,1000,5
yffP,70,1248,4.156119201917282,1178,Upregulated,1000,5
yffO,52,584,3.489384840738925,532,Unchanged,1000,5
yffN,21,491,4.547261791535933,470,Unchanged,1000,5
yffM,6,238,5.309855262586788,232,Unchanged,1000,5
yffL,322,1063,1.7230090034164878,741,Unchanged,1000,5
intZ,335,2598,2.9551684301027463,2263,Upregulated,1000,5
eutB,1718,4213,1.2941178794237909,2495,Upregulated,1000,5
eutC,532,1618,1.604713456928788,1086,Upregulated,1000,5
eutL,472,1549,1.7144783794277272,1077,Upregulated,1000,5
eutK,305,1070,1.8107296488382607,765,Unchanged,1000,5
eutR,393,2680,2.7696317830865285,2287,Upregulated,1000,5
hemF,810,1930,1.2526070343834557,1120,Upregulated,1000,5
amiA,1373,2284,0.7342310252157421,911,Unchanged,1000,5
ypeA,656,1134,0.7896529203241452,478,Unchanged,1000,5
yfeZ,277,934,1.7535365736604736,657,Unchanged,1000,5
yfeY,758,1244,0.7147167319595109,486,Unchanged,1000,5
yfeX,5567,2892,-0.9448325309147156,-2675,Downregulated,1000,5
yfeW,108,2888,4.740967524723702,2780,Upregulated,1000,5
murP,144,3370,4.548607874626908,3226,Upregulated,1000,5
murQ,163,2127,3.7058761637295947,1964,Upregulated,1000,5
murR,216,2029,3.2316656475931906,1813,Upregulated,1000,5
ucpA,1306,2375,0.8627726165592418,1069,Upregulated,1000,5
cysP,329,4508,3.7763280264369796,4179,Upregulated,1000,5
cysU,126,2847,4.4979468542423495,2721,Upregulated,1000,5
cysW,204,3261,3.99867338377697,3057,Upregulated,1000,5
cysA,366,5022,3.7783464749874573,4656,Upregulated,1000,5
cysM,795,3112,1.9688152948144741,2317,Upregulated,1000,5
yfeS,267,511,0.9364835492500674,244,Unchanged,1000,5
yfeK,103,367,1.8331357256599945,264,Unchanged,1000,5
pdxK,2480,1933,-0.35949848306300186,-547,Unchanged,1000,5
crr,33596,4329,-2.9561837677075102,-29267,Downregulated,1000,5
ptsI,141378,27201,-2.377826042236528,-114177,Downregulated,1000,5
ptsH,17812,2381,-2.9032099911725697,-15431,Downregulated,1000,5
cysK,9227,22902,1.3115400305896625,13675,Upregulated,1000,5
cysZ,1228,1754,0.5143381870745536,526,Unchanged,1000,5
zipA,6068,3569,-0.7657011841980108,-2499,Downregulated,1000,5
ligA,3873,5243,0.43694104448800836,1370,Upregulated,1000,5
yfeH,505,1848,1.8716094637769005,1343,Upregulated,1000,5
yfeR,249,1853,2.895645233959185,1604,Upregulated,1000,5
yfeN,124,972,2.970616193218906,848,Unchanged,1000,5
xapA,27,1285,5.572665141917772,1258,Upregulated,1000,5
xapB,252,1929,2.936357504549187,1677,Upregulated,1000,5
xapR,432,1545,1.8385036206282683,1113,Upregulated,1000,5
gltX,10436,4711,-1.147463612149531,-5725,Downregulated,1000,5
yfeD,238,384,0.6901447374132127,146,Unchanged,1000,5
yfeC,183,310,0.7604245669901952,127,Unchanged,1000,5
pdeA,2579,3873,0.5866397282391328,1294,Upregulated,1000,5
insL3,895,2493,1.4779232953398818,1598,Upregulated,1000,5
nupC,4556,2436,-0.9032536138017795,-2120,Downregulated,1000,5
mntH,249,2205,3.146561008376802,1956,Upregulated,1000,5
ypeC,313,495,0.6612658680343536,182,Unchanged,1000,5
yfeO,189,1851,3.2918467556495017,1662,Upregulated,1000,5
glk,3112,4006,0.36432036082651587,894,Unchanged,1000,5
fryB,3,312,6.700439718141092,309,Unchanged,1000,5
fryC,28,2076,6.212235806300277,2048,Upregulated,1000,5
ypdF,49,1997,5.348908773328764,1948,Upregulated,1000,5
ypdE,24,1459,5.925801667196735,1435,Upregulated,1000,5
fryA,199,4641,4.543595361626543,4442,Upregulated,1000,5
ypdC,232,1474,2.6675398139674975,1242,Upregulated,1000,5
pyrR,434,979,1.1736138171592156,545,Unchanged,1000,5
pyrS,303,2444,3.0118545863457786,2141,Upregulated,1000,5
alaC,1743,2657,0.6082256583648216,914,Unchanged,1000,5
lpxP,110,1433,3.703463180737486,1323,Upregulated,1000,5
yfdY,183,163,-0.16697168405296492,-20,Unchanged,1000,5
ypdI,5,106,4.405992359675837,101,Unchanged,1000,5
yfdX,40,573,3.8404632338695426,533,Unchanged,1000,5
frc,63,1091,4.114155462823691,1028,Upregulated,1000,5
oxc,43,1478,5.103165799444053,1435,Upregulated,1000,5
yfdV,24,609,4.6653359171851765,585,Unchanged,1000,5
yfdE,57,951,4.060411516695822,894,Unchanged,1000,5
evgS,3760,2604,-0.5300032133993643,-1156,Downregulated,1000,5
evgA,2842,729,-1.9629158349158433,-2113,Downregulated,1000,5
emrK,75,574,2.936088236179807,499,Unchanged,1000,5
emrY,53,797,3.910515459427273,744,Unchanged,1000,5
dsdA,519,1365,1.3950945074493342,846,Unchanged,1000,5
dsdX,86,1253,3.8649059446197627,1167,Upregulated,1000,5
dsdC,460,896,0.9618648711132289,436,Unchanged,1000,5
yfdT,8,130,4.022367813028454,122,Unchanged,1000,5
yfdS,5,163,5.026800059343715,158,Unchanged,1000,5
yfdR,2,349,7.447083226209652,347,Unchanged,1000,5
yfdQ,53,650,3.616375453352618,597,Unchanged,1000,5
yfdP,8,218,4.768184324776926,210,Unchanged,1000,5
yfdO,5,596,6.897240425574799,591,Unchanged,1000,5
yfdN,3,448,7.222392421336448,445,Unchanged,1000,5
yfdM,2,163,6.348728154231077,161,Unchanged,1000,5
yfdL,5,424,6.405992359675837,419,Unchanged,1000,5
yfdK,61,245,2.0059006014396843,184,Unchanged,1000,5
tfaS,22,129,2.5517956367859567,107,Unchanged,1000,5
yfdI,514,142,-1.855877429689196,-372,Unchanged,1000,5
yfdH,920,562,-0.7110637307234491,-358,Unchanged,1000,5
yfdG,289,212,-0.4470052279374796,-77,Unchanged,1000,5
intS,574,1301,1.1804983200421075,727,Unchanged,1000,5
yfdC,477,900,0.9159357352115255,423,Unchanged,1000,5
mlaA,5785,1100,-2.3948134355828303,-4685,Downregulated,1000,5
yfdF,46,258,2.4876652993662414,212,Unchanged,1000,5
fadL,415,1341,1.6921259956701868,926,Unchanged,1000,5
yfcZ,971,280,-1.7940444684742258,-691,Unchanged,1000,5
fadI,57,1688,4.888209174542443,1631,Upregulated,1000,5
fadJ,295,3042,3.366233293475293,2747,Upregulated,1000,5
sixA,1782,871,-1.0327527129230574,-911,Unchanged,1000,5
yfcV,9,496,5.784271308944563,487,Unchanged,1000,5
yfcS,23,1040,5.498805856971441,1017,Upregulated,1000,5
yfcR,35,439,3.6487941125903918,404,Unchanged,1000,5
yfcQ,22,441,4.325203226920223,419,Unchanged,1000,5
yfcP,27,675,4.643856189774724,648,Unchanged,1000,5
yfcO,624,971,0.6379252665569439,347,Unchanged,1000,5
smrB,1050,1099,0.06580205839574609,49,Unchanged,1000,5
prmB,4764,2105,-1.1783531799103557,-2659,Downregulated,1000,5
aroC,6610,3877,-0.7697095366438736,-2733,Downregulated,1000,5
mepA,2355,1967,-0.25973010222161524,-388,Unchanged,1000,5
yfcA,1300,1687,0.3759483503717489,387,Unchanged,1000,5
epmC,1294,1022,-0.34044242105488615,-272,Unchanged,1000,5
yfcL,394,370,-0.09067035894006407,-24,Unchanged,1000,5
mnmC,1426,4951,1.7957459675182725,3525,Upregulated,1000,5
fabB,4505,8243,0.8716423888252957,3738,Upregulated,1000,5
yfcJ,390,2621,2.7485713245788066,2231,Upregulated,1000,5
flk,872,1911,1.1319277382005304,1039,Upregulated,1000,5
pdxB,3710,3424,-0.11573648510701863,-286,Unchanged,1000,5
usg,1978,2961,0.5820420644184431,983,Unchanged,1000,5
truA,555,1242,1.162105496983013,687,Unchanged,1000,5
dedA,692,1230,0.8298143725898777,538,Unchanged,1000,5
accD,13002,4494,-1.5326615296349224,-8508,Downregulated,1000,5
folC,2611,3447,0.40073884105442764,836,Unchanged,1000,5
dedD,2006,1673,-0.26188416057382796,-333,Unchanged,1000,5
cvpA,4868,2123,-1.1972247968083507,-2745,Downregulated,1000,5
purF,7738,5515,-0.48859984296447145,-2223,Downregulated,1000,5
ubiX,634,1019,0.6845993060264066,385,Unchanged,1000,5
argT,206,1178,2.515623296647242,972,Unchanged,1000,5
hisJ,1225,3490,1.5104452872070817,2265,Upregulated,1000,5
hisQ,422,1865,2.143860726435415,1443,Upregulated,1000,5
hisM,278,1192,2.100227447738654,914,Unchanged,1000,5
hisP,311,1687,2.4394734881569633,1376,Upregulated,1000,5
rpnB,127,895,2.817059185379453,768,Unchanged,1000,5
yfcH,1907,2064,0.11413812711049784,157,Unchanged,1000,5
folX,662,308,-1.1039008661123162,-354,Unchanged,1000,5
yfcG,248,841,1.761765679868269,593,Unchanged,1000,5
yfcF,507,894,0.8182890841799771,387,Unchanged,1000,5
yfcE,2076,1156,-0.8446650458572021,-920,Unchanged,1000,5
yfcD,2943,1323,-1.153474480661718,-1620,Downregulated,1000,5
yfcC,1489,2693,0.8548704759195719,1204,Upregulated,1000,5
pta,1966,4752,1.2732715144601852,2786,Upregulated,1000,5
ackA,2,1,-1.0,-1,Unchanged,1000,5
yfbV,1435,1347,-0.09130088610074703,-88,Unchanged,1000,5
yfbU,2808,1368,-1.0374747054186628,-1440,Downregulated,1000,5
hxpA,4106,2090,-0.9742306851403568,-2016,Downregulated,1000,5
yfbS,1499,3405,1.183654414951574,1906,Upregulated,1000,5
yfbR,796,862,0.1149194385454494,66,Unchanged,1000,5
alaA,4858,2801,-0.7944205065613587,-2057,Downregulated,1000,5
lrhA,1614,2427,0.5885335298733533,813,Unchanged,1000,5
nuoA,1799,1096,-0.7149473882909556,-703,Unchanged,1000,5
nuoB,4216,2742,-0.6206462958579887,-1474,Downregulated,1000,5
nuoC,9393,7895,-0.25064674311222684,-1498,Downregulated,1000,5
nuoE,2488,1928,-0.3678814339006409,-560,Unchanged,1000,5
nuoF,6727,5652,-0.2512017924974152,-1075,Downregulated,1000,5
nuoG,10852,10182,-0.09193998201804657,-670,Unchanged,1000,5
nuoH,3331,2832,-0.23413408859135365,-499,Unchanged,1000,5
nuoI,1099,1533,0.4801663107095463,434,Unchanged,1000,5
nuoJ,1365,1481,0.11767068948163283,116,Unchanged,1000,5
nuoK,291,389,0.418751002077908,98,Unchanged,1000,5
nuoL,4609,5209,0.17655266941405348,600,Unchanged,1000,5
nuoM,3547,3878,0.12871347317160373,331,Unchanged,1000,5
nuoN,5211,4153,-0.3274063830067539,-1058,Downregulated,1000,5
yfbP,59,838,3.8281633843375102,779,Unchanged,1000,5
yfbO,30,176,2.5525410230287786,146,Unchanged,1000,5
yfbN,19,398,4.3886971071000636,379,Unchanged,1000,5
yfbM,173,631,1.8668679673458244,458,Unchanged,1000,5
yfbL,28,1046,5.223312214189337,1018,Upregulated,1000,5
yfbK,79,2576,5.027136129937515,2497,Upregulated,1000,5
elaD,55,415,2.9156078127096277,360,Unchanged,1000,5
rbn,411,1558,1.9224849343799864,1147,Upregulated,1000,5
elaA,690,784,0.18425729244967684,94,Unchanged,1000,5
elaB,9861,641,-3.9433376951827253,-9220,Downregulated,1000,5
menF,1610,2641,0.7140236131651136,1031,Upregulated,1000,5
menD,1714,4043,1.238059094159195,2329,Upregulated,1000,5
menH,147,1329,3.17645304443981,1182,Upregulated,1000,5
menB,3115,2260,-0.4629093906088141,-855,Unchanged,1000,5
menC,2646,2405,-0.13777616762127248,-241,Unchanged,1000,5
menE,1821,3248,0.834820710208338,1427,Upregulated,1000,5
pmrD,174,246,0.49957100949051153,72,Unchanged,1000,5
arnF,69,400,2.5353317329965557,331,Unchanged,1000,5
arnT,173,2970,4.101618988051404,2797,Upregulated,1000,5
arnD,129,1585,3.6190398696035158,1456,Upregulated,1000,5
arnA,615,3468,2.4954455829952327,2853,Upregulated,1000,5
arnC,164,1267,2.9496488045227256,1103,Upregulated,1000,5
arnB,326,2036,2.6427936918446178,1710,Upregulated,1000,5
ais,34,458,3.7517409468466045,424,Unchanged,1000,5
nudI,203,508,1.3233487695869897,305,Unchanged,1000,5
yfaZ,155,796,2.3605002152694112,641,Unchanged,1000,5
yfaY,1564,2724,0.8004861907047189,1160,Upregulated,1000,5
yfaX,17,1011,5.894104440652675,994,Unchanged,1000,5
rhmD,49,2224,5.504231228608299,2175,Upregulated,1000,5
yfaV,37,2380,6.007292492566356,2343,Upregulated,1000,5
yfaU,40,1353,5.0800180290891745,1313,Upregulated,1000,5
rpnE,283,1170,2.0476345716388846,887,Unchanged,1000,5
glpC,14723,6938,-1.0854799232219399,-7785,Downregulated,1000,5
glpB,17244,9755,-0.8218806896821039,-7489,Downregulated,1000,5
glpA,27879,16500,-0.7567127892131932,-11379,Downregulated,1000,5
glpT,9621,4959,-0.956137629149333,-4662,Downregulated,1000,5
glpQ,8403,3497,-1.2647866880979461,-4906,Downregulated,1000,5
yfaH,3,106,5.142957953842043,103,Unchanged,1000,5
inaA,544,1205,1.1473545898669844,661,Unchanged,1000,5
yfaE,201,241,0.26183764505103296,40,Unchanged,1000,5
nrdB,2013,2355,0.2263798875788059,342,Unchanged,1000,5
nrdA,1142,4666,2.0306236566213562,3524,Upregulated,1000,5
yfaL,1171,6569,2.487932689709059,5398,Upregulated,1000,5
ubiG,1622,1788,0.14057291696604474,166,Unchanged,1000,5
gyrA,16891,12835,-0.39617144681057487,-4056,Downregulated,1000,5
yfaA,167,2759,4.046225448879221,2592,Upregulated,1000,5
yfaT,17,849,5.642157902302699,832,Unchanged,1000,5
yfaQ,111,2774,4.643336205973497,2663,Upregulated,1000,5
yfaP,28,1013,5.1770635367435345,985,Unchanged,1000,5
atoB,96,1658,4.110265790774594,1562,Upregulated,1000,5
atoE,62,2130,5.102441404726325,2068,Upregulated,1000,5
atoA,9,989,6.779901709316799,980,Unchanged,1000,5
atoD,12,953,6.311369903188786,941,Unchanged,1000,5
atoC,286,1897,2.7296326266330864,1611,Upregulated,1000,5
atoS,165,2557,3.953914230995833,2392,Upregulated,1000,5
rcsC,3070,5008,0.7059959066750766,1938,Upregulated,1000,5
rcsB,6121,2103,-1.5413185180747846,-4018,Downregulated,1000,5
rcsD,7900,6604,-0.25851253303856964,-1296,Downregulated,1000,5
ompC,353442,36375,-3.2804543343829895,-317067,Downregulated,1000,5
ftp,341,2012,2.5607866607813548,1671,Upregulated,1000,5
ada,613,2311,1.9145582807768495,1698,Upregulated,1000,5
alkB,157,1046,2.7360463873553145,889,Unchanged,1000,5
yojI,106,2952,4.799556551497197,2846,Upregulated,1000,5
mqo,82,3739,5.510884751240085,3657,Upregulated,1000,5
eco,1033,860,-0.26443168927559924,-173,Unchanged,1000,5
napF,210,1020,2.2801079191927354,810,Unchanged,1000,5
napD,41,288,2.812372996824229,247,Unchanged,1000,5
napA,1787,7122,1.9947428013215722,5335,Upregulated,1000,5
napG,268,1491,2.47597535182567,1223,Upregulated,1000,5
napH,250,1942,2.957543200757105,1692,Upregulated,1000,5
napB,144,787,2.450294824065174,643,Unchanged,1000,5
napC,321,946,1.5592668862170922,625,Unchanged,1000,5
ccmA,437,1405,1.68486494560769,968,Unchanged,1000,5
ccmB,202,1227,2.6027080509111102,1025,Upregulated,1000,5
ccmC,401,1443,1.8473971580362778,1042,Upregulated,1000,5
ccmD,39,184,2.2381597371947644,145,Unchanged,1000,5
ccmE,332,939,1.4999419163068497,607,Unchanged,1000,5
ccmF,792,4796,2.598259323334614,4004,Upregulated,1000,5
ccmG,203,921,2.1817214289061595,718,Unchanged,1000,5
ccmH,455,1900,2.0620609681322515,1445,Upregulated,1000,5
narP,1519,1264,-0.2651254063249806,-255,Unchanged,1000,5
insH8,7246,3927,-0.8837572077868905,-3319,Downregulated,1000,5
yejM,1918,3987,1.0557008849792,2069,Upregulated,1000,5
yejL,277,210,-0.3994966483830657,-67,Unchanged,1000,5
yejK,3066,2200,-0.47885417324675567,-866,Unchanged,1000,5
rplY,9196,1156,-2.991865068217501,-8040,Downregulated,1000,5
radD,504,3226,2.6782507996557263,2722,Upregulated,1000,5
rsuA,1416,1479,0.06280078701607025,63,Unchanged,1000,5
bcr,1387,2263,0.7062687969432897,876,Unchanged,1000,5
yejG,163,505,1.6314114234080794,342,Unchanged,1000,5
yejF,716,2588,1.8538061247282511,1872,Upregulated,1000,5
yejE,272,1356,2.3176786218860044,1084,Upregulated,1000,5
yejB,322,1590,2.3038941720571007,1268,Upregulated,1000,5
yejA,1017,2815,1.4688152431100918,1798,Upregulated,1000,5
pdeN,611,2480,2.021095835455508,1869,Upregulated,1000,5
mepS,8428,1858,-2.1814398124346535,-6570,Downregulated,1000,5
lpxT,494,771,0.6422198183303567,277,Unchanged,1000,5
yeiR,757,1704,1.1705601302401067,947,Unchanged,1000,5
yeiQ,90,2504,4.798165750602943,2414,Upregulated,1000,5
yeiP,1136,542,-1.0675980781508105,-594,Unchanged,1000,5
setB,91,1872,4.362570079384708,1781,Upregulated,1000,5
fruB,12073,3052,-1.9839573462841358,-9021,Downregulated,1000,5
fruK,8840,2580,-1.7766753039681773,-6260,Downregulated,1000,5
fruA,22641,5623,-2.009525728050357,-17018,Downregulated,1000,5
psuK,40,977,4.610286657081023,937,Unchanged,1000,5
psuG,83,1428,4.104740832682175,1345,Upregulated,1000,5
psuT,211,2147,3.3470072871515884,1936,Upregulated,1000,5
yeiL,35,501,3.839383776250242,466,Unchanged,1000,5
rihB,21,1173,5.803669875249748,1152,Upregulated,1000,5
nupX,52,1823,5.131659127898042,1771,Upregulated,1000,5
yeiI,661,1942,1.5548210239115006,1281,Upregulated,1000,5
nfo,985,1790,0.8617639578078801,805,Unchanged,1000,5
yeiH,1807,1907,0.07770833744815672,100,Unchanged,1000,5
yeiE,1258,1735,0.46380374058633406,477,Unchanged,1000,5
lysP,3826,2848,-0.4258877273797146,-978,Unchanged,1000,5
cirA,218,3231,3.8895807104884375,3013,Upregulated,1000,5
yeiG,3311,3785,0.19302628947609457,474,Unchanged,1000,5
folE,6927,1649,-2.0706392750578044,-5278,Downregulated,1000,5
yeiB,1356,2163,0.6736764868256349,807,Unchanged,1000,5
galS,218,1860,3.092902581218467,1642,Upregulated,1000,5
mglB,126,1676,3.733526510199435,1550,Upregulated,1000,5
mglA,30,1812,5.916476644437717,1782,Upregulated,1000,5
mglC,34,1684,5.630213581816057,1650,Upregulated,1000,5
preA,1569,2762,0.8158679672899533,1193,Upregulated,1000,5
preT,2219,3272,0.5602630807447375,1053,Upregulated,1000,5
yeiS,54,189,1.8073549220576042,135,Unchanged,1000,5
sanA,314,929,1.5649140374910258,615,Unchanged,1000,5
cdd,632,2438,1.9477016624431092,1806,Upregulated,1000,5
yohK,185,1505,3.0241663111307524,1320,Upregulated,1000,5
yohJ,86,802,3.2211936717528222,716,Unchanged,1000,5
dusC,165,2308,3.806105294399667,2143,Upregulated,1000,5
mdtQ,39,3047,6.2877715658242375,3008,Upregulated,1000,5
yohF,287,1591,2.47081119365536,1304,Upregulated,1000,5
yohD,419,1101,1.3937923198650173,682,Unchanged,1000,5
yohC,377,1073,1.5090136474878577,696,Unchanged,1000,5
pbpG,1595,1746,0.13049713497720836,151,Unchanged,1000,5
dld,4718,4521,-0.0615335009204825,-197,Unchanged,1000,5
bglX,3112,6246,1.0050905090343814,3134,Upregulated,1000,5
osmF,919,1761,0.9382581425421738,842,Unchanged,1000,5
yehY,448,2612,2.543584259488827,2164,Upregulated,1000,5
yehX,252,2102,3.060267030462262,1850,Upregulated,1000,5
yehW,135,1352,3.3240638392313535,1217,Upregulated,1000,5
mlrA,430,1274,1.5669567126668402,844,Unchanged,1000,5
btsS,453,3196,2.8186844528817416,2743,Upregulated,1000,5
btsR,363,1122,1.628031222613042,759,Unchanged,1000,5
yehS,271,770,1.5065655942283922,499,Unchanged,1000,5
yehR,16,435,4.764871590736091,419,Unchanged,1000,5
yehQ,123,3454,4.8115378621896845,3331,Upregulated,1000,5
yehP,32,1860,5.861086905995394,1828,Upregulated,1000,5
yehM,68,4365,6.004303097266463,4297,Upregulated,1000,5
yehL,22,1949,6.469086756620593,1927,Upregulated,1000,5
yehI,305,5956,4.287462606131851,5651,Upregulated,1000,5
metG,10395,6258,-0.7321161945048105,-4137,Downregulated,1000,5
mrp,6457,4014,-0.6858234103847323,-2443,Downregulated,1000,5
yehE,273,95,-1.5229015325889046,-178,Unchanged,1000,5
yehD,115,218,0.9226942738325511,103,Unchanged,1000,5
yehC,16,387,4.59618975614441,371,Unchanged,1000,5
yehB,89,2652,4.89713162914619,2563,Upregulated,1000,5
yehA,18,434,4.5916262310021665,416,Unchanged,1000,5
rcnB,1118,456,-1.2938144586784484,-662,Unchanged,1000,5
rcnA,78,1094,3.809994803930308,1016,Upregulated,1000,5
rcnR,115,276,1.2630344058337937,161,Unchanged,1000,5
thiM,194,1102,2.50599566638403,908,Unchanged,1000,5
thiD,232,1166,2.329371078072924,934,Unchanged,1000,5
yegX,154,1141,2.8892965355937803,987,Unchanged,1000,5
yegW,332,1003,1.595066459265256,671,Unchanged,1000,5
yegV,288,1793,2.6382347714260623,1505,Upregulated,1000,5
yegU,323,1996,2.627505650643336,1673,Upregulated,1000,5
yegT,140,2037,3.8629472480209217,1897,Upregulated,1000,5
fbaB,28402,3261,-3.1226061781960226,-25141,Downregulated,1000,5
gatY,63081,52673,-0.2601419000437396,-10408,Downregulated,1000,5
gatZ,94167,68585,-0.45732848476521315,-25582,Downregulated,1000,5
gatA,12288,8185,-0.5861957993596403,-4103,Downregulated,1000,5
gatB,6011,1944,-1.6285768011158377,-4067,Downregulated,1000,5
gatC,39885,22508,-0.825408409408629,-17377,Downregulated,1000,5
gatD,5237,6935,0.405155277761614,1698,Upregulated,1000,5
insF5,30,675,4.491853096329675,645,Unchanged,1000,5
insE5,80,103,0.3645724322958561,23,Unchanged,1000,5
yegS,830,1382,0.7355743741539715,552,Unchanged,1000,5
yegR,26,87,1.7425037777076362,61,Unchanged,1000,5
yegZ,5,57,3.5109619192773796,52,Unchanged,1000,5
ogrK,95,130,0.4525122046975067,35,Unchanged,1000,5
trhP,1783,3475,0.9627062748732371,1692,Upregulated,1000,5
yegP,396,276,-0.5208321633014404,-120,Unchanged,1000,5
baeR,709,1435,1.017193204323534,726,Unchanged,1000,5
baeS,206,2176,3.400962314067121,1970,Upregulated,1000,5
mdtD,195,2620,3.748020782675202,2425,Upregulated,1000,5
mdtC,498,6795,3.7702559035866727,6297,Upregulated,1000,5
mdtB,687,7160,3.3815775833335184,6473,Upregulated,1000,5
mdtA,358,2090,2.5454714497039888,1732,Upregulated,1000,5
yegL,54,1058,4.292236409950557,1004,Upregulated,1000,5
pphC,23,1372,5.898502810115799,1349,Upregulated,1000,5
yegJ,19,339,4.157213949692759,320,Unchanged,1000,5
yegI,167,3354,4.327962681090294,3187,Upregulated,1000,5
yegD,419,2672,2.6728978587747005,2253,Upregulated,1000,5
alkA,316,1378,2.1245794245271883,1062,Upregulated,1000,5
dgcE,1170,6681,2.5135555290381792,5511,Upregulated,1000,5
udk,1166,1154,-0.014924564555013892,-12,Unchanged,1000,5
dcd,3006,2147,-0.4855228180575914,-859,Unchanged,1000,5
asmA,3564,4666,0.38868897046227724,1102,Upregulated,1000,5
yegH,1224,3651,1.5766881107422328,2427,Upregulated,1000,5
wza,169,1416,3.0667261138008133,1247,Upregulated,1000,5
wzb,37,533,3.848538357130226,496,Unchanged,1000,5
wzc,342,3733,3.448267278417172,3391,Upregulated,1000,5
wcaA,129,1122,3.1206297051855385,993,Unchanged,1000,5
wcaB,60,557,3.2146429217315133,497,Unchanged,1000,5
wcaC,155,1827,3.559136513353251,1672,Upregulated,1000,5
wcaD,137,944,2.7846109664013143,807,Unchanged,1000,5
wcaE,64,682,3.4136279290241727,618,Unchanged,1000,5
wcaF,31,426,3.780513309838963,395,Unchanged,1000,5
gmd,291,1452,2.318950395087467,1161,Upregulated,1000,5
fcl,241,1314,2.446860224092368,1073,Upregulated,1000,5
gmm,66,437,2.727095350142145,371,Unchanged,1000,5
wcaI,137,1658,3.5971962085352236,1521,Upregulated,1000,5
cpsB,146,2095,3.842909969706697,1949,Upregulated,1000,5
cpsG,135,1835,3.764748750679744,1700,Upregulated,1000,5
wcaJ,108,1972,4.190556334214443,1864,Upregulated,1000,5
wzxC,103,1853,4.1691466388440475,1750,Upregulated,1000,5
wcaK,198,1800,3.1844245711374275,1602,Upregulated,1000,5
wcaL,283,1732,2.6135649718948426,1449,Upregulated,1000,5
wcaM,260,1368,2.3954847018574434,1108,Upregulated,1000,5
galF,12704,2315,-2.456198718995359,-10389,Downregulated,1000,5
rfbB,4733,1652,-1.5185412353189183,-3081,Downregulated,1000,5
rfbD,3083,1511,-1.028831228942346,-1572,Downregulated,1000,5
rfbA,3124,1145,-1.448046855157673,-1979,Downregulated,1000,5
rfbC,1192,395,-1.5934596773976963,-797,Unchanged,1000,5
rfbX,1662,601,-1.467483486059159,-1061,Downregulated,1000,5
glf,2686,1029,-1.3842163225334738,-1657,Downregulated,1000,5
wbbH,987,513,-0.9440912588493436,-474,Unchanged,1000,5
wbbI,2331,592,-1.9772799234999165,-1739,Downregulated,1000,5
wbbJ,1085,583,-0.8961272541313453,-502,Unchanged,1000,5
wbbK,1597,283,-2.4964903545793504,-1314,Downregulated,1000,5
insH7,2926,2885,-0.02035845060564203,-41,Unchanged,1000,5
gnd,40426,5825,-2.7949535065669906,-34601,Downregulated,1000,5
ugd,1130,905,-0.3203330753319823,-225,Unchanged,1000,5
wzzB,6004,2255,-1.412796543477945,-3749,Downregulated,1000,5
hisI,1914,1093,-0.808297428814121,-821,Unchanged,1000,5
hisF,1889,1433,-0.39858409212622414,-456,Unchanged,1000,5
hisA,1544,1471,-0.06987550601325024,-73,Unchanged,1000,5
hisH,1302,1105,-0.23668307888684156,-197,Unchanged,1000,5
hisB,3244,2322,-0.4824058473517066,-922,Unchanged,1000,5
hisC,2844,2568,-0.1472762624971122,-276,Unchanged,1000,5
hisD,3180,3383,0.0892764116222706,203,Unchanged,1000,5
hisG,2132,2193,0.04069837391441764,61,Unchanged,1000,5
hisL,1,1,0.0,0,Unchanged,1000,5
yefM,295,285,-0.049753035197099615,-10,Unchanged,1000,5
yeeZ,3853,2428,-0.6662137644038679,-1425,Downregulated,1000,5
yeeY,311,1361,2.129680581373392,1050,Upregulated,1000,5
plaP,1482,1908,0.36451572369967766,426,Unchanged,1000,5
yeeE,251,2267,3.175025121790014,2016,Upregulated,1000,5
yeeD,97,310,1.67621156308711,213,Unchanged,1000,5
sbcB,2188,2526,0.20724190099499581,338,Unchanged,1000,5
dacD,369,1468,1.9921592467828166,1099,Upregulated,1000,5
sbmC,870,514,-0.7592470415422125,-356,Unchanged,1000,5
yeeA,580,1031,0.829919527353174,451,Unchanged,1000,5
yeeX,6484,1324,-2.291980968710324,-5160,Downregulated,1000,5
yeeW,6,27,2.169925001442312,21,Unchanged,1000,5
cbtA,9,194,4.429987840744816,185,Unchanged,1000,5
cbeA,17,318,4.225420114034016,301,Unchanged,1000,5
yeeT,5,88,4.137503523749935,83,Unchanged,1000,5
yeeS,81,450,2.473931188332412,369,Unchanged,1000,5
yeeR,1122,2184,0.9609001803110596,1062,Upregulated,1000,5
flu,38462,25731,-0.5799262573462889,-12731,Downregulated,1000,5
yeeP,83,557,2.746494085993107,474,Unchanged,1000,5
insC3,233,153,-0.6067983019616285,-80,Unchanged,1000,5
insD3,456,438,-0.05810295456356828,-18,Unchanged,1000,5
insH6,511,1656,1.6963074765617039,1145,Upregulated,1000,5
cobU,194,535,1.4634822391013815,341,Unchanged,1000,5
cobS,373,1097,1.556315990147955,724,Unchanged,1000,5
cobT,829,1589,0.9386751178527688,760,Unchanged,1000,5
ldtA,1397,1039,-0.4271363665052513,-358,Unchanged,1000,5
nac,79,638,3.0136318655877665,559,Unchanged,1000,5
cbl,117,875,2.902774487136287,758,Unchanged,1000,5
yeeO,650,1648,1.3422046192674015,998,Unchanged,1000,5
yeeN,1875,761,-1.30092223676706,-1114,Downregulated,1000,5
amn,4097,2585,-0.6644036122780042,-1512,Downregulated,1000,5
shiA,1386,1416,0.030894007945783775,30,Unchanged,1000,5
yeeJ,1294,7180,2.472146226717906,5886,Upregulated,1000,5
mtfA,1449,900,-0.6870606883398924,-549,Unchanged,1000,5
yodB,70,270,1.9475325801058645,200,Unchanged,1000,5
zinT,51,190,1.8974302663594522,139,Unchanged,1000,5
msrQ,194,536,1.4661763482706447,342,Unchanged,1000,5
msrP,476,1049,1.1399811992693243,573,Unchanged,1000,5
hiuH,31,173,2.4804319172498497,142,Unchanged,1000,5
hprR,378,491,0.3773367900936203,113,Unchanged,1000,5
hprS,416,747,0.8445247146481449,331,Unchanged,1000,5
hchA,6245,911,-2.7771786126932687,-5334,Downregulated,1000,5
drpB,486,353,-0.4612881303346007,-133,Unchanged,1000,5
yedJ,1422,1072,-0.40761655916164274,-350,Unchanged,1000,5
dcm,2938,2402,-0.2905982448506457,-536,Unchanged,1000,5
vsr,225,410,0.865698908288409,185,Unchanged,1000,5
yedA,31,882,4.830438535170646,851,Unchanged,1000,5
yedI,806,1206,0.5813781633721175,400,Unchanged,1000,5
yodC,133,80,-0.7333543406138273,-53,Unchanged,1000,5
dgcQ,1065,2066,0.9559868237518588,1001,Upregulated,1000,5
yedP,900,874,-0.04229172171643864,-26,Unchanged,1000,5
dsrA,1,1,0.0,0,Unchanged,1000,5
yodD,312,101,-1.6271907361104536,-211,Unchanged,1000,5
dsrB,115,50,-1.2016338611696507,-65,Unchanged,1000,5
rcsA,605,214,-1.49932434576081,-391,Unchanged,1000,5
fliR,70,733,3.3883863711888456,663,Unchanged,1000,5
fliQ,39,187,2.261492241025388,148,Unchanged,1000,5
fliP,195,683,1.8084114545404797,488,Unchanged,1000,5
fliO,160,315,0.9772799234999164,155,Unchanged,1000,5
fliN,343,301,-0.1884450894131103,-42,Unchanged,1000,5
fliM,895,1085,0.277735455180223,190,Unchanged,1000,5
fliL,388,325,-0.25561693427131077,-63,Unchanged,1000,5
fliK,341,1315,1.9472191551554923,974,Unchanged,1000,5
fliJ,128,315,1.2992080183872787,187,Unchanged,1000,5
fliI,526,1813,1.7852442204518557,1287,Upregulated,1000,5
fliH,546,839,0.6197698595199709,293,Unchanged,1000,5
fliG,755,1299,0.78285288123544,544,Unchanged,1000,5
fliF,1100,2147,0.9648186674467513,1047,Upregulated,1000,5
fliE,356,213,-0.7410238107405596,-143,Unchanged,1000,5
intG,1,14,3.807354922057604,13,Unchanged,1000,5
yedL,77,406,2.398549376490275,329,Unchanged,1000,5
yedK,102,706,2.7910990312996846,604,Unchanged,1000,5
yedF,150,110,-0.4474589769712214,-40,Unchanged,1000,5
yedE,1585,1795,0.17950100368364416,210,Unchanged,1000,5
yedD,1123,564,-0.9935908600018076,-559,Unchanged,1000,5
amyA,977,1698,0.7974059915846532,721,Unchanged,1000,5
fliT,50,268,2.4222330006830477,218,Unchanged,1000,5
fliS,97,263,1.4390061471051747,166,Unchanged,1000,5
fliD,453,1915,2.079761436766084,1462,Upregulated,1000,5
fliC,4914,1763,-1.4788653830419831,-3151,Downregulated,1000,5
fliA,2101,761,-1.4651078031695006,-1340,Downregulated,1000,5
fliZ,827,527,-0.6500843675340601,-300,Unchanged,1000,5
tcyJ,4462,4044,-0.14190751634112583,-418,Unchanged,1000,5
dcyD,2511,2486,-0.01443573221901491,-25,Unchanged,1000,5
tcyL,929,1102,0.24637372218850462,173,Unchanged,1000,5
tcyN,1082,1431,0.4033231728998524,349,Unchanged,1000,5
sdiA,168,686,2.029747343394052,518,Unchanged,1000,5
yecF,153,71,-1.1076407231879697,-82,Unchanged,1000,5
uvrY,2317,1116,-1.0539210170356341,-1201,Downregulated,1000,5
uvrC,3224,3042,-0.08383159080347061,-182,Unchanged,1000,5
pgsA,1305,840,-0.6355885737911242,-465,Unchanged,1000,5
yecA,2045,1225,-0.7393190939391782,-820,Unchanged,1000,5
tyrP,643,1570,1.287873916451042,927,Unchanged,1000,5
yecH,461,271,-0.7664738990754665,-190,Unchanged,1000,5
ftnA,20910,1511,-3.7906174963121124,-19399,Downregulated,1000,5
yecR,63,203,1.6880559936852597,140,Unchanged,1000,5
ftnB,1587,552,-1.5235619560570128,-1035,Downregulated,1000,5
araF,121,1145,3.2422686457097116,1024,Upregulated,1000,5
araG,171,2094,3.6141932120449107,1923,Upregulated,1000,5
otsB,2591,1202,-1.108072119468909,-1389,Downregulated,1000,5
otsA,8145,2323,-1.8099255446040725,-5822,Downregulated,1000,5
uspC,284,318,0.1631358357796734,34,Unchanged,1000,5
insA5,26,90,1.7914133781885826,64,Unchanged,1000,5
insB5,32,769,4.586839787961827,737,Unchanged,1000,5
flhD,773,319,-1.276911990159978,-454,Unchanged,1000,5
flhC,1344,571,-1.2349704874159175,-773,Unchanged,1000,5
motA,183,1257,2.780069096136465,1074,Upregulated,1000,5
motB,154,1315,3.0940605434847632,1161,Upregulated,1000,5
cheA,517,2872,2.473819563508117,2355,Upregulated,1000,5
cheW,188,540,1.5222267453731935,352,Unchanged,1000,5
tar,475,2445,2.363835046621286,1970,Upregulated,1000,5
tap,282,2352,3.0601209924375707,2070,Upregulated,1000,5
cheR,124,1158,3.2232232276023614,1034,Upregulated,1000,5
cheB,99,1349,3.768318012868658,1250,Upregulated,1000,5
cheY,95,346,1.864772619305777,251,Unchanged,1000,5
cheZ,243,875,1.8483267031139103,632,Unchanged,1000,5
flhB,506,1618,1.6770023177356674,1112,Upregulated,1000,5
flhA,997,3210,1.6869078876114694,2213,Upregulated,1000,5
flhE,96,337,1.8116422804607022,241,Unchanged,1000,5
yecT,35,172,2.2969817377571315,137,Unchanged,1000,5
argS,4800,3297,-0.5418805188254936,-1503,Downregulated,1000,5
yecM,543,764,0.4926204402313871,221,Unchanged,1000,5
cutC,936,1099,0.23161095136582666,163,Unchanged,1000,5
torY,13,938,6.173004394374285,925,Unchanged,1000,5
torZ,328,3126,3.2525500583815807,2798,Upregulated,1000,5
cmoB,1181,1623,0.4586540351508142,442,Unchanged,1000,5
cmoA,1152,1150,-0.0025068556105748664,-2,Unchanged,1000,5
yecN,669,469,-0.5124182881260844,-200,Unchanged,1000,5
yecE,315,803,1.3500481591300355,488,Unchanged,1000,5
yecD,866,874,0.013266254773873592,8,Unchanged,1000,5
aspS,9753,8775,-0.1524469313322267,-978,Unchanged,1000,5
nudB,978,810,-0.27191255718024665,-168,Unchanged,1000,5
yebC,2981,2288,-0.38170932321277934,-693,Unchanged,1000,5
ruvC,1283,1176,-0.12563311025331814,-107,Unchanged,1000,5
yebB,37,434,3.5520978668155294,397,Unchanged,1000,5
ruvA,769,747,-0.04187535517258934,-22,Unchanged,1000,5
ruvB,2052,1825,-0.16913426695231218,-227,Unchanged,1000,5
znuB,644,963,0.5804751097288424,319,Unchanged,1000,5
znuC,759,939,0.30702527223830817,180,Unchanged,1000,5
znuA,1247,1272,0.028637205454685438,25,Unchanged,1000,5
mepM,4091,3182,-0.3625197015569986,-909,Unchanged,1000,5
lpxM,1591,1727,0.11833424719787643,136,Unchanged,1000,5
pykA,39109,14137,-1.4680246478466752,-24972,Downregulated,1000,5
yebK,829,1338,0.6906341091457104,509,Unchanged,1000,5
zwf,5426,2890,-0.908819554893825,-2536,Downregulated,1000,5
edd,3784,2938,-0.3650776927831154,-846,Unchanged,1000,5
eda,9402,2647,-1.828609485698338,-6755,Downregulated,1000,5
purT,3466,1840,-0.9135658882157943,-1626,Downregulated,1000,5
yebG,1595,615,-1.3748981084256295,-980,Unchanged,1000,5
yebF,1866,906,-1.0423660308055236,-960,Unchanged,1000,5
yebE,617,1215,0.9776139193437254,598,Unchanged,1000,5
ptrB,1446,2692,0.8966108576591993,1246,Upregulated,1000,5
exoX,1039,965,-0.10659480674876895,-74,Unchanged,1000,5
yobB,1053,749,-0.4914678125669659,-304,Unchanged,1000,5
holE,509,130,-1.9691540330472408,-379,Unchanged,1000,5
yobA,1006,736,-0.4508526337485142,-270,Unchanged,1000,5
yebZ,1348,2008,0.5749387727689135,660,Unchanged,1000,5
yebY,664,333,-0.9956610642756626,-331,Unchanged,1000,5
pphA,105,590,2.490325626583081,485,Unchanged,1000,5
yebW,76,48,-0.6629650127224294,-28,Unchanged,1000,5
yebV,517,89,-2.538287039348537,-428,Unchanged,1000,5
rsmF,596,1844,1.6294544199671765,1248,Upregulated,1000,5
letB,2046,3532,0.7876791979031373,1486,Upregulated,1000,5
letA,828,1540,0.8952276780829385,712,Unchanged,1000,5
msrC,4221,843,-2.3239802930156066,-3378,Downregulated,1000,5
proQ,9926,2443,-2.022558591029864,-7483,Downregulated,1000,5
prc,14880,4310,-1.7876147520189332,-10570,Downregulated,1000,5
htpX,5623,4150,-0.4382287104191545,-1473,Downregulated,1000,5
yebQ,59,1292,4.452747305332084,1233,Upregulated,1000,5
kdgR,2476,1831,-0.4353795234169275,-645,Unchanged,1000,5
mgrB,45,11,-2.0324214776923775,-34,Unchanged,1000,5
yebO,760,220,-1.7884958948062881,-540,Unchanged,1000,5
yobF,1076,53,-4.343541907993425,-1023,Downregulated,1000,5
cspC,8006,425,-4.235546869362475,-7581,Downregulated,1000,5
rlmA,545,971,0.8332150657549035,426,Unchanged,1000,5
mntP,177,656,1.8899464545350864,479,Unchanged,1000,5
yobD,853,446,-0.9355020313979854,-407,Unchanged,1000,5
manZ,23603,10209,-1.2091286842324276,-13394,Downregulated,1000,5
manY,23378,10298,-1.1827873365932655,-13080,Downregulated,1000,5
manX,24692,11537,-1.0977755719525577,-13155,Downregulated,1000,5
yoaE,1632,2503,0.6170172337168363,871,Unchanged,1000,5
pdeD,324,1715,2.40414285817555,1391,Upregulated,1000,5
sdaA,1818,2541,0.4830441758592477,723,Unchanged,1000,5
nudL,547,694,0.34339482978570424,147,Unchanged,1000,5
pabB,1206,1971,0.7086978691434009,765,Unchanged,1000,5
yoaH,124,85,-0.5448053742491735,-39,Unchanged,1000,5
yoaC,291,174,-0.7419318470595556,-117,Unchanged,1000,5
yoaB,2553,549,-2.21731548340192,-2004,Downregulated,1000,5
yoaA,2064,3174,0.6208591574119279,1110,Upregulated,1000,5
tsaB,661,1159,0.8101583894987802,498,Unchanged,1000,5
yeaY,919,821,-0.16268263951122966,-98,Unchanged,1000,5
fadD,671,2176,1.6972938850501558,1505,Upregulated,1000,5
rnd,994,1599,0.6858521819180459,605,Unchanged,1000,5
yeaX,155,953,2.6202079986357045,798,Unchanged,1000,5
yeaW,107,1439,3.7493838903391508,1332,Upregulated,1000,5
yeaV,86,1656,4.267222202797227,1570,Upregulated,1000,5
dmlA,87244,1543,-5.8212459497692866,-85701,Downregulated,1000,5
dmlR,1036,1117,0.10860518279676099,81,Unchanged,1000,5
leuE,629,481,-0.38702312310924736,-148,Unchanged,1000,5
yeaR,28,246,3.1351595832816357,218,Unchanged,1000,5
yoaG,2,16,3.0,14,Unchanged,1000,5
yeaQ,2365,186,-3.668465657118726,-2179,Downregulated,1000,5
dgcP,2402,1469,-0.7094017551493541,-933,Unchanged,1000,5
yoaF,80,152,0.925999418556223,72,Unchanged,1000,5
yeaO,358,340,-0.07442484112655467,-18,Unchanged,1000,5
nimT,144,1366,3.245816766847778,1222,Upregulated,1000,5
nimR,279,908,1.7024271754617275,629,Unchanged,1000,5
yeaL,294,508,0.7890123419358014,214,Unchanged,1000,5
yoaI,1,1,0.0,0,Unchanged,1000,5
yeaK,1322,1063,-0.31458057997658706,-259,Unchanged,1000,5
dgcJ,427,1152,1.431832741821822,725,Unchanged,1000,5
cdgI,122,762,2.6429098499304358,640,Unchanged,1000,5
yeaH,733,1323,0.851927958144865,590,Unchanged,1000,5
yeaG,2926,2511,-0.220667740866987,-415,Unchanged,1000,5
mipA,4677,1445,-1.6945139360308996,-3232,Downregulated,1000,5
yeaE,704,1153,0.7117451790144745,449,Unchanged,1000,5
yeaD,11466,1765,-2.69962209554007,-9701,Downregulated,1000,5
gapA,318154,45160,-2.8166078688035605,-272994,Downregulated,1000,5
msrB,802,753,-0.09095237178299216,-49,Unchanged,1000,5
yeaC,448,415,-0.11038739582331702,-33,Unchanged,1000,5
ydjL,137,1262,3.203464112022022,1125,Upregulated,1000,5
ydjK,106,1349,3.6697541783850687,1243,Upregulated,1000,5
ydjJ,99,1112,3.4895844526438977,1013,Upregulated,1000,5
ydjI,154,755,2.2935462935175397,601,Unchanged,1000,5
ydjH,101,849,3.0714092608012438,748,Unchanged,1000,5
ydjG,190,944,2.3127874410308937,754,Unchanged,1000,5
ydjF,463,574,0.3100385434154514,111,Unchanged,1000,5
ydjE,45,1157,4.6843200527778155,1112,Upregulated,1000,5
pncA,444,792,0.8349407537295036,348,Unchanged,1000,5
ansA,561,1260,1.167351057778486,699,Unchanged,1000,5
sppA,1986,2726,0.45691993927683555,740,Unchanged,1000,5
ydjA,1447,1795,0.31091892217868905,348,Unchanged,1000,5
selD,6696,4166,-0.6846366885096968,-2530,Downregulated,1000,5
topB,5499,5407,-0.024340930179042635,-92,Unchanged,1000,5
ynjI,130,717,2.4634614956734504,587,Unchanged,1000,5
gdhA,22177,12819,-0.7907804948627224,-9358,Downregulated,1000,5
ynjH,44,145,1.7204774713776372,101,Unchanged,1000,5
nudG,113,442,1.9677235969762439,329,Unchanged,1000,5
ynjF,329,823,1.3228048466863842,494,Unchanged,1000,5
ynjE,3862,2603,-0.5691728525465383,-1259,Downregulated,1000,5
ynjD,428,825,0.9467833227320311,397,Unchanged,1000,5
ynjC,1098,2504,1.1893565079274198,1406,Upregulated,1000,5
ynjB,2106,2311,0.13401182344191415,205,Unchanged,1000,5
ynjA,767,900,0.23069842371410365,133,Unchanged,1000,5
ydjZ,1499,1177,-0.3488860629094155,-322,Unchanged,1000,5
ydjY,2364,1050,-1.1708407076240475,-1314,Downregulated,1000,5
ydjX,1211,919,-0.39806209840529433,-292,Unchanged,1000,5
xthA,1677,1280,-0.38973887867698387,-397,Unchanged,1000,5
astC,47,2311,5.619712692789993,2264,Upregulated,1000,5
astA,31,1997,6.009422307057098,1966,Upregulated,1000,5
astD,104,2929,4.815752759738275,2825,Upregulated,1000,5
astB,112,2427,4.43760347109353,2315,Upregulated,1000,5
astE,34,1527,5.489021505546512,1493,Upregulated,1000,5
spy,1578,1880,0.25263545655154107,302,Unchanged,1000,5
ves,45,807,4.1645717669481055,762,Unchanged,1000,5
cho,1004,1495,0.5743862151346953,491,Unchanged,1000,5
nadE,6223,2659,-1.2267264690297064,-3564,Downregulated,1000,5
osmE,9861,1027,-3.2632977754832715,-8834,Downregulated,1000,5
chbB,57,168,1.5594274086140185,111,Unchanged,1000,5
chbC,67,1759,4.714450577014189,1692,Upregulated,1000,5
chbA,79,378,2.2584616760439697,299,Unchanged,1000,5
chbR,236,738,1.6448339566985548,502,Unchanged,1000,5
chbF,158,1477,3.224673362587686,1319,Upregulated,1000,5
chbG,370,1035,1.4840335918703755,665,Unchanged,1000,5
katE,10012,3934,-1.3476613334098018,-6078,Downregulated,1000,5
cedA,98,192,0.970252656605948,94,Unchanged,1000,5
ydjO,10,181,4.177917792195843,171,Unchanged,1000,5
tcyP,1608,4421,1.4591053277751376,2813,Upregulated,1000,5
ydjM,149,714,2.260611743566938,565,Unchanged,1000,5
hxpB,873,995,0.18871487180157107,122,Unchanged,1000,5
yniB,1201,781,-0.6208416975636547,-420,Unchanged,1000,5
yniA,3329,2044,-0.7036936742026417,-1285,Downregulated,1000,5
ydiZ,485,236,-1.0391978877126489,-249,Unchanged,1000,5
pfkB,5287,3339,-0.6630332333178263,-1948,Downregulated,1000,5
ydiY,68,803,3.561793336266975,735,Unchanged,1000,5
thrS,43564,13497,-1.6904976541053067,-30067,Downregulated,1000,5
infC,37449,8442,-2.1492704605293826,-29007,Downregulated,1000,5
rpmI,4477,1441,-1.6354619827287968,-3036,Downregulated,1000,5
rplT,29138,6390,-2.1890140195284826,-22748,Downregulated,1000,5
pheM,1,1,0.0,0,Unchanged,1000,5
pheS,4551,2685,-0.7612614980954147,-1866,Downregulated,1000,5
pheT,14837,8307,-0.8367999529957835,-6530,Downregulated,1000,5
ihfA,4496,856,-2.392959333819779,-3640,Downregulated,1000,5
btuC,858,1462,0.7688937584528917,604,Unchanged,1000,5
btuE,1235,640,-0.9483672315846776,-595,Unchanged,1000,5
btuD,992,1084,0.1279527309669964,92,Unchanged,1000,5
nlpC,1156,574,-1.010018755824991,-582,Unchanged,1000,5
rflP,650,520,-0.3219280948873623,-130,Unchanged,1000,5
ydiU,550,2041,1.8917726586206973,1491,Upregulated,1000,5
ydiE,1,74,6.20945336562895,73,Unchanged,1000,5
aroH,2082,1991,-0.0644768475789144,-91,Unchanged,1000,5
ppsR,933,1058,0.18139064126226692,125,Unchanged,1000,5
ppsA,2893,4128,0.5128766474936545,1235,Upregulated,1000,5
fadK,113,1821,4.010336244561651,1708,Upregulated,1000,5
ydiT,12,102,3.0874628412503395,90,Unchanged,1000,5
ydiS,118,1558,3.722836468699828,1440,Upregulated,1000,5
ydiR,136,1197,3.1377445956931624,1061,Upregulated,1000,5
ydiQ,54,838,3.955918931535883,784,Unchanged,1000,5
ydiP,448,659,0.5567797329504476,211,Unchanged,1000,5
ydiO,62,1285,4.373356333694366,1223,Upregulated,1000,5
ydiF,35,1628,5.53960196732128,1593,Upregulated,1000,5
aroD,969,1127,0.21791894475713997,158,Unchanged,1000,5
ydiB,46,788,4.098489863399363,742,Unchanged,1000,5
ydiN,33,1220,5.208271313091795,1187,Upregulated,1000,5
ydiM,17,982,5.852116373064353,965,Unchanged,1000,5
ydiL,13,279,4.423681593688095,266,Unchanged,1000,5
ydiK,2717,2239,-0.2791600373693775,-478,Unchanged,1000,5
ydiJ,20150,10845,-0.8937497857430559,-9305,Downregulated,1000,5
menI,1683,865,-0.960263138805862,-818,Unchanged,1000,5
ydiH,1107,400,-1.4685833170068274,-707,Unchanged,1000,5
sufA,250,384,0.6191782160590692,134,Unchanged,1000,5
sufB,1808,2407,0.4128414640593092,599,Unchanged,1000,5
sufC,839,953,0.18380540347011853,114,Unchanged,1000,5
sufD,1622,1911,0.23655395876018365,289,Unchanged,1000,5
sufS,1259,1702,0.4349527539669462,443,Unchanged,1000,5
sufE,296,350,0.24175774620337906,54,Unchanged,1000,5
ldtE,3764,1416,-1.4104453626455393,-2348,Downregulated,1000,5
lpp,50412,2420,-4.380688239045717,-47992,Downregulated,1000,5
pykF,35641,6452,-2.465719472344591,-29189,Downregulated,1000,5
fumD,568,150,-1.9209284290088013,-418,Unchanged,1000,5
ydhY,1114,502,-1.1499899633892599,-612,Unchanged,1000,5
ydhV,3625,2378,-0.6082322800440033,-1247,Downregulated,1000,5
ydhW,684,751,0.1348165826283738,67,Unchanged,1000,5
ydhX,496,720,0.5376567859427995,224,Unchanged,1000,5
ydhU,539,787,0.5460783627549809,248,Unchanged,1000,5
ydhT,346,1073,1.6328061331197974,727,Unchanged,1000,5
ydhS,1414,1831,0.37284967098793814,417,Unchanged,1000,5
ydhR,3473,845,-2.039159164212545,-2628,Downregulated,1000,5
ydhQ,7311,2816,-1.3764214178071996,-4495,Downregulated,1000,5
mdtK,1116,2488,1.1566494583014149,1372,Upregulated,1000,5
ribC,4026,1281,-1.6520766965796931,-2745,Downregulated,1000,5
cfa,31218,7370,-2.0826415887154166,-23848,Downregulated,1000,5
ydhC,342,1701,2.314314910777487,1359,Upregulated,1000,5
ydhB,575,1302,1.179095587333898,727,Unchanged,1000,5
purR,3336,1999,-0.7388408167000359,-1337,Downregulated,1000,5
ydhP,328,1712,2.383914981783063,1384,Upregulated,1000,5
sodB,19516,8797,-1.1495738712222052,-10719,Downregulated,1000,5
mepH,795,937,0.23709418748746908,142,Unchanged,1000,5
grxD,2100,614,-1.7740787671833054,-1486,Downregulated,1000,5
lhr,3450,10768,1.6420820480574232,7318,Upregulated,1000,5
rnt,733,1343,0.8735742012936304,610,Unchanged,1000,5
gloA,2760,1116,-1.3063312398363438,-1644,Downregulated,1000,5
nemA,1073,1992,0.8925675713115591,919,Unchanged,1000,5
nemR,260,775,1.5756846871331454,515,Unchanged,1000,5
ydhL,172,224,0.38109016735550627,52,Unchanged,1000,5
ydhF,1465,1609,0.135263661413836,144,Unchanged,1000,5
sodC,1438,758,-0.923793922268206,-680,Unchanged,1000,5
ydhK,254,2985,3.5548305293800015,2731,Upregulated,1000,5
ydhJ,151,984,2.704109766014161,833,Unchanged,1000,5
ydhI,59,160,1.439285045525521,101,Unchanged,1000,5
slyA,3696,895,-2.046005169264439,-2801,Downregulated,1000,5
slyB,15455,5913,-1.3861114719809438,-9542,Downregulated,1000,5
anmK,1482,1821,0.2971854746710044,339,Unchanged,1000,5
mliC,375,250,-0.5849625007211563,-125,Unchanged,1000,5
pdxH,3123,1131,-1.4653336400307528,-1992,Downregulated,1000,5
tyrS,12363,4420,-1.4839105947228617,-7943,Downregulated,1000,5
pdxY,2549,1275,-0.9994341262759816,-1274,Downregulated,1000,5
gstA,4497,1407,-1.676340555432483,-3090,Downregulated,1000,5
dtpA,22029,2339,-3.2354402390036,-19690,Downregulated,1000,5
nth,208,562,1.433986602079834,354,Unchanged,1000,5
rsxE,257,834,1.6982790242507855,577,Unchanged,1000,5
rsxG,225,714,1.6659990728120626,489,Unchanged,1000,5
rsxD,396,1312,1.728195384538474,916,Unchanged,1000,5
rsxC,1148,3059,1.4139374648825147,1911,Upregulated,1000,5
rsxB,313,709,1.1796229703068979,396,Unchanged,1000,5
rsxA,399,709,0.8293968810171704,310,Unchanged,1000,5
ydgK,557,513,-0.1187185017329777,-44,Unchanged,1000,5
cnu,105,66,-0.6698513983076693,-39,Unchanged,1000,5
ydgJ,2365,1709,-0.4686877865506181,-656,Unchanged,1000,5
add,2223,1743,-0.35093537890130505,-480,Unchanged,1000,5
malY,1567,1316,-0.25184569073733876,-251,Unchanged,1000,5
malX,318,1971,2.6318291057591305,1653,Upregulated,1000,5
malI,281,1324,2.2362610865862917,1043,Upregulated,1000,5
hdhA,7599,1287,-2.5617975242129556,-6312,Downregulated,1000,5
uidR,854,705,-0.27661281233433443,-149,Unchanged,1000,5
uidA,84,2028,4.59352451422458,1944,Upregulated,1000,5
uidB,26,1201,5.529580717564542,1175,Upregulated,1000,5
uidC,24,903,5.233619676759702,879,Unchanged,1000,5
ydgA,7832,2741,-1.51467843677792,-5091,Downregulated,1000,5
manA,6596,2470,-1.4170803569654271,-4126,Downregulated,1000,5
fumA,1055,1934,0.8743447958822937,879,Unchanged,1000,5
fumC,435,1574,1.8553482347713957,1139,Upregulated,1000,5
tus,407,953,1.2274474196436949,546,Unchanged,1000,5
rstB,1227,1378,0.16744063904138629,151,Unchanged,1000,5
rstA,1658,1034,-0.6812078211808157,-624,Unchanged,1000,5
ydgC,82,176,1.1018796140192137,94,Unchanged,1000,5
folM,333,554,0.7343637989779263,221,Unchanged,1000,5
ydgI,437,1565,1.8404574723193823,1128,Upregulated,1000,5
ydgH,4232,1815,-1.2213700792309126,-2417,Downregulated,1000,5
pntA,20019,7852,-1.3502378317680022,-12167,Downregulated,1000,5
pntB,18260,6722,-1.4417243175635825,-11538,Downregulated,1000,5
tqsA,398,1120,1.4926583964013178,722,Unchanged,1000,5
mdtJ,32,278,3.1189410727235076,246,Unchanged,1000,5
mdtI,18,183,3.34577483684173,165,Unchanged,1000,5
ydgD,569,738,0.3751921637538141,169,Unchanged,1000,5
asr,77,145,0.9131225493200331,68,Unchanged,1000,5
ynfM,783,1435,0.8739665242720095,652,Unchanged,1000,5
ynfL,308,1055,1.776240742899646,747,Unchanged,1000,5
mlc,2569,2592,0.012858827983807924,23,Unchanged,1000,5
ynfK,4051,2020,-1.0039227920472795,-2031,Downregulated,1000,5
clcB,272,1077,1.985339693293868,805,Unchanged,1000,5
dmsD,1985,595,-1.7381774338350142,-1390,Downregulated,1000,5
ynfH,6173,964,-2.6788667397930284,-5209,Downregulated,1000,5
ynfG,2804,429,-2.708436796511078,-2375,Downregulated,1000,5
ynfF,19327,2400,-3.0095114041497926,-16927,Downregulated,1000,5
ynfE,6240,2094,-1.5752845868188023,-4146,Downregulated,1000,5
ynfD,417,167,-1.3201992809706113,-250,Unchanged,1000,5
ynfC,511,625,0.2905328986118282,114,Unchanged,1000,5
speG,2243,577,-1.9587863964407897,-1666,Downregulated,1000,5
ynfB,1402,389,-1.8496442890244311,-1013,Downregulated,1000,5
ynfA,174,244,0.487793841714158,70,Unchanged,1000,5
rspA,134,1014,2.919752746545568,880,Unchanged,1000,5
rspB,87,709,3.026698321390788,622,Unchanged,1000,5
intQ,67,604,3.1723155488673065,537,Unchanged,1000,5
insD7,6,1627,8.083036034951371,1621,Upregulated,1000,5
ydfE,36,584,4.0198995574377046,548,Unchanged,1000,5
ydfD,1,23,4.523561956057013,22,Unchanged,1000,5
dicB,2,4,1.0,2,Unchanged,1000,5
dicF,1,1,0.0,0,Unchanged,1000,5
ydfC,5,56,3.4854268271702415,51,Unchanged,1000,5
ydfB,1,7,2.807354922057604,6,Unchanged,1000,5
ydfA,3,13,2.1154772174199357,10,Unchanged,1000,5
dicA,1209,278,-2.120657456525616,-931,Unchanged,1000,5
dicC,5,42,3.070389327891398,37,Unchanged,1000,5
ydfX,8,104,3.700439718141092,96,Unchanged,1000,5
ydfW,4,18,2.169925001442312,14,Unchanged,1000,5
flxA,112,141,0.3321964303411894,29,Unchanged,1000,5
ydfV,9,99,3.4594316186372973,90,Unchanged,1000,5
relB,516,287,-0.8463203287475664,-229,Unchanged,1000,5
relE,685,437,-0.6484707083472907,-248,Unchanged,1000,5
hokD,39,29,-0.42742122373467617,-10,Unchanged,1000,5
rem,29,98,1.756728848987636,69,Unchanged,1000,5
ydfU,26,876,5.074347341460081,850,Unchanged,1000,5
ydfT,65,486,2.9024446905773265,421,Unchanged,1000,5
cspF,17,66,1.956931278108114,49,Unchanged,1000,5
cspB,10,26,1.3785116232537298,16,Unchanged,1000,5
essQ,1,29,4.857980995127572,28,Unchanged,1000,5
ydfR,10,105,3.3923174227787602,95,Unchanged,1000,5
rrrQ,11,372,5.079727192470735,361,Unchanged,1000,5
rzpQ,14,292,4.382469636822413,278,Unchanged,1000,5
cspI,3,22,2.8744691179161412,19,Unchanged,1000,5
ynfN,1,10,3.321928094887362,9,Unchanged,1000,5
gnsB,61,6,-3.34577483684173,-55,Unchanged,1000,5
ydfO,32,10,-1.6780719051126376,-22,Unchanged,1000,5
nohA,28,429,3.9374789154419414,401,Unchanged,1000,5
stfQ,28,677,4.595657101517393,649,Unchanged,1000,5
tfaQ,19,372,4.291231297664446,353,Unchanged,1000,5
pinQ,37,337,3.1871514155529086,300,Unchanged,1000,5
ydfK,9,10,0.15200309344505006,1,Unchanged,1000,5
ydfI,132,1074,3.024384158626959,942,Unchanged,1000,5
ydfZ,11569,474,-4.609233296964281,-11095,Downregulated,1000,5
ydfH,1623,1352,-0.26356784826578716,-271,Unchanged,1000,5
ydfG,6165,2726,-1.1773153324849919,-3439,Downregulated,1000,5
dcp,6944,3189,-1.1226628501922185,-3755,Downregulated,1000,5
ydeJ,316,316,0.0,0,Unchanged,1000,5
ydeI,995,248,-2.004356405044136,-747,Unchanged,1000,5
dgcZ,1305,637,-1.0346845292009466,-668,Unchanged,1000,5
ydeE,258,884,1.7766753039681773,626,Unchanged,1000,5
eamA,480,823,0.7778580248131072,343,Unchanged,1000,5
marB,117,47,-1.3157758679057672,-70,Unchanged,1000,5
marA,345,273,-0.337695410745679,-72,Unchanged,1000,5
marR,345,380,0.13940305666541644,35,Unchanged,1000,5
marC,628,766,0.2865798330333302,138,Unchanged,1000,5
ydeA,837,1149,0.4570792700957695,312,Unchanged,1000,5
yneK,41,390,3.249778309131527,349,Unchanged,1000,5
yneJ,493,967,0.9719282430989297,474,Unchanged,1000,5
sad,844,1877,1.153113746123689,1033,Upregulated,1000,5
glsB,823,1337,0.7000351296717271,514,Unchanged,1000,5
yneG,117,276,1.2381597371947646,159,Unchanged,1000,5
dgcF,216,788,1.8671643172929078,572,Unchanged,1000,5
uxaB,245,1471,2.5859435922522596,1226,Upregulated,1000,5
yneE,302,639,1.0812673816219154,337,Unchanged,1000,5
tam,685,640,-0.09803208296052676,-45,Unchanged,1000,5
lsrG,37,132,1.8349407537295037,95,Unchanged,1000,5
lsrF,253,728,1.524801065504386,475,Unchanged,1000,5
lsrB,137,781,2.5111466551814527,644,Unchanged,1000,5
lsrD,104,785,2.916109125637897,681,Unchanged,1000,5
lsrC,109,969,3.152168530638155,860,Unchanged,1000,5
lsrA,213,1472,2.7888523358311748,1259,Upregulated,1000,5
lsrR,384,799,1.0570891922068204,415,Unchanged,1000,5
lsrK,456,1455,1.6739134236309046,999,Unchanged,1000,5
hipB,69,125,0.8572598278839181,56,Unchanged,1000,5
hipA,877,1411,0.686069240152531,534,Unchanged,1000,5
yneL,4,35,3.1292830169449664,31,Unchanged,1000,5
ydeT,116,866,2.9002422195991526,750,Unchanged,1000,5
ydeS,20,314,3.9726926540042644,294,Unchanged,1000,5
ydeR,21,273,3.700439718141092,252,Unchanged,1000,5
ydeQ,29,471,4.021602254485211,442,Unchanged,1000,5
ydeP,375,2104,2.488172203909059,1729,Upregulated,1000,5
safA,2,8,2.0,6,Unchanged,1000,5
ydeO,19,215,3.500265336145875,196,Unchanged,1000,5
ydeN,521,983,0.9159080440620724,462,Unchanged,1000,5
ydeM,76,431,2.503616545645513,355,Unchanged,1000,5
yddA,15,920,5.938599455335857,905,Unchanged,1000,5
yddB,139,1547,3.4763164087255283,1408,Upregulated,1000,5
pqqL,310,2170,2.807354922057604,1860,Upregulated,1000,5
gadB,196014,1537,-6.994695725052132,-194477,Downregulated,1000,5
gadC,146286,1329,-6.782306791089309,-144957,Downregulated,1000,5
digH,2243,1294,-0.7935920030937648,-949,Unchanged,1000,5
dosC,125,902,2.851199338593294,777,Unchanged,1000,5
dosP,196,2354,3.586188760923236,2158,Upregulated,1000,5
ddpX,9,439,5.608152128093046,430,Unchanged,1000,5
ddpA,124,1410,3.5072831368992805,1286,Upregulated,1000,5
ddpB,49,965,4.299675288040234,916,Unchanged,1000,5
ddpC,104,842,3.017236704925304,738,Unchanged,1000,5
ddpD,130,1089,3.0664204256884524,959,Unchanged,1000,5
ddpF,117,907,2.954594020945118,790,Unchanged,1000,5
osmC,15380,3259,-2.238554246110625,-12121,Downregulated,1000,5
bdm,228,119,-0.9380722508567982,-109,Unchanged,1000,5
sra,384,41,-3.2274104961030727,-343,Unchanged,1000,5
maeA,13004,5143,-1.3382734023378988,-7861,Downregulated,1000,5
adhP,787,1269,0.6892565283336195,482,Unchanged,1000,5
yddM,248,319,0.36321630337799427,71,Unchanged,1000,5
fdnI,220,621,1.4970897446958218,401,Unchanged,1000,5
fdnH,172,1049,2.6085342078751697,877,Unchanged,1000,5
fdnG,992,4205,2.0836937747556314,3213,Upregulated,1000,5
yddG,606,731,0.27055361247948656,125,Unchanged,1000,5
yddL,1,73,6.189824558880018,72,Unchanged,1000,5
yddK,2,67,5.066089190457772,65,Unchanged,1000,5
yddJ,2,38,4.247927513443585,36,Unchanged,1000,5
narU,284,1498,2.399074788954069,1214,Upregulated,1000,5
narZ,1449,5706,1.9774221520247903,4257,Upregulated,1000,5
narY,439,1852,2.076791253724878,1413,Upregulated,1000,5
narW,162,869,2.4233623639297757,707,Unchanged,1000,5
narV,184,848,2.204358498506186,664,Unchanged,1000,5
yddE,1129,1750,0.6323094359466903,621,Unchanged,1000,5
nhoA,87,1204,3.7906761809109737,1117,Upregulated,1000,5
yddH,151,650,2.105891168590738,499,Unchanged,1000,5
pptA,161,72,-1.1609918766723046,-89,Unchanged,1000,5
ydcC,27,882,5.029747343394052,855,Unchanged,1000,5
yncI,103,489,2.247190127769015,386,Unchanged,1000,5
ydcD,47,26,-0.8541491335365452,-21,Unchanged,1000,5
rhsE,164,2170,3.725927322713758,2006,Upregulated,1000,5
yncH,3,2,-0.5849625007211563,-1,Unchanged,1000,5
yncG,247,715,1.533432200081074,468,Unchanged,1000,5
ansP,470,2201,2.2274264833265573,1731,Upregulated,1000,5
yncE,157,1340,3.093396536453508,1183,Upregulated,1000,5
yncD,225,2948,3.7117396178780324,2723,Upregulated,1000,5
mcbR,117,563,2.266626392496825,446,Unchanged,1000,5
curA,1107,1406,0.34494137229098315,299,Unchanged,1000,5
mnaT,1256,998,-0.3317247435543665,-258,Unchanged,1000,5
ydcZ,302,369,0.28907226673531705,67,Unchanged,1000,5
ydcY,1480,368,-2.0078195044592992,-1112,Downregulated,1000,5
ortT,8,23,1.5235619560570128,15,Unchanged,1000,5
patD,401,1851,2.2066307534156535,1450,Upregulated,1000,5
ydcV,59,867,3.877245133859994,808,Unchanged,1000,5
ydcU,128,1114,3.1215335173400316,986,Unchanged,1000,5
ydcT,105,1204,3.5193741590935796,1099,Upregulated,1000,5
ydcS,238,1403,2.5594815303119556,1165,Upregulated,1000,5
ydcR,829,1904,1.199589471812193,1075,Upregulated,1000,5
hicB,319,255,-0.32305917690601155,-64,Unchanged,1000,5
yncJ,27,107,1.9865794842376783,80,Unchanged,1000,5
rlhA,2155,2709,0.330072524225554,554,Unchanged,1000,5
sutR,158,492,1.638733757162137,334,Unchanged,1000,5
ydcO,113,1274,3.4949705998411127,1161,Upregulated,1000,5
insQ,2129,1555,-0.45326136943432904,-574,Unchanged,1000,5
ydcL,407,456,0.16400502989849455,49,Unchanged,1000,5
tehB,1310,581,-1.1729567430202839,-729,Unchanged,1000,5
tehA,539,1460,1.4376111910148741,921,Unchanged,1000,5
ydcK,465,938,1.0123572065199826,473,Unchanged,1000,5
rimL,682,610,-0.16096249657392386,-72,Unchanged,1000,5
ydcH,605,135,-2.163975735111126,-470,Unchanged,1000,5
opgD,2569,1982,-0.37424992771432875,-587,Unchanged,1000,5
ydcJ,377,1726,2.194796035910291,1349,Upregulated,1000,5
ydcI,125,943,2.9153296760130094,818,Unchanged,1000,5
trg,288,1891,2.715008646507449,1603,Upregulated,1000,5
mokB,21,28,0.41503749927884376,7,Unchanged,1000,5
ydcA,97,42,-1.2075954194083673,-55,Unchanged,1000,5
cybB,725,607,-0.25628447864661474,-118,Unchanged,1000,5
aldA,664,2236,1.7516650414962653,1572,Upregulated,1000,5
ydcF,3467,1345,-1.3660816637588469,-2122,Downregulated,1000,5
hrpA,5991,8892,0.5697111148618612,2901,Upregulated,1000,5
azoR,730,684,-0.09390013888148166,-46,Unchanged,1000,5
ynbD,320,1442,2.17192735435346,1122,Upregulated,1000,5
ynbC,313,2018,2.6886916121737388,1705,Upregulated,1000,5
ynbB,10,790,6.303780748177103,780,Unchanged,1000,5
ynbA,9,490,5.766712937560258,481,Unchanged,1000,5
ydbD,127,1902,3.9046168440883977,1775,Upregulated,1000,5
pdxI,624,1354,1.1176098047127483,730,Unchanged,1000,5
insI2,24,14,-0.777607578663552,-10,Unchanged,1000,5
insC2,441,166,-1.4095954142105958,-275,Unchanged,1000,5
insD2,189,1633,3.1110666513406224,1444,Upregulated,1000,5
paaY,519,990,0.9316939866090912,471,Unchanged,1000,5
paaX,1037,1845,0.8312049221345328,808,Unchanged,1000,5
paaK,236,2047,3.116652337661569,1811,Upregulated,1000,5
paaJ,211,2121,3.3294297168233697,1910,Upregulated,1000,5
paaI,44,434,3.302119613807182,390,Unchanged,1000,5
paaH,179,2266,3.6621163685562594,2087,Upregulated,1000,5
paaG,39,1114,4.836131298477784,1075,Upregulated,1000,5
paaF,43,1170,4.766028059768669,1127,Upregulated,1000,5
paaE,92,1689,4.198391656744373,1597,Upregulated,1000,5
paaD,23,592,4.685891409571937,569,Unchanged,1000,5
paaC,12,1118,6.541741972122034,1106,Upregulated,1000,5
paaB,4,325,6.344295907915817,321,Unchanged,1000,5
paaA,8,1296,7.339850002884624,1288,Upregulated,1000,5
paaZ,61,3063,5.649992314036071,3002,Upregulated,1000,5
tynA,272,3119,3.5194049961238125,2847,Upregulated,1000,5
feaB,433,2687,2.633557391286441,2254,Upregulated,1000,5
feaR,78,1040,3.736965594166206,962,Unchanged,1000,5
ydbL,94,278,1.5643522210458702,184,Unchanged,1000,5
ynbE,8,31,1.9541963103868751,23,Unchanged,1000,5
ydbH,2187,4757,1.1210988049143613,2570,Upregulated,1000,5
ldhA,1,3,1.584962500721156,2,Unchanged,1000,5
hslJ,1511,696,-1.1183444493161008,-815,Unchanged,1000,5
ydbK,6758,7839,0.21407327487737546,1081,Upregulated,1000,5
ompN,37,1344,5.182864057149811,1307,Upregulated,1000,5
uspF,2875,736,-1.965784284662087,-2139,Downregulated,1000,5
ynaE,13,22,0.7589919004962051,9,Unchanged,1000,5
pinR,38,636,4.06495544184077,598,Unchanged,1000,5
tfaR,85,855,3.3303896736355583,770,Unchanged,1000,5
stfR,294,6096,4.373974842656958,5802,Upregulated,1000,5
insH5,215,367,0.7714434032537526,152,Unchanged,1000,5
ynaA,158,1057,2.74197891320558,899,Unchanged,1000,5
ydaY,19,410,4.43155258606186,391,Unchanged,1000,5
ynaK,15,181,3.592955291474687,166,Unchanged,1000,5
trkG,593,823,0.4728603258756221,230,Unchanged,1000,5
rzpR,17,452,4.732716121164849,435,Unchanged,1000,5
ydaW,51,575,3.4949928038602422,524,Unchanged,1000,5
ydaV,38,1217,5.001185939270143,1179,Upregulated,1000,5
ydaU,53,882,4.056714390994321,829,Unchanged,1000,5
ydaT,21,424,4.335603031784439,403,Unchanged,1000,5
ydaS,12,111,3.2094533656289497,99,Unchanged,1000,5
racR,1145,466,-1.296945738330026,-679,Unchanged,1000,5
ydaG,1,6,2.584962500721156,5,Unchanged,1000,5
sieB,124,171,0.4636562044990228,47,Unchanged,1000,5
kilR,1,27,4.754887502163468,26,Unchanged,1000,5
racC,2,70,5.129283016944966,68,Unchanged,1000,5
recE,127,3621,4.833487774704012,3494,Upregulated,1000,5
recT,147,841,2.5162896454187798,694,Unchanged,1000,5
ralR,2,28,3.807354922057604,26,Unchanged,1000,5
rcbA,3,15,2.321928094887362,12,Unchanged,1000,5
xisR,1,45,5.491853096329675,44,Unchanged,1000,5
intR,85,1006,3.5650236536678253,921,Unchanged,1000,5
ttcA,1511,1296,-0.2214379422802043,-215,Unchanged,1000,5
dbpA,1226,1940,0.6620976733837085,714,Unchanged,1000,5
zntB,1530,1780,0.2183455882737461,250,Unchanged,1000,5
dgcM,564,1238,1.134244246815471,674,Unchanged,1000,5
smrA,916,943,0.041910172578152605,27,Unchanged,1000,5
abgR,190,914,2.266194746727122,724,Unchanged,1000,5
abgA,55,1664,4.919080004616433,1609,Upregulated,1000,5
abgB,104,1982,4.252301529045396,1878,Upregulated,1000,5
abgT,116,1859,4.002330059791909,1743,Upregulated,1000,5
ogt,310,656,1.0814275993438462,346,Unchanged,1000,5
fnr,5164,3184,-0.6976486647635418,-1980,Downregulated,1000,5
uspE,9296,3253,-1.5148392463633968,-6043,Downregulated,1000,5
ynaJ,463,205,-1.1753882837547904,-258,Unchanged,1000,5
insH4,2431,3950,0.7003027599230988,1519,Upregulated,1000,5
ynaI,2268,1205,-0.9123874938249048,-1063,Downregulated,1000,5
mppA,1034,2278,1.1395315613931771,1244,Upregulated,1000,5
pgrR,531,962,0.8573250329658884,431,Unchanged,1000,5
ycjY,243,995,2.03374021182523,752,Unchanged,1000,5
mpaA,1099,1275,0.2143058607969892,176,Unchanged,1000,5
ycjG,965,1995,1.0477878989542653,1030,Upregulated,1000,5
tpx,5110,3004,-0.7664384783107119,-2106,Downregulated,1000,5
tyrR,3765,4109,0.1261374656083659,344,Unchanged,1000,5
ycjF,1053,2524,1.261206473956832,1471,Upregulated,1000,5
ycjX,1446,2784,0.9450916588976105,1338,Upregulated,1000,5
ycjW,963,1342,0.47877696835672423,379,Unchanged,1000,5
ompG,27,1412,5.708636871107712,1385,Upregulated,1000,5
ycjU,4,1343,8.391243589427443,1339,Upregulated,1000,5
ycjT,176,5304,4.9134334414752905,5128,Upregulated,1000,5
ycjS,120,2054,4.097329870709677,1934,Upregulated,1000,5
ycjR,60,973,4.019405399172593,913,Unchanged,1000,5
ycjQ,103,2082,4.337253826116199,1979,Upregulated,1000,5
ycjP,47,1764,5.230045993879883,1717,Upregulated,1000,5
ycjO,38,1420,5.223747700948459,1382,Upregulated,1000,5
ycjN,58,2498,5.4285767664803855,2440,Upregulated,1000,5
ycjM,92,2275,4.6280888739164086,2183,Upregulated,1000,5
pspE,2218,2399,0.11317379213172468,181,Unchanged,1000,5
pspD,430,785,0.868355994189529,355,Unchanged,1000,5
pspC,2288,2807,0.29494201173413503,519,Unchanged,1000,5
pspB,792,867,0.13053156314222542,75,Unchanged,1000,5
pspA,15001,18263,0.2838650941409044,3262,Upregulated,1000,5
pspF,596,2843,2.254029863215366,2247,Upregulated,1000,5
puuE,93,3444,5.210710616288813,3351,Upregulated,1000,5
puuB,76,2784,5.195015982405143,2708,Upregulated,1000,5
puuC,171,3570,4.383855844030564,3399,Upregulated,1000,5
puuR,311,849,1.448849973422436,538,Unchanged,1000,5
puuD,89,1508,4.082687282302267,1419,Upregulated,1000,5
puuA,149,2326,3.964466861011057,2177,Upregulated,1000,5
puuP,70,2208,4.979241439833203,2138,Upregulated,1000,5
ymjA,251,188,-0.41695470227313464,-63,Unchanged,1000,5
sapA,2278,3838,0.7525869644872685,1560,Upregulated,1000,5
sapB,839,1898,1.177737276581286,1059,Upregulated,1000,5
sapC,546,1818,1.7353793432742548,1272,Upregulated,1000,5
sapD,1390,2021,0.5399844387688656,631,Unchanged,1000,5
sapF,661,1193,0.8518718661875364,532,Unchanged,1000,5
ycjD,76,363,2.255898224552165,287,Unchanged,1000,5
fabI,17639,4454,-1.9855953099056673,-13185,Downregulated,1000,5
yciW,207,2074,3.3247132213139006,1867,Upregulated,1000,5
rnb,12315,5798,-1.0867893893249263,-6517,Downregulated,1000,5
pdeR,1106,2600,1.23316023768111,1494,Upregulated,1000,5
yciT,1665,1086,-0.6164980741542629,-579,Unchanged,1000,5
osmB,2245,259,-3.1156914419419555,-1986,Downregulated,1000,5
yciH,444,235,-0.9178989197851062,-209,Unchanged,1000,5
pyrF,3520,1514,-1.217210223538928,-2006,Downregulated,1000,5
lapB,2581,3383,0.3903730357000183,802,Unchanged,1000,5
lapA,1009,617,-0.7095837799569394,-392,Unchanged,1000,5
pgpB,770,1196,0.6352870386158413,426,Unchanged,1000,5
ribA,1494,1027,-0.5407439664710421,-467,Unchanged,1000,5
acnA,3775,7988,1.081357688344169,4213,Upregulated,1000,5
cysB,1645,1663,0.01570058466466533,18,Unchanged,1000,5
topA,17377,7770,-1.1611925301497397,-9607,Downregulated,1000,5
yciN,702,230,-1.6098371693601854,-472,Unchanged,1000,5
sohB,3009,2016,-0.5777884678334203,-993,Unchanged,1000,5
yciK,1581,1162,-0.44422729895384194,-419,Unchanged,1000,5
btuR,759,692,-0.13332784777874168,-67,Unchanged,1000,5
rluB,1853,1966,0.08540044031331483,113,Unchanged,1000,5
yciQ,402,2066,2.361572847686131,1664,Upregulated,1000,5
yciO,1248,972,-0.36058971525646744,-276,Unchanged,1000,5
yciV,1408,1390,-0.01856245102642752,-18,Unchanged,1000,5
trpL,1,1,0.0,0,Unchanged,1000,5
trpE,447,3005,2.74901825441523,2558,Upregulated,1000,5
trpD,486,2912,2.5829821365929155,2426,Upregulated,1000,5
trpC,695,2552,1.8765434461539996,1857,Upregulated,1000,5
trpB,1220,2652,1.1201996276623392,1432,Upregulated,1000,5
trpA,961,1512,0.6538498034473221,551,Unchanged,1000,5
yciG,49,48,-0.029747343394052068,-1,Unchanged,1000,5
yciF,394,377,-0.06363110618771194,-17,Unchanged,1000,5
yciE,421,242,-0.7988131857918015,-179,Unchanged,1000,5
ompW,148,832,2.4909863525121425,684,Unchanged,1000,5
yciC,1653,1078,-0.6167295465398084,-575,Unchanged,1000,5
yciB,1086,695,-0.6439392201934918,-391,Unchanged,1000,5
yciA,606,359,-0.7553339496498995,-247,Unchanged,1000,5
tonB,291,1147,1.9787743331075411,856,Unchanged,1000,5
yciI,2138,267,-3.001350206032937,-1871,Downregulated,1000,5
kch,1565,1134,-0.46474201687775174,-431,Unchanged,1000,5
clsA,2828,2905,0.038756043482492404,77,Unchanged,1000,5
yciU,565,324,-0.8022570544179252,-241,Unchanged,1000,5
oppF,19319,10416,-0.8912190649685247,-8903,Downregulated,1000,5
oppD,19341,11709,-0.724044520709988,-7632,Downregulated,1000,5
oppC,14520,9481,-0.614930314102267,-5039,Downregulated,1000,5
oppB,12135,8750,-0.47181918643144266,-3385,Downregulated,1000,5
oppA,137677,44347,-1.6343791492722417,-93330,Downregulated,1000,5
ychE,552,998,0.8543715485590915,446,Unchanged,1000,5
adhE,309420,108494,-1.5119511912780845,-200926,Downregulated,1000,5
tdk,659,403,-0.7094986264800844,-256,Unchanged,1000,5
hns,19492,1620,-3.5888164094203283,-17872,Downregulated,1000,5
galU,9254,2068,-2.161840913250361,-7186,Downregulated,1000,5
rssB,1397,1426,0.029641961034424947,29,Unchanged,1000,5
rssA,1569,1533,-0.03348765530932006,-36,Unchanged,1000,5
ychJ,1019,599,-0.7665261433770281,-420,Unchanged,1000,5
purU,5913,2151,-1.458882752341581,-3762,Downregulated,1000,5
tpr,1,3,1.584962500721156,2,Unchanged,1000,5
narI,4057,1259,-1.6881350194872562,-2798,Downregulated,1000,5
narJ,3377,1367,-1.3047289364014167,-2010,Downregulated,1000,5
narH,10284,3365,-1.6117231053359766,-6919,Downregulated,1000,5
narG,32374,9038,-1.840760167980422,-23336,Downregulated,1000,5
narK,2637,2262,-0.22129864187473972,-375,Unchanged,1000,5
narX,1510,2975,0.9783411188702269,1465,Upregulated,1000,5
narL,2927,1446,-1.0173551934576328,-1481,Downregulated,1000,5
ychO,668,2328,1.8011710504342318,1660,Upregulated,1000,5
ychN,1650,693,-1.2515387669959646,-957,Unchanged,1000,5
chaC,782,994,0.3460772442549339,212,Unchanged,1000,5
chaB,163,124,-0.39453184384420226,-39,Unchanged,1000,5
chaA,752,1871,1.3150049915631468,1119,Upregulated,1000,5
kdsA,5904,2643,-1.1595162964188261,-3261,Downregulated,1000,5
ychA,1692,1370,-0.3045536752720607,-322,Unchanged,1000,5
ychQ,97,337,1.796691938994731,240,Unchanged,1000,5
prmC,630,1378,1.1291521543170124,748,Unchanged,1000,5
prfA,1895,1827,-0.052721214430965446,-68,Unchanged,1000,5
hemA,3806,2947,-0.36902850115002167,-859,Unchanged,1000,5
lolB,2723,1389,-0.9711503830624035,-1334,Downregulated,1000,5
ispE,3312,1785,-0.8917785985828631,-1527,Downregulated,1000,5
prs,49915,6529,-2.9345394796826705,-43386,Downregulated,1000,5
dauA,3378,3270,-0.04687869241594091,-108,Unchanged,1000,5
ychH,1684,846,-0.9931625699464464,-838,Unchanged,1000,5
pth,1487,722,-1.0423339051652476,-765,Unchanged,1000,5
ychF,4157,2428,-0.7757743263686903,-1729,Downregulated,1000,5
ycgV,1025,3310,1.6912073073017717,2285,Upregulated,1000,5
dhaR,704,2359,1.7445280846021654,1655,Upregulated,1000,5
dhaK,9338,4852,-0.9445340381216788,-4486,Downregulated,1000,5
dhaL,4879,2234,-1.1269562974427123,-2645,Downregulated,1000,5
dhaM,10626,4924,-1.109695950988613,-5702,Downregulated,1000,5
treA,1261,2158,0.775126589159797,897,Unchanged,1000,5
ycgY,23,223,3.2773379438632917,200,Unchanged,1000,5
ymgE,116,156,0.4274212237346762,40,Unchanged,1000,5
ycgR,59,867,3.877245133859994,808,Unchanged,1000,5
emtA,1523,729,-1.0629252221603551,-794,Unchanged,1000,5
ldcA,1018,1445,0.505331931312346,427,Unchanged,1000,5
cvrA,1648,2647,0.6836419523121802,999,Unchanged,1000,5
dadX,727,1607,1.1443426597554995,880,Unchanged,1000,5
dadA,1547,2592,0.7445925214355891,1045,Upregulated,1000,5
ycgB,1043,1553,0.5743186718675356,510,Unchanged,1000,5
fadR,1069,995,-0.10349342228947936,-74,Unchanged,1000,5
nhaB,2823,2726,-0.05044356664448337,-97,Unchanged,1000,5
dsbB,1210,749,-0.6919694237032059,-461,Unchanged,1000,5
umuC,330,1658,2.328906077249935,1328,Upregulated,1000,5
umuD,259,292,0.1730162711934633,33,Unchanged,1000,5
hlyE,500,536,0.10030490579568548,36,Unchanged,1000,5
ycgN,568,458,-0.31054333140773804,-110,Unchanged,1000,5
ycgM,1868,841,-1.1513167494545176,-1027,Downregulated,1000,5
ycgL,1140,307,-1.8927232636819247,-833,Unchanged,1000,5
pliG,753,330,-1.1901838404261125,-423,Unchanged,1000,5
ycgJ,283,188,-0.5900693911542451,-95,Unchanged,1000,5
minC,5471,1875,-1.5449139601119741,-3596,Downregulated,1000,5
minD,10017,2326,-2.1065274973110535,-7691,Downregulated,1000,5
minE,1105,154,-2.8430441135838924,-951,Unchanged,1000,5
ymgG,2792,521,-2.421943663931144,-2271,Downregulated,1000,5
ymgD,4200,527,-2.9945144609162706,-3673,Downregulated,1000,5
pdeG,39,1012,4.697591355832062,973,Unchanged,1000,5
ymgC,1,16,4.0,15,Unchanged,1000,5
ariR,4,20,2.321928094887362,16,Unchanged,1000,5
ymgA,14,70,2.321928094887362,56,Unchanged,1000,5
ycgZ,12,93,2.9541963103868754,81,Unchanged,1000,5
bluF,89,724,3.0241124561168076,635,Unchanged,1000,5
bluR,790,774,-0.029519086920054966,-16,Unchanged,1000,5
ycgX,43,95,1.14359085362885,52,Unchanged,1000,5
iraM,20,12,-0.7369655941662062,-8,Unchanged,1000,5
mcrA,310,312,0.00927781358801065,2,Unchanged,1000,5
pinE,11,477,5.4384138373682145,466,Unchanged,1000,5
stfE,6,238,5.309855262586788,232,Unchanged,1000,5
tfaE,22,367,4.060204634205916,345,Unchanged,1000,5
tfaP,20,100,2.321928094887362,80,Unchanged,1000,5
ycfK,16,424,4.727920454563199,408,Unchanged,1000,5
ymfQ,13,575,5.466978427690646,562,Unchanged,1000,5
jayE,48,667,3.796580450463429,619,Unchanged,1000,5
beeE,27,319,3.562525111601401,292,Unchanged,1000,5
ymfR,2,55,4.78135971352466,53,Unchanged,1000,5
ymfM,33,267,3.0163018123291008,234,Unchanged,1000,5
ymfL,69,438,2.666262602823004,369,Unchanged,1000,5
ymfT,10,37,1.8875252707415875,27,Unchanged,1000,5
ymfK,716,489,-0.5501251223120228,-227,Unchanged,1000,5
ymfJ,44,184,2.0641303374197157,140,Unchanged,1000,5
ymfI,474,126,-1.9114633253983428,-348,Unchanged,1000,5
xisE,23,91,1.9842326841416833,68,Unchanged,1000,5
intE,215,887,2.0445974447116035,672,Unchanged,1000,5
lit,1333,669,-0.9945986644475123,-664,Unchanged,1000,5
ymfE,310,184,-0.7525624492172248,-126,Unchanged,1000,5
ymfD,123,188,0.6120743463383976,65,Unchanged,1000,5
icd,15230,10430,-0.5461767839675266,-4800,Downregulated,1000,5
rluE,640,966,0.5939512839484107,326,Unchanged,1000,5
nudJ,504,685,0.44268025434797265,181,Unchanged,1000,5
mnmA,4975,3828,-0.37810569583234804,-1147,Downregulated,1000,5
hflD,1842,1528,-0.2696285180555868,-314,Unchanged,1000,5
purB,11656,5235,-1.1548113402463418,-6421,Downregulated,1000,5
phoP,4041,1957,-1.0460685955566553,-2084,Downregulated,1000,5
phoQ,3668,3544,-0.049615035040036094,-124,Unchanged,1000,5
roxA,5382,3228,-0.737501812362637,-2154,Downregulated,1000,5
pepT,7856,2870,-1.452744192751643,-4986,Downregulated,1000,5
potA,1398,2112,0.5952454739830171,714,Unchanged,1000,5
potB,497,1040,1.0652657714661684,543,Unchanged,1000,5
potC,524,981,0.9046863246817884,457,Unchanged,1000,5
potD,3991,2167,-0.8810511254175981,-1824,Downregulated,1000,5
ymfA,25,331,3.726831217032493,306,Unchanged,1000,5
ycfZ,16,513,5.002815015607054,497,Unchanged,1000,5
cobB,2059,1628,-0.3388431303660072,-431,Unchanged,1000,5
nagK,1770,1892,0.09616272836903554,122,Unchanged,1000,5
lolE,1665,2640,0.6650157522871913,975,Unchanged,1000,5
lolD,730,1559,1.0946525589304053,829,Unchanged,1000,5
lolC,932,2228,1.2573473726857516,1296,Upregulated,1000,5
ycfT,92,1180,3.6810091881921907,1088,Upregulated,1000,5
mfd,9569,9917,0.0515355907211584,348,Unchanged,1000,5
ldtC,113,1452,3.683646775580563,1339,Upregulated,1000,5
bhsA,272,1060,1.962385708200222,788,Unchanged,1000,5
comR,320,957,1.5804470195986633,637,Unchanged,1000,5
ycfJ,2616,1481,-0.8207909002092348,-1135,Downregulated,1000,5
ndh,344,2117,2.621540799305491,1773,Upregulated,1000,5
ycfP,4143,1870,-1.147637550204208,-2273,Downregulated,1000,5
nagZ,2421,2115,-0.19494541599162438,-306,Unchanged,1000,5
thiK,1191,1306,0.13298148368231688,115,Unchanged,1000,5
lpoB,6500,1840,-1.8207339518588042,-4660,Downregulated,1000,5
ycfL,3788,660,-2.5208984012225693,-3128,Downregulated,1000,5
hinT,2215,717,-1.6272616747404758,-1498,Downregulated,1000,5
fhuE,179,3044,4.087936866239289,2865,Upregulated,1000,5
ptsG,40519,13391,-1.5973348683281345,-27128,Downregulated,1000,5
ycfH,1022,1136,0.15256763856706065,114,Unchanged,1000,5
holB,1198,2101,0.8104482538842603,903,Unchanged,1000,5
tmk,837,1353,0.6928623114261934,516,Unchanged,1000,5
mltG,863,1745,1.0157945719180597,882,Unchanged,1000,5
pabC,698,1272,0.865799729074703,574,Unchanged,1000,5
fabF,19103,5762,-1.7291576561718742,-13341,Downregulated,1000,5
acpP,10587,1385,-2.9343359545643297,-9202,Downregulated,1000,5
fabG,18276,3711,-2.3000704415109223,-14565,Downregulated,1000,5
fabD,11227,3515,-1.6753758780002472,-7712,Downregulated,1000,5
fabH,5416,3740,-0.5341894687999977,-1676,Downregulated,1000,5
plsX,4789,3040,-0.6556531119050533,-1749,Downregulated,1000,5
rpmF,1189,227,-2.3889845124547406,-962,Unchanged,1000,5
yceD,13505,3007,-2.1670968668223263,-10498,Downregulated,1000,5
yceF,1923,1187,-0.6960388276979906,-736,Unchanged,1000,5
rluC,2826,1957,-0.5301177097071355,-869,Unchanged,1000,5
yceQ,20,211,3.399171093819823,191,Unchanged,1000,5
rne,18565,14960,-0.31147513996710374,-3605,Downregulated,1000,5
flgL,901,1871,1.0542105474272454,970,Unchanged,1000,5
flgK,870,3114,1.8396816383429462,2244,Upregulated,1000,5
flgJ,445,1679,1.91572498908327,1234,Upregulated,1000,5
flgI,756,2196,1.538419914784126,1440,Upregulated,1000,5
flgH,689,1203,0.8040607544717852,514,Unchanged,1000,5
flgG,2137,1575,-0.4402350793851699,-562,Unchanged,1000,5
flgF,2175,1749,-0.31448511170180043,-426,Unchanged,1000,5
flgE,4559,2179,-1.065051212748858,-2380,Downregulated,1000,5
flgD,2647,1170,-1.1778496650246317,-1477,Downregulated,1000,5
flgC,1173,455,-1.36626456294245,-718,Unchanged,1000,5
flgB,1528,545,-1.4873164083714598,-983,Unchanged,1000,5
flgA,978,906,-0.11032341490599867,-72,Unchanged,1000,5
flgM,296,325,0.13484254228686715,29,Unchanged,1000,5
flgN,360,428,0.24961389007147222,68,Unchanged,1000,5
murJ,456,2851,2.644362309773211,2395,Upregulated,1000,5
yceM,1690,1981,0.2292056337199397,291,Unchanged,1000,5
yceH,1595,1226,-0.37959744496145026,-369,Unchanged,1000,5
rimJ,1083,1019,-0.08787919144251333,-64,Unchanged,1000,5
mdtH,180,1996,3.471042909007586,1816,Upregulated,1000,5
grxB,9658,3604,-1.422125452359117,-6054,Downregulated,1000,5
yceB,2884,1121,-1.3632848864353957,-1763,Downregulated,1000,5
pyrC,18327,1994,-3.2002333314032056,-16333,Downregulated,1000,5
dinI,1134,222,-2.3527890585921227,-912,Unchanged,1000,5
bssS,560,174,-1.6863395210962382,-386,Unchanged,1000,5
solA,2910,2255,-0.36789171965290285,-655,Unchanged,1000,5
yceO,4,5,0.32192809488736235,1,Unchanged,1000,5
yceJ,23,574,4.6413449706186745,551,Unchanged,1000,5
yceI,120,606,2.3362833878644325,486,Unchanged,1000,5
trhO,392,1377,1.812603000019756,985,Unchanged,1000,5
lpxL,1470,2069,0.49311749013628287,599,Unchanged,1000,5
mdtG,254,1616,2.6695267959796287,1362,Upregulated,1000,5
msyB,1443,353,-2.0313312112200177,-1090,Downregulated,1000,5
yceK,152,139,-0.12898644072007803,-13,Unchanged,1000,5
opgH,7957,6686,-0.25108124403954035,-1271,Downregulated,1000,5
opgG,10984,4937,-1.1536969804060038,-6047,Downregulated,1000,5
opgC,246,1016,2.046170181432926,770,Unchanged,1000,5
clsC,1044,2250,1.1078032895345151,1206,Upregulated,1000,5
ymdB,428,591,0.4655473337763855,163,Unchanged,1000,5
ymdA,66,241,1.868495216871508,175,Unchanged,1000,5
csgC,10,153,3.9354597478052895,143,Unchanged,1000,5
csgA,338,470,0.4756375102828154,132,Unchanged,1000,5
csgB,12,181,3.914883386362049,169,Unchanged,1000,5
csgD,125,394,1.6562675347942892,269,Unchanged,1000,5
csgE,18,157,3.1246957474493144,139,Unchanged,1000,5
csgF,16,249,3.960001932068081,233,Unchanged,1000,5
csgG,166,1174,2.8221772617631276,1008,Upregulated,1000,5
ycdZ,596,750,0.33157826492108156,154,Unchanged,1000,5
ycdY,1768,1062,-0.735334508587278,-706,Unchanged,1000,5
ycdX,3393,1942,-0.8050182292917843,-1451,Downregulated,1000,5
ghrA,3850,3169,-0.28083078608739237,-681,Unchanged,1000,5
ycdU,19,889,5.548112095386185,870,Unchanged,1000,5
ymdE,3,111,5.20945336562895,108,Unchanged,1000,5
insE4,99,112,0.17799830197799443,13,Unchanged,1000,5
insF4,24,606,4.658211482751795,582,Unchanged,1000,5
dgcT,939,1005,0.09799843841251649,66,Unchanged,1000,5
pgaA,2502,3834,0.6157685475023308,1332,Upregulated,1000,5
pgaB,1215,2453,1.0135909200644588,1238,Upregulated,1000,5
pgaC,838,1786,1.0917099314218714,948,Unchanged,1000,5
pgaD,207,334,0.690217334974727,127,Unchanged,1000,5
phoH,67,1740,4.6987824002783185,1673,Upregulated,1000,5
efeB,142,2756,4.278613053199609,2614,Upregulated,1000,5
efeO,80,2367,4.8869158958472525,2287,Upregulated,1000,5
putP,897,3399,1.9219304716224106,2502,Upregulated,1000,5
putA,510,10181,4.319238215713851,9671,Upregulated,1000,5
rutR,426,1339,1.6522306250984724,913,Unchanged,1000,5
rutA,14,2489,7.473995592923432,2475,Upregulated,1000,5
rutB,19,1458,6.261847490883352,1439,Upregulated,1000,5
rutC,8,493,5.945443836377912,485,Unchanged,1000,5
rutD,27,1888,6.1277555471983725,1861,Upregulated,1000,5
rutE,21,1117,5.733096047704555,1096,Upregulated,1000,5
rutF,18,865,5.586631321081775,847,Unchanged,1000,5
rutG,202,2970,3.8780357329363335,2768,Upregulated,1000,5
wrbA,8996,2543,-1.8227521990877107,-6453,Downregulated,1000,5
yccJ,2763,528,-2.3876257274540382,-2235,Downregulated,1000,5
agp,2559,3336,0.38253914140521716,777,Unchanged,1000,5
yccE,76,289,1.9269981690570934,213,Unchanged,1000,5
cbpA,11798,2480,-2.2501302885543626,-9318,Downregulated,1000,5
cbpM,2625,546,-2.265344566520995,-2079,Downregulated,1000,5
torD,6279,2503,-1.3268765212885334,-3776,Downregulated,1000,5
torA,54276,16650,-1.7047922245065805,-37626,Downregulated,1000,5
torC,17968,4504,-1.9961511003203716,-13464,Downregulated,1000,5
torR,540,1436,1.4110244367722204,896,Unchanged,1000,5
torT,516,2121,2.039301650107301,1605,Upregulated,1000,5
torS,859,6052,2.816681951078274,5193,Upregulated,1000,5
yccM,233,1706,2.87221578666401,1473,Upregulated,1000,5
ymcE,1,39,5.285402218862249,38,Unchanged,1000,5
cspG,21,106,2.335603031784439,85,Unchanged,1000,5
cspH,2,103,5.6865005271832185,101,Unchanged,1000,5
insB4,177,924,2.3841434913330604,747,Unchanged,1000,5
gfcA,51,291,2.5124500009367883,240,Unchanged,1000,5
gfcB,26,667,4.681103233043493,641,Unchanged,1000,5
gfcC,37,1072,4.856635824828823,1035,Upregulated,1000,5
gfcD,132,3691,4.805401902887155,3559,Upregulated,1000,5
gfcE,118,1885,3.9977057587941855,1767,Upregulated,1000,5
etp,62,444,2.840219555963231,382,Unchanged,1000,5
etk,886,4143,2.2252972164241887,3257,Upregulated,1000,5
appA,2363,2466,0.06155317042899224,103,Unchanged,1000,5
appB,3375,2654,-0.3467191314553622,-721,Unchanged,1000,5
appC,4239,3418,-0.31057156937895625,-821,Unchanged,1000,5
hyaF,2995,1647,-0.8627154479497933,-1348,Downregulated,1000,5
hyaE,1064,691,-0.622740535112931,-373,Unchanged,1000,5
hyaD,3274,1419,-1.2061797324136019,-1855,Downregulated,1000,5
hyaC,2700,1413,-0.934197941604254,-1287,Downregulated,1000,5
hyaB,5664,4366,-0.37550913509220635,-1298,Downregulated,1000,5
hyaA,4584,2836,-0.6927495115173888,-1748,Downregulated,1000,5
yccA,4779,2897,-0.7221490829760625,-1882,Downregulated,1000,5
tusE,572,379,-0.5938172986072977,-193,Unchanged,1000,5
yccX,84,235,1.4841995237862393,151,Unchanged,1000,5
rlmI,2482,2324,-0.09489304672582782,-158,Unchanged,1000,5
hspQ,1831,1012,-0.8554225011030269,-819,Unchanged,1000,5
yccU,1754,893,-0.9739166673235102,-861,Unchanged,1000,5
yccT,122,1112,3.1882037351606214,990,Unchanged,1000,5
mgsA,2306,1255,-0.8777051488136377,-1051,Downregulated,1000,5
helD,4108,5220,0.34561362513905175,1112,Upregulated,1000,5
yccF,698,628,-0.15246247731802526,-70,Unchanged,1000,5
yccS,1818,3991,1.1343980793171646,2173,Upregulated,1000,5
sxy,419,915,1.1268214994720533,496,Unchanged,1000,5
sulA,2741,985,-1.4765066984820365,-1756,Downregulated,1000,5
ompA,206754,45709,-2.1773650792051917,-161045,Downregulated,1000,5
matP,515,603,0.22758556982950404,88,Unchanged,1000,5
ycbZ,1931,3540,0.8744011960197096,1609,Upregulated,1000,5
fabA,2426,1815,-0.41861000223739725,-611,Unchanged,1000,5
rmf,19615,7006,-1.485294442162395,-12609,Downregulated,1000,5
pqiC,610,825,0.43558487668292956,215,Unchanged,1000,5
pqiB,1559,2700,0.7923384792404085,1141,Upregulated,1000,5
pqiA,542,1941,1.8404353613597921,1399,Upregulated,1000,5
uup,3146,4285,0.4457765335841755,1139,Upregulated,1000,5
rlmL,3709,4931,0.41084998499810926,1222,Upregulated,1000,5
ycbX,752,1959,1.3813128305899496,1207,Upregulated,1000,5
zapC,1360,927,-0.5529654075121709,-433,Unchanged,1000,5
pyrD,20107,1467,-3.7767570689213334,-18640,Downregulated,1000,5
ycbF,119,638,2.422594850456926,519,Unchanged,1000,5
ycbV,62,596,3.2649722100752863,534,Unchanged,1000,5
ycbU,35,429,3.615550820554579,394,Unchanged,1000,5
elfG,161,1108,2.782825287934571,947,Unchanged,1000,5
elfC,175,3411,4.2847679277810755,3236,Upregulated,1000,5
elfD,15,502,5.064652958342253,487,Unchanged,1000,5
elfA,176,372,1.0797271924707341,196,Unchanged,1000,5
ssuE,12,733,5.932706887412656,721,Unchanged,1000,5
ssuA,32,1397,5.448116305409463,1365,Upregulated,1000,5
ssuD,83,1896,4.513703817551335,1813,Upregulated,1000,5
ssuC,44,1243,4.820178962415188,1199,Upregulated,1000,5
ssuB,152,1146,2.9144638153133196,994,Unchanged,1000,5
pepN,6759,6278,-0.10650478537446889,-481,Unchanged,1000,5
pncB,13139,4036,-1.702857397782121,-9103,Downregulated,1000,5
asnS,17274,8045,-1.1024378686737821,-9229,Downregulated,1000,5
ompF,11716,2336,-2.3263679189993494,-9380,Downregulated,1000,5
aspC,14428,5594,-1.3669191693113787,-8834,Downregulated,1000,5
gloC,4344,1939,-1.1637112996975691,-2405,Downregulated,1000,5
mepK,4820,1575,-1.6136813178426828,-3245,Downregulated,1000,5
ldtD,2920,3868,0.4056194257094617,948,Unchanged,1000,5
mukB,11670,10981,-0.08779511969410014,-689,Unchanged,1000,5
mukE,1015,1166,0.200088061127958,151,Unchanged,1000,5
mukF,1656,2238,0.43450736347706875,582,Unchanged,1000,5
cmoM,1597,1617,0.017955366062429045,20,Unchanged,1000,5
elyC,359,876,1.2869470257781221,517,Unchanged,1000,5
ycbJ,1854,1882,0.021625384103005865,28,Unchanged,1000,5
kdsB,3176,1899,-0.7419710069934603,-1277,Downregulated,1000,5
ycaR,149,117,-0.34880380087875706,-32,Unchanged,1000,5
ycaQ,281,1606,2.5148298572963883,1325,Upregulated,1000,5
lpxK,596,1728,1.5357189817013068,1132,Upregulated,1000,5
msbA,2833,3545,0.32345502574878005,712,Unchanged,1000,5
ycaI,267,2883,3.4326591898073526,2616,Upregulated,1000,5
ihfB,4169,543,-2.9406772690040275,-3626,Downregulated,1000,5
rpsA,111197,26814,-2.0520595102282333,-84383,Downregulated,1000,5
cmk,2341,1341,-0.8038156972075388,-1000,Downregulated,1000,5
ycaL,158,728,2.2040138920215933,570,Unchanged,1000,5
aroA,7840,2877,-1.4462884332632837,-4963,Downregulated,1000,5
serC,40422,7489,-2.432295710382022,-32933,Downregulated,1000,5
ycaP,358,629,0.8131004296150328,271,Unchanged,1000,5
ycaO,1024,2488,1.2807707701306026,1464,Upregulated,1000,5
focA,3653,2876,-0.3450180779227205,-777,Unchanged,1000,5
pflA,2310,1267,-0.8664763271626105,-1043,Downregulated,1000,5
ycaK,94,385,2.0341257839046265,291,Unchanged,1000,5
ycaN,239,852,1.8338428122450898,613,Unchanged,1000,5
ycaM,49,1510,4.945622990097233,1461,Upregulated,1000,5
ycaD,1249,1714,0.45659363250454255,465,Unchanged,1000,5
ycaC,1162,602,-0.9487746766448268,-560,Unchanged,1000,5
dmsC,4717,1628,-1.53476890126335,-3089,Downregulated,1000,5
dmsB,2469,936,-1.3993464015593775,-1533,Downregulated,1000,5
dmsA,11621,4690,-1.3090743917468417,-6931,Downregulated,1000,5
serS,19894,6684,-1.5735497432391965,-13210,Downregulated,1000,5
rarA,1869,2732,0.5476909145449325,863,Unchanged,1000,5
lolA,1526,1013,-0.5911207880333923,-513,Unchanged,1000,5
ftsK,12158,10309,-0.23800152960157073,-1849,Downregulated,1000,5
lrp,6467,1136,-2.509133775543195,-5331,Downregulated,1000,5
trxB,5474,2431,-1.1710455413362275,-3043,Downregulated,1000,5
cydD,2062,4856,1.2357240888875736,2794,Upregulated,1000,5
cydC,2670,4215,0.6586928892545283,1545,Upregulated,1000,5
aat,858,1389,0.694997046481847,531,Unchanged,1000,5
infA,2058,307,-2.744932421523789,-1751,Downregulated,1000,5
clpA,29579,21566,-0.4558146645997842,-8013,Downregulated,1000,5
clpS,455,516,0.18150452033719547,61,Unchanged,1000,5
cspD,1176,315,-1.9004643264490857,-861,Unchanged,1000,5
macB,1094,5070,2.212373009098146,3976,Upregulated,1000,5
macA,728,2767,1.9263122884112582,2039,Upregulated,1000,5
ybjX,13740,3962,-1.794081218815976,-9778,Downregulated,1000,5
ybjD,921,3715,2.012089149334623,2794,Upregulated,1000,5
aqpZ,356,1476,2.0517435750939983,1120,Upregulated,1000,5
lysO,1426,1720,0.2704345831455723,294,Unchanged,1000,5
hcp,293,3690,3.6546482465255106,3397,Upregulated,1000,5
hcr,312,1329,2.090723170413926,1017,Upregulated,1000,5
poxB,4689,3931,-0.2543839152967266,-758,Unchanged,1000,5
ltaE,3682,2458,-0.5830047109772448,-1224,Downregulated,1000,5
ybjT,2111,2893,0.45463974458244355,782,Unchanged,1000,5
ybjS,1614,1890,0.22774565583065481,276,Unchanged,1000,5
amiD,1618,2348,0.5372208006800746,730,Unchanged,1000,5
ybjQ,562,618,0.13703670768344833,56,Unchanged,1000,5
ybjP,2106,1071,-0.9755469562754611,-1035,Downregulated,1000,5
artP,2060,2361,0.1967537041580618,301,Unchanged,1000,5
artI,3090,2655,-0.21889497710022102,-435,Unchanged,1000,5
artQ,1630,1697,0.05811460042422344,67,Unchanged,1000,5
artM,1040,1367,0.3944297145776055,327,Unchanged,1000,5
artJ,1695,3465,1.0315700790008697,1770,Upregulated,1000,5
rlmC,472,1874,1.9892621882973456,1402,Upregulated,1000,5
ybjO,201,559,1.4756527816642615,358,Unchanged,1000,5
potI,121,1291,3.415410048032596,1170,Upregulated,1000,5
potH,31,1317,5.408843319869639,1286,Upregulated,1000,5
potG,98,1611,4.03903093459136,1513,Upregulated,1000,5
potF,141,1450,3.362285832503503,1309,Upregulated,1000,5
ybjN,1262,543,-1.2166878071781875,-719,Unchanged,1000,5
rimK,1282,1613,0.3313501765369017,331,Unchanged,1000,5
nfsA,1198,1319,0.1388166564627591,121,Unchanged,1000,5
ybjC,343,322,-0.09114788805819528,-21,Unchanged,1000,5
grxA,159,112,-0.5055280332267513,-47,Unchanged,1000,5
ybjM,592,506,-0.22645979093463967,-86,Unchanged,1000,5
ybjL,2238,4070,0.8628187581772154,1832,Upregulated,1000,5
rcdA,210,735,1.8073549220576042,525,Unchanged,1000,5
ybjJ,517,2100,2.02215314223855,1583,Upregulated,1000,5
ybjI,819,1106,0.4334160285936985,287,Unchanged,1000,5
ybjH,149,235,0.6573484261028382,86,Unchanged,1000,5
mdfA,472,1748,1.8888464201387571,1276,Upregulated,1000,5
ybjG,2358,1221,-0.9495005179923595,-1137,Downregulated,1000,5
deoR,1256,1179,-0.09127274591186439,-77,Unchanged,1000,5
dacC,4569,2970,-0.6214155115203204,-1599,Downregulated,1000,5
gstB,3048,1360,-1.1642562513556203,-1688,Downregulated,1000,5
yliI,463,2480,2.4212560220140014,2017,Upregulated,1000,5
bssR,10383,6662,-0.6401960882122527,-3721,Downregulated,1000,5
rimO,1654,2378,0.5237894805743811,724,Unchanged,1000,5
dgcI,654,1152,0.8167781759442299,498,Unchanged,1000,5
pdeI,1556,2375,0.6100854531194805,819,Unchanged,1000,5
gsiD,251,1506,2.584962500721156,1255,Upregulated,1000,5
gsiC,385,1878,2.2862667120715106,1493,Upregulated,1000,5
gsiB,1239,3863,1.6405454900913297,2624,Upregulated,1000,5
gsiA,2083,6300,1.5966889892339944,4217,Upregulated,1000,5
iaaA,1443,4880,1.7578098479590505,3437,Upregulated,1000,5
moeA,2189,3195,0.5455439766534106,1006,Upregulated,1000,5
moeB,916,1774,0.9535865062041199,858,Unchanged,1000,5
fsaA,155,869,2.4870879615401624,714,Unchanged,1000,5
ybiY,30,1492,5.636141224646719,1462,Upregulated,1000,5
ybiW,265,4667,4.138431202513582,4402,Upregulated,1000,5
ybiV,444,1088,1.2930469749002333,644,Unchanged,1000,5
ybiU,96,2480,4.6911619045530815,2384,Upregulated,1000,5
ybiT,3661,5084,0.4737262567004134,1423,Upregulated,1000,5
ldtB,3104,1894,-0.7126922267187425,-1210,Downregulated,1000,5
ybiR,287,1990,2.7936457887553234,1703,Upregulated,1000,5
mntR,583,1156,0.9875736093001823,573,Unchanged,1000,5
yliL,2,188,6.554588851677638,186,Unchanged,1000,5
opgE,265,2432,3.198078963993024,2167,Upregulated,1000,5
ompX,48807,9662,-2.3366943190254443,-39145,Downregulated,1000,5
rhtA,180,1640,3.187627003175771,1460,Upregulated,1000,5
dps,14671,2135,-2.7806592359214415,-12536,Downregulated,1000,5
glnH,9754,1919,-2.3456392608404877,-7835,Downregulated,1000,5
glnP,3277,1272,-1.3652770022584044,-2005,Downregulated,1000,5
glnQ,3497,1503,-1.2182727867813519,-1994,Downregulated,1000,5
ybiO,672,4518,2.749151132614324,3846,Upregulated,1000,5
rlmF,1442,1794,0.3151087256784386,352,Unchanged,1000,5
mcbA,69,224,1.698830465279435,155,Unchanged,1000,5
fiu,70,4128,5.881944238478288,4058,Upregulated,1000,5
ybiX,67,1146,4.096302138299133,1079,Upregulated,1000,5
ybiI,51,281,2.4620009782494305,230,Unchanged,1000,5
ybiJ,100,250,1.3219280948873624,150,Unchanged,1000,5
hcxB,9217,4083,-1.1746676831554574,-5134,Downregulated,1000,5
ybiB,2844,2333,-0.2857351576352161,-511,Unchanged,1000,5
dinG,1871,6136,1.7134889242621494,4265,Upregulated,1000,5
ybiA,112,859,2.9391593990808595,747,Unchanged,1000,5
rhlE,751,3454,2.2013832700146523,2703,Upregulated,1000,5
cecR,562,1703,1.5994363994576164,1141,Upregulated,1000,5
ybhG,1149,2752,1.2601016720559846,1603,Upregulated,1000,5
ybhF,2044,5108,1.3213633287651025,3064,Upregulated,1000,5
ybhS,629,2785,2.146545405348105,2156,Upregulated,1000,5
ybhR,485,2499,2.365294249012214,2014,Upregulated,1000,5
ybhQ,351,663,0.9175378398080271,312,Unchanged,1000,5
ybhP,600,1332,1.1505596765753814,732,Unchanged,1000,5
clsB,877,2672,1.607271260029319,1795,Upregulated,1000,5
ybhN,286,1777,2.6353566292502886,1491,Upregulated,1000,5
ybhM,64,618,3.2714630279043746,554,Unchanged,1000,5
ybhL,3891,1918,-1.0205382599547248,-1973,Downregulated,1000,5
moaE,1752,887,-0.9819967653001095,-865,Unchanged,1000,5
moaD,260,212,-0.2944473584652553,-48,Unchanged,1000,5
moaC,2860,1422,-1.0080936820463364,-1438,Downregulated,1000,5
moaB,3256,1582,-1.0413510997934552,-1674,Downregulated,1000,5
moaA,3302,2657,-0.31354189242275143,-645,Unchanged,1000,5
ybhK,1102,1725,0.6464721379817361,623,Unchanged,1000,5
uvrB,5067,7051,0.4766960517334962,1984,Upregulated,1000,5
bioD,627,1115,0.8305063620056281,488,Unchanged,1000,5
bioC,584,1616,1.4683869238717775,1032,Upregulated,1000,5
bioF,1223,3169,1.373603255854847,1946,Upregulated,1000,5
bioB,1832,3375,0.8814679987286117,1543,Upregulated,1000,5
bioA,1022,4147,2.02067285096834,3125,Upregulated,1000,5
ybhB,1312,862,-0.6060079455289856,-450,Unchanged,1000,5
ybhC,4620,3395,-0.44448127717132574,-1225,Downregulated,1000,5
ybhJ,126,4432,5.136462242549272,4306,Upregulated,1000,5
ybhI,19,1969,6.6953198824579685,1950,Upregulated,1000,5
ybhH,9,1233,7.098032082960526,1224,Upregulated,1000,5
ybhD,21,919,5.4516036285102745,898,Unchanged,1000,5
pgl,5304,2024,-1.3898714854182777,-3280,Downregulated,1000,5
ybhA,1185,1124,-0.07624502356469538,-61,Unchanged,1000,5
modC,548,2934,2.420621072712863,2386,Upregulated,1000,5
modB,333,1743,2.387978487054423,1410,Upregulated,1000,5
modA,403,3138,2.96099360844013,2735,Upregulated,1000,5
acrZ,112,12,-3.222392421336448,-100,Unchanged,1000,5
modE,525,1642,1.6450647992243197,1117,Upregulated,1000,5
modF,666,3309,2.3128012092412766,2643,Upregulated,1000,5
galE,2865,2524,-0.18282322866171827,-341,Unchanged,1000,5
galT,2229,2268,0.025024023682476366,39,Unchanged,1000,5
galK,3675,3084,-0.2529414846960549,-591,Unchanged,1000,5
galM,9684,3637,-1.4128541535433197,-6047,Downregulated,1000,5
gpmA,6870,3083,-1.1559752095982874,-3787,Downregulated,1000,5
aroG,13069,6744,-0.9544723133417239,-6325,Downregulated,1000,5
ybgS,686,346,-0.9874365385360876,-340,Unchanged,1000,5
zitB,773,1333,0.7861364611641258,560,Unchanged,1000,5
pnuC,10328,1578,-2.710391795293732,-8750,Downregulated,1000,5
nadA,15773,2695,-2.5490999064830935,-13078,Downregulated,1000,5
cpoB,8513,2280,-1.9006338060429238,-6233,Downregulated,1000,5
pal,12885,2556,-2.3337327957999876,-10329,Downregulated,1000,5
tolB,13827,4672,-1.5653759941777878,-9155,Downregulated,1000,5
tolA,2665,2547,-0.06533657337234353,-118,Unchanged,1000,5
tolR,476,489,0.03887289164429008,13,Unchanged,1000,5
tolQ,1786,1210,-0.5617250329592661,-576,Unchanged,1000,5
ybgC,891,449,-0.9887099867807749,-442,Unchanged,1000,5
ybgE,1043,406,-1.3611875253345895,-637,Unchanged,1000,5
cydB,10697,6818,-0.6497857413838689,-3879,Downregulated,1000,5
cydA,15778,9944,-0.6660161411773403,-5834,Downregulated,1000,5
mngB,695,3651,2.3932067858240145,2956,Upregulated,1000,5
mngA,36,3044,6.4018276420612334,3008,Upregulated,1000,5
mngR,443,965,1.1232222436004242,522,Unchanged,1000,5
sucD,2502,2196,-0.1882037351606212,-306,Unchanged,1000,5
sucC,3330,3138,-0.08567682499052688,-192,Unchanged,1000,5
sucB,4106,3606,-0.18733423067626032,-500,Unchanged,1000,5
sucA,5375,7546,0.4894473454459246,2171,Upregulated,1000,5
sdhB,312,1019,1.7075361173035655,707,Unchanged,1000,5
sdhA,571,3693,2.693230611842771,3122,Upregulated,1000,5
sdhD,45,388,3.108059745857453,343,Unchanged,1000,5
sdhC,57,509,3.1586318319109536,452,Unchanged,1000,5
gltA,4843,10211,1.076151253402954,5368,Upregulated,1000,5
ybgD,12,709,5.88467931651836,697,Unchanged,1000,5
ybgQ,17,4222,7.956248022096816,4205,Upregulated,1000,5
ybgP,16,969,5.920352855415081,953,Unchanged,1000,5
ybgO,33,1253,5.246776579963407,1220,Upregulated,1000,5
abrB,589,2139,1.8605969433345837,1550,Upregulated,1000,5
nei,1068,1807,0.7586848591770456,739,Unchanged,1000,5
pxpA,1773,2091,0.23800052569089059,318,Unchanged,1000,5
pxpC,3778,3246,-0.2189597018403983,-532,Unchanged,1000,5
pxpB,2126,1999,-0.0888631247864771,-127,Unchanged,1000,5
ybgI,2940,2890,-0.024746662335685607,-50,Unchanged,1000,5
dtpD,1059,3729,1.8160862077813047,2670,Upregulated,1000,5
phr,887,2930,1.7238946550085463,2043,Upregulated,1000,5
ybgA,438,770,0.8139275759810903,332,Unchanged,1000,5
ybfD,63,563,3.1597111885803133,500,Unchanged,1000,5
ybfL,66,1104,4.064130337419716,1038,Upregulated,1000,5
ybfC,106,337,1.6686843266186593,231,Unchanged,1000,5
ybfO,136,2421,4.153924522748597,2285,Upregulated,1000,5
ybfB,20,18,-0.15200309344504995,-2,Unchanged,1000,5
rhsC,1471,10618,2.8516428948689008,9147,Upregulated,1000,5
ybfA,2277,251,-3.1813750221858506,-2026,Downregulated,1000,5
kdpA,42,4335,6.689498855330437,4293,Upregulated,1000,5
kdpB,220,6069,4.78588339175478,5849,Upregulated,1000,5
kdpC,133,1235,3.2150128909708506,1102,Upregulated,1000,5
kdpD,1830,8244,2.1715008563678513,6414,Upregulated,1000,5
kdpE,187,1476,2.9805825461727595,1289,Upregulated,1000,5
speF,70,4158,5.892391025913404,4088,Upregulated,1000,5
potE,315,2476,2.9745875808269857,2161,Upregulated,1000,5
ybfG,20,713,5.155830171556525,693,Unchanged,1000,5
ybfP,47,438,3.220198207923536,391,Unchanged,1000,5
pgm,13779,5872,-1.2305473160988876,-7907,Downregulated,1000,5
seqA,2579,1436,-0.8447560239661627,-1143,Downregulated,1000,5
ybfF,1322,1348,0.028098319674166743,26,Unchanged,1000,5
ybfE,227,286,0.3333228494874745,59,Unchanged,1000,5
fldA,3509,1495,-1.2309144633166993,-2014,Downregulated,1000,5
fur,3036,1227,-1.3070365417525613,-1809,Downregulated,1000,5
chiQ,33,320,3.277533975528909,287,Unchanged,1000,5
chiP,92,2127,4.531042361903659,2035,Upregulated,1000,5
glnS,4970,4363,-0.18792537807314874,-607,Unchanged,1000,5
nagE,1753,3834,1.1290243409086127,2081,Upregulated,1000,5
nagB,1465,985,-0.5727050349658716,-480,Unchanged,1000,5
nagA,2314,2567,0.1496944314679285,253,Unchanged,1000,5
nagC,2087,3113,0.5768749763093446,1026,Upregulated,1000,5
umpH,2473,1850,-0.4187369689862633,-623,Unchanged,1000,5
asnB,11711,4559,-1.3610749582311916,-7152,Downregulated,1000,5
ubiF,1014,2940,1.5357585027203864,1926,Upregulated,1000,5
miaB,5129,4111,-0.31918819941338006,-1018,Downregulated,1000,5
ybeZ,4419,3751,-0.2364446680955357,-668,Unchanged,1000,5
ybeY,1362,1208,-0.17310624868699223,-154,Unchanged,1000,5
ybeX,5542,3226,-0.7806602723257742,-2316,Downregulated,1000,5
lnt,1961,3240,0.724404277579838,1279,Upregulated,1000,5
insH3,5086,3668,-0.471537823095052,-1418,Downregulated,1000,5
gltI,2328,1803,-0.3686916614759422,-525,Unchanged,1000,5
gltJ,234,934,1.9969140201262574,700,Unchanged,1000,5
gltK,302,1044,1.7895012572448055,742,Unchanged,1000,5
gltL,326,1234,1.9203985249183404,908,Unchanged,1000,5
rihA,1101,1559,0.5018064591334157,458,Unchanged,1000,5
hscC,143,2390,4.062923566089721,2247,Upregulated,1000,5
djlC,182,1910,3.391562282724415,1728,Upregulated,1000,5
ybeU,39,685,4.134557958985641,646,Unchanged,1000,5
ybeT,1,392,8.614709844115207,391,Unchanged,1000,5
djlB,51,1784,5.128474557948809,1733,Upregulated,1000,5
ybeR,15,675,5.491853096329675,660,Unchanged,1000,5
ybeQ,62,1100,4.149091498025147,1038,Upregulated,1000,5
ybeL,2112,889,-1.2483545105286835,-1223,Downregulated,1000,5
leuS,17258,8851,-0.9633529152638997,-8407,Downregulated,1000,5
lptE,2392,1202,-0.9927804934869194,-1190,Downregulated,1000,5
holA,1720,1713,-0.0058834135054613625,-7,Unchanged,1000,5
nadD,594,764,0.3631097072349828,170,Unchanged,1000,5
cobC,294,735,1.3219280948873624,441,Unchanged,1000,5
rsfS,744,401,-0.8917003846531112,-343,Unchanged,1000,5
rlmH,927,984,0.0860889767137092,57,Unchanged,1000,5
mrdA,1735,3095,0.8350037466360037,1360,Upregulated,1000,5
mrdB,1123,1828,0.7029081426574686,705,Unchanged,1000,5
rlpA,3505,2300,-0.607780583066248,-1205,Downregulated,1000,5
dacA,5294,2078,-1.3491625405911867,-3216,Downregulated,1000,5
ybeD,867,346,-1.3252599555851103,-521,Unchanged,1000,5
lipB,1228,1057,-0.2163351839874963,-171,Unchanged,1000,5
ybeF,39,933,4.580331051989511,894,Unchanged,1000,5
lipA,2513,2007,-0.32437005451803846,-506,Unchanged,1000,5
tatE,377,151,-1.3200159739435855,-226,Unchanged,1000,5
crcB,508,397,-0.355689489629208,-111,Unchanged,1000,5
cspE,9436,734,-3.68432345039625,-8702,Downregulated,1000,5
pagP,592,510,-0.2150999287700918,-82,Unchanged,1000,5
dcuC,806,2157,1.4201744326324868,1351,Upregulated,1000,5
dpiA,1051,838,-0.3267405202628268,-213,Unchanged,1000,5
dpiB,1865,2775,0.5733121409822306,910,Unchanged,1000,5
citC,6544,1529,-2.097584341580944,-5015,Downregulated,1000,5
citD,3627,280,-3.6952780130253133,-3347,Downregulated,1000,5
citE,17565,1522,-3.5286633126061884,-16043,Downregulated,1000,5
citF,35674,3061,-3.5427980392116187,-32613,Downregulated,1000,5
citX,8881,920,-3.2710163668036967,-7961,Downregulated,1000,5
citG,2388,1148,-1.0566801945891173,-1240,Downregulated,1000,5
citT,14439,2193,-2.718993112012435,-12246,Downregulated,1000,5
rna,806,1711,1.085988015961446,905,Unchanged,1000,5
rnk,886,704,-0.33173126991772117,-182,Unchanged,1000,5
ybdR,1588,2099,0.40249125414919645,511,Unchanged,1000,5
uspG,5319,1062,-2.324371270815691,-4257,Downregulated,1000,5
ahpF,5126,6331,0.30459991693185695,1205,Upregulated,1000,5
ahpC,18400,7356,-1.3227123814197999,-11044,Downregulated,1000,5
dsbG,491,1101,1.1650195392496758,610,Unchanged,1000,5
ybdO,29,625,4.429731384421878,596,Unchanged,1000,5
ybdN,47,2228,5.566944665662394,2181,Upregulated,1000,5
ybdM,134,1080,3.0107264065930583,946,Unchanged,1000,5
ybdL,1558,2395,0.6203304225618733,837,Unchanged,1000,5
hcxA,1912,3369,0.8172379051410089,1457,Upregulated,1000,5
cstA,571,6499,3.508655097282057,5928,Upregulated,1000,5
entH,42,745,4.148779192570764,703,Unchanged,1000,5
entA,100,1547,3.951401291674311,1447,Upregulated,1000,5
entB,95,2072,4.446952679355606,1977,Upregulated,1000,5
entE,47,4299,6.515196543305664,4252,Upregulated,1000,5
entC,21,3096,7.20387233336565,3075,Upregulated,1000,5
fepB,66,2470,5.225901207113586,2404,Upregulated,1000,5
entS,14,3182,7.828363198273443,3168,Upregulated,1000,5
fepD,43,2669,5.955818835439868,2626,Upregulated,1000,5
fepG,48,2789,5.860569718307156,2741,Upregulated,1000,5
fepC,48,1976,5.363404730863522,1928,Upregulated,1000,5
fepE,14,1776,6.987060944292502,1762,Upregulated,1000,5
entF,399,9184,4.524661990453342,8785,Upregulated,1000,5
fes,15,2305,7.263660439708182,2290,Upregulated,1000,5
fepA,159,4194,4.721228190812237,4035,Upregulated,1000,5
entD,21,678,5.012824040357583,657,Unchanged,1000,5
insL2,1964,1840,-0.09408916337031785,-124,Unchanged,1000,5
ybdK,648,1957,1.5945780377421792,1309,Upregulated,1000,5
ybdJ,47,147,1.645083493158727,100,Unchanged,1000,5
ybdF,259,368,0.506753668370459,109,Unchanged,1000,5
nfsB,3393,1642,-1.047107302933172,-1751,Downregulated,1000,5
ybdG,4126,2928,-0.49482826760244225,-1198,Downregulated,1000,5
pheP,1564,2811,0.8458429410729909,1247,Upregulated,1000,5
cusA,287,6000,4.3858398587075555,5713,Upregulated,1000,5
cusB,79,1771,4.486567748574811,1692,Upregulated,1000,5
cusF,13,279,4.423681593688095,266,Unchanged,1000,5
cusC,25,2003,6.324090516037983,1978,Upregulated,1000,5
cusR,556,1128,1.020610279675286,572,Unchanged,1000,5
cusS,545,2203,2.015141360036594,1658,Upregulated,1000,5
nfrB,321,4022,3.647267879183049,3701,Upregulated,1000,5
nfrA,834,5608,2.7493670605659597,4774,Upregulated,1000,5
ybcH,181,1260,2.7993621313040737,1079,Upregulated,1000,5
envY,58,650,3.4863149127882447,592,Unchanged,1000,5
ompT,109949,15187,-2.855925665843311,-94762,Downregulated,1000,5
appY,1342,73,-4.200344397320166,-1269,Downregulated,1000,5
tfaX,2,53,4.727920454563199,51,Unchanged,1000,5
ybcY,27,384,3.8300749985576874,357,Unchanged,1000,5
tfaD,18,478,4.7309418065384365,460,Unchanged,1000,5
nohD,39,819,4.392317422778761,780,Unchanged,1000,5
ybcW,157,55,-1.5132610353669675,-102,Unchanged,1000,5
ybcV,12,13,0.11547721741993588,1,Unchanged,1000,5
borD,4813,257,-4.227096158770994,-4556,Downregulated,1000,5
rzpD,83,548,2.722992651613602,465,Unchanged,1000,5
rrrD,51,414,3.0210616155278296,363,Unchanged,1000,5
essD,7,45,2.6844981742720706,38,Unchanged,1000,5
insH2,5183,3326,-0.6399992250974303,-1857,Downregulated,1000,5
quuD,11,242,4.459431618637297,231,Unchanged,1000,5
rusA,8,352,5.459431618637297,344,Unchanged,1000,5
ybcO,4,226,5.820178962415188,222,Unchanged,1000,5
ninE,1,27,4.754887502163468,26,Unchanged,1000,5
ybcN,7,410,5.872125177447842,403,Unchanged,1000,5
ybcM,646,288,-1.1654653532516126,-358,Unchanged,1000,5
ybcL,132,378,1.5178483048626192,246,Unchanged,1000,5
ybcK,25,446,4.15704371014558,421,Unchanged,1000,5
emrE,116,87,-0.4150374992788438,-29,Unchanged,1000,5
renD,1519,5201,1.775667168094117,3682,Upregulated,1000,5
insF3,23,685,4.896398221790876,662,Unchanged,1000,5
insE3,132,128,-0.044394119358453395,-4,Unchanged,1000,5
exoD,4,276,6.108524456778169,272,Unchanged,1000,5
intD,767,1675,1.1268626127295636,908,Unchanged,1000,5
fimZ,18,192,3.415037499278844,174,Unchanged,1000,5
sfmF,4,395,6.625708843064465,391,Unchanged,1000,5
sfmH,23,939,5.351419391596762,916,Unchanged,1000,5
sfmD,114,3380,4.889917517004805,3266,Upregulated,1000,5
sfmC,4,543,7.084808387804362,539,Unchanged,1000,5
sfmA,28,390,3.7999753916920067,362,Unchanged,1000,5
folD,4243,2476,-0.7770733640764715,-1767,Downregulated,1000,5
ybcJ,447,229,-0.964927233086374,-218,Unchanged,1000,5
ybcI,74,938,3.6639907468864266,864,Unchanged,1000,5
cysS,3271,3113,-0.07142618261359868,-158,Unchanged,1000,5
ppiB,10047,2164,-2.2149923776010567,-7883,Downregulated,1000,5
lpxH,1036,1731,0.7405817216800848,695,Unchanged,1000,5
purE,2789,2029,-0.4589790692716531,-760,Unchanged,1000,5
purK,5606,4585,-0.2900500105500771,-1021,Downregulated,1000,5
ybcF,43,1744,5.341919570074828,1701,Upregulated,1000,5
ylbF,64,1818,4.828136484194107,1754,Upregulated,1000,5
fdrA,18,3604,7.645458294371227,3586,Upregulated,1000,5
allD,25,1896,6.244887059123535,1871,Upregulated,1000,5
allC,153,2715,4.149348639999072,2562,Upregulated,1000,5
allE,386,1246,1.6906313157559214,860,Unchanged,1000,5
glxK,132,2210,4.06543653492034,2078,Upregulated,1000,5
ybbY,37,2610,6.140380725828297,2573,Upregulated,1000,5
allB,87,3142,5.174523969445468,3055,Upregulated,1000,5
ybbW,10,2416,7.916476644437717,2406,Upregulated,1000,5
glxR,34,1684,5.630213581816057,1650,Upregulated,1000,5
hyi,25,857,5.099295204337775,832,Unchanged,1000,5
gcl,150,3592,4.581752944245266,3442,Upregulated,1000,5
allR,4566,2143,-1.091299009548154,-2423,Downregulated,1000,5
allA,92,849,3.2060587874960254,757,Unchanged,1000,5
allS,46,1785,5.278146402859449,1739,Upregulated,1000,5
selU,435,2561,2.5576199468613776,2126,Upregulated,1000,5
ylbG,161,616,1.9358696625802845,455,Unchanged,1000,5
ybbD,2,191,6.577428828035749,189,Unchanged,1000,5
ylbH,25,603,4.59215800212536,578,Unchanged,1000,5
ybbC,37,51,0.4629719763425457,14,Unchanged,1000,5
rhsD,795,9827,3.6277242903545646,9032,Upregulated,1000,5
ybbP,851,7405,3.1212686984902476,6554,Upregulated,1000,5
ybbA,447,2034,2.1859729426741823,1587,Upregulated,1000,5
tesA,654,1539,1.2346306908301277,885,Unchanged,1000,5
ybbO,1202,2456,1.030873664658994,1254,Upregulated,1000,5
cnoX,4477,3871,-0.20982601061123315,-606,Unchanged,1000,5
fetB,459,1370,1.577609834434081,911,Unchanged,1000,5
fetA,512,1093,1.0940776856719046,581,Unchanged,1000,5
qmcA,2072,2847,0.4584184900557117,775,Unchanged,1000,5
ybbJ,542,944,0.8004940080079697,402,Unchanged,1000,5
cueR,905,855,-0.08199337219730746,-50,Unchanged,1000,5
ybaT,4897,3296,-0.5711819535255476,-1601,Downregulated,1000,5
glsA,2707,2125,-0.3492320463025373,-582,Unchanged,1000,5
copA,8910,9491,0.09113467014986153,581,Unchanged,1000,5
ybaQ,782,588,-0.411352452470988,-194,Unchanged,1000,5
ybaP,910,2226,1.290515142255901,1316,Upregulated,1000,5
ybaK,821,1051,0.3563085421843737,230,Unchanged,1000,5
ushA,3058,4611,0.5924912590511229,1553,Upregulated,1000,5
fsr,250,1988,2.991317756900199,1738,Upregulated,1000,5
ybaL,2669,5400,1.016660101796227,2731,Upregulated,1000,5
gsk,2047,3102,0.5996875840126802,1055,Upregulated,1000,5
aes,122,2060,4.0776912845076945,1938,Upregulated,1000,5
hemH,478,2308,2.271560700664734,1830,Upregulated,1000,5
adk,9547,2153,-2.1486991398140236,-7394,Downregulated,1000,5
htpG,15235,12864,-0.24405018839491935,-2371,Downregulated,1000,5
recR,3471,2292,-0.5987443210717411,-1179,Downregulated,1000,5
ybaB,2425,1321,-0.8763542807150246,-1104,Downregulated,1000,5
dnaX,3164,6854,1.1151965920463824,3690,Upregulated,1000,5
apt,1522,1568,0.042957200611662895,46,Unchanged,1000,5
ybaN,54,681,3.6566234858486024,627,Unchanged,1000,5
priC,592,1368,1.2083991492569481,776,Unchanged,1000,5
ybaM,23,51,1.1488633859144828,28,Unchanged,1000,5
mscK,2849,9773,1.7783458699855794,6924,Upregulated,1000,5
acrR,308,768,1.3181759600262548,460,Unchanged,1000,5
acrA,3209,3909,0.28467579500748336,700,Unchanged,1000,5
acrB,11104,11074,-0.0039030460478649926,-30,Unchanged,1000,5
tomB,118,224,0.9247118726957629,106,Unchanged,1000,5
hha,160,201,0.32912359629156634,41,Unchanged,1000,5
maa,325,1088,1.7431669333345226,763,Unchanged,1000,5
ylaC,190,787,2.0503642171765386,597,Unchanged,1000,5
pdeB,384,2214,2.527477006060396,1830,Upregulated,1000,5
ybaA,67,429,2.678744647041773,362,Unchanged,1000,5
ffs,2,6,1.584962500721156,4,Unchanged,1000,5
ybaZ,192,492,1.3575520046180838,300,Unchanged,1000,5
ybaY,1105,817,-0.4356383861331104,-288,Unchanged,1000,5
tesB,784,1422,0.858995905504207,638,Unchanged,1000,5
amtB,390,2511,2.686715999521889,2121,Upregulated,1000,5
glnK,18,403,4.484711027085655,385,Unchanged,1000,5
mdlB,374,3164,3.080639424585155,2790,Upregulated,1000,5
mdlA,487,3202,2.7169796304339147,2715,Upregulated,1000,5
decR,226,560,1.3091040545297787,334,Unchanged,1000,5
cof,159,1119,2.815111365692039,960,Unchanged,1000,5
ybaE,248,2614,3.397847115408558,2366,Upregulated,1000,5
queC,529,1094,1.048273110678531,565,Unchanged,1000,5
fadM,61,288,2.239187663879426,227,Unchanged,1000,5
ybaV,164,414,1.3359349528812416,250,Unchanged,1000,5
ppiD,6756,4998,-0.434818426714682,-1758,Downregulated,1000,5
hupB,11231,888,-3.6607829031649928,-10343,Downregulated,1000,5
lon,16664,12308,-0.4371383957071021,-4356,Downregulated,1000,5
clpX,17133,7366,-1.2178244880777658,-9767,Downregulated,1000,5
clpP,7476,2654,-1.4940981983749648,-4822,Downregulated,1000,5
tig,23630,7237,-1.7071559525913556,-16393,Downregulated,1000,5
bolA,1498,280,-2.4195388915137848,-1218,Downregulated,1000,5
yajG,2246,1235,-0.8628468859285612,-1011,Downregulated,1000,5
ampG,1180,2203,0.9006826354516795,1023,Upregulated,1000,5
cyoA,90,1251,3.797012977836145,1161,Upregulated,1000,5
cyoB,324,2943,3.1832218240557704,2619,Upregulated,1000,5
cyoC,88,694,2.9793602339409637,606,Unchanged,1000,5
cyoD,81,308,1.9269365378102767,227,Unchanged,1000,5
cyoE,338,1303,1.9467419322859503,965,Unchanged,1000,5
yajR,608,2110,1.7950997701509621,1502,Upregulated,1000,5
yajQ,6016,2713,-1.1489155193957714,-3303,Downregulated,1000,5
panE,1748,1690,-0.04868193833105162,-58,Unchanged,1000,5
yajL,1432,1063,-0.4298898957331517,-369,Unchanged,1000,5
thiI,3164,2925,-0.11331297511466266,-239,Unchanged,1000,5
xseB,1026,373,-1.4597831953518163,-653,Unchanged,1000,5
ispA,3515,2312,-0.6043832914592188,-1203,Downregulated,1000,5
dxs,3729,4300,0.2055478627031816,571,Unchanged,1000,5
yajO,1791,1975,0.1410873159658665,184,Unchanged,1000,5
pgpA,1451,1277,-0.18428899436402066,-174,Unchanged,1000,5
thiL,1102,1679,0.6074780063658725,577,Unchanged,1000,5
nusB,2820,1084,-1.3793304059322844,-1736,Downregulated,1000,5
ribE,1881,906,-1.05391689347696,-975,Unchanged,1000,5
ribD,2395,2657,0.14977257186696405,262,Unchanged,1000,5
nrdR,1299,1060,-0.29333716599731957,-239,Unchanged,1000,5
yajI,404,570,0.4966066263003092,166,Unchanged,1000,5
tsx,8516,2793,-1.608360376172344,-5723,Downregulated,1000,5
yajD,677,317,-1.0946729934355894,-360,Unchanged,1000,5
secF,3967,2681,-0.5652771781627194,-1286,Downregulated,1000,5
secD,7855,5854,-0.42418852977280813,-2001,Downregulated,1000,5
yajC,2403,817,-1.556428664984183,-1586,Downregulated,1000,5
tgt,2831,2499,-0.17996084781904326,-332,Unchanged,1000,5
queA,838,2284,1.4465405016634911,1446,Upregulated,1000,5
acpH,310,697,1.1688904405941856,387,Unchanged,1000,5
malZ,1538,3263,1.0851434841300376,1725,Upregulated,1000,5
proY,1340,2392,0.8359843888529702,1052,Upregulated,1000,5
brnQ,6619,3029,-1.1277716926731132,-3590,Downregulated,1000,5
phoR,294,2701,3.199605579672603,2407,Upregulated,1000,5
phoB,410,1412,1.7840442737657343,1002,Upregulated,1000,5
sbcD,800,2094,1.3881895371560837,1294,Upregulated,1000,5
sbcC,1553,6714,2.112114707310249,5161,Upregulated,1000,5
araJ,324,2030,2.647414009187914,1706,Upregulated,1000,5
mak,828,1859,1.1668240974201562,1031,Upregulated,1000,5
rdgC,3510,2217,-0.662862260324616,-1293,Downregulated,1000,5
ykiA,42,218,2.375866901998166,176,Unchanged,1000,5
ppnP,1151,423,-1.4441582650122806,-728,Unchanged,1000,5
aroM,322,1160,1.8489922119003175,838,Unchanged,1000,5
yaiA,130,174,0.4205756828202737,44,Unchanged,1000,5
aroL,673,1756,1.3836144349250412,1083,Upregulated,1000,5
yaiI,301,773,1.3607049271651455,472,Unchanged,1000,5
proC,2679,1822,-0.5561716220403283,-857,Unchanged,1000,5
dgcC,77,1721,4.482244841345302,1644,Upregulated,1000,5
psiF,173,295,0.7699429166124789,122,Unchanged,1000,5
phoA,803,3799,2.242147819147708,2996,Upregulated,1000,5
iraP,1126,493,-1.191547275702318,-633,Unchanged,1000,5
ddlA,3671,2020,-0.8618178214603903,-1651,Downregulated,1000,5
yaiZ,47,160,1.767339243209725,113,Unchanged,1000,5
yaiY,485,422,-0.20074174836730485,-63,Unchanged,1000,5
yaiW,1193,2233,0.9043892081272454,1040,Upregulated,1000,5
sbmA,416,2326,2.4831956633321264,1910,Upregulated,1000,5
ampH,937,2269,1.2759356560131505,1332,Upregulated,1000,5
iprA,15,310,4.369233809665719,295,Unchanged,1000,5
insE2,79,80,0.01814734671025952,1,Unchanged,1000,5
insF2,23,556,4.595379116666495,533,Unchanged,1000,5
hemB,2960,2919,-0.020122965014044487,-41,Unchanged,1000,5
tauD,64,1482,4.533329732305834,1418,Upregulated,1000,5
tauC,34,1582,5.5400710432224525,1548,Upregulated,1000,5
tauB,40,1135,4.826548487290915,1095,Upregulated,1000,5
tauA,20,2129,6.734032139564932,2109,Upregulated,1000,5
yaiS,7,580,6.372554167957331,573,Unchanged,1000,5
yaiP,61,1842,4.91632000852845,1781,Upregulated,1000,5
insD1,465,1296,1.478763096889231,831,Unchanged,1000,5
insC1,425,206,-1.0448185038418458,-219,Unchanged,1000,5
yaiO,70,1135,4.019193565233311,1065,Upregulated,1000,5
frmR,32,571,4.157346935362843,539,Unchanged,1000,5
frmA,348,3853,3.4688229748108217,3505,Upregulated,1000,5
frmB,57,1424,4.642843416801656,1367,Upregulated,1000,5
yaiL,674,815,0.27405146793658136,141,Unchanged,1000,5
mhpT,143,2410,4.074946094338935,2267,Upregulated,1000,5
mhpE,61,2177,5.15738835462532,2116,Upregulated,1000,5
mhpF,51,1802,5.142957953842043,1751,Upregulated,1000,5
mhpD,39,1386,5.151309323274965,1347,Upregulated,1000,5
mhpC,33,1868,5.822884620351209,1835,Upregulated,1000,5
mhpB,12,1865,7.279997414421444,1853,Upregulated,1000,5
mhpA,22,3827,7.442566567031198,3805,Upregulated,1000,5
mhpR,50,1819,5.185073637876762,1769,Upregulated,1000,5
lacI,971,2684,1.4668414707809911,1713,Upregulated,1000,5
lacZ,38115,24033,-0.6653421271462036,-14082,Downregulated,1000,5
lacY,2799,2464,-0.18390923087801353,-335,Unchanged,1000,5
lacA,2089,1009,-1.0498863179607512,-1080,Downregulated,1000,5
cynX,109,3069,4.815368605689558,2960,Upregulated,1000,5
cynS,55,731,3.732367882427778,676,Unchanged,1000,5
cynT,44,1523,5.113268607849995,1479,Upregulated,1000,5
cynR,204,2122,3.378783598943269,1918,Upregulated,1000,5
codA,13627,3555,-1.9385465211399973,-10072,Downregulated,1000,5
codB,16339,3201,-2.351725106555469,-13138,Downregulated,1000,5
prpE,84,5617,6.06326666479985,5533,Upregulated,1000,5
prpD,41,4370,6.735865559769877,4329,Upregulated,1000,5
prpC,27,2690,6.638502955280518,2663,Upregulated,1000,5
prpB,11,2420,7.78135971352466,2409,Upregulated,1000,5
prpR,36,3530,6.61552746671623,3494,Upregulated,1000,5
yahO,750,152,-2.302819271939658,-598,Unchanged,1000,5
yahN,85,1264,3.8943898120394014,1179,Upregulated,1000,5
yahM,12,170,3.8244284354165456,158,Unchanged,1000,5
yahL,23,627,4.768759676745026,604,Unchanged,1000,5
yahK,1614,2520,0.6427831551094985,906,Unchanged,1000,5
yahJ,1002,3537,1.8196437105057104,2535,Upregulated,1000,5
yahI,47,2160,5.522226745373193,2113,Upregulated,1000,5
yahG,92,3747,5.3479583062721,3655,Upregulated,1000,5
yahF,68,3626,5.7367003684938185,3558,Upregulated,1000,5
yahE,35,1183,5.078951341394822,1148,Upregulated,1000,5
yahD,81,639,2.9798221180623696,558,Unchanged,1000,5
yahC,23,879,5.2561573990863915,856,Unchanged,1000,5
yahB,192,1467,2.9336906549522337,1275,Upregulated,1000,5
pdeL,2092,2088,-0.0027611396770568656,-4,Unchanged,1000,5
betT,318,4523,3.8301813253470556,4205,Upregulated,1000,5
betI,305,1482,2.280664299855585,1177,Upregulated,1000,5
betB,866,4573,2.400701989080239,3707,Upregulated,1000,5
betA,494,4160,3.074000581443777,3666,Upregulated,1000,5
ykgH,5,283,5.82273014794452,278,Unchanged,1000,5
ykgG,153,1321,3.110026908554176,1168,Upregulated,1000,5
ykgF,427,2914,2.770692902444022,2487,Upregulated,1000,5
ykgE,77,1192,3.95238197976726,1115,Upregulated,1000,5
rclR,71,1419,4.320911754555869,1348,Upregulated,1000,5
rclA,543,1676,1.62599804589499,1133,Upregulated,1000,5
rclB,6,40,2.736965594166206,34,Unchanged,1000,5
rclC,43,599,3.8001474380866878,556,Unchanged,1000,5
ykgA,164,648,1.982297998266541,484,Unchanged,1000,5
insF1,30,351,3.548436624696042,321,Unchanged,1000,5
insE1,70,89,0.34645041402143123,19,Unchanged,1000,5
eaeH,10,1059,6.726558779104974,1049,Upregulated,1000,5
ykgM,6,105,4.129283016944966,99,Unchanged,1000,5
ykgL,11,35,1.669851398307669,24,Unchanged,1000,5
ecpR,193,312,0.6929451815941678,119,Unchanged,1000,5
ecpA,1126,873,-0.36715326845078944,-253,Unchanged,1000,5
ecpB,193,1083,2.4883604903402468,890,Unchanged,1000,5
ecpC,469,4713,3.328985853499976,4244,Upregulated,1000,5
ecpD,431,2405,2.480277119568306,1974,Upregulated,1000,5
ecpE,195,1016,2.381354373022555,821,Unchanged,1000,5
ykgJ,80,326,2.0268000593437154,246,Unchanged,1000,5
yagU,7525,1179,-2.674127863554664,-6346,Downregulated,1000,5
paoA,153,1570,3.3591610010863375,1417,Upregulated,1000,5
paoB,175,2281,3.7042396194798086,2106,Upregulated,1000,5
paoC,476,5693,3.5801556210832026,5217,Upregulated,1000,5
paoD,214,2674,3.643316763692206,2460,Upregulated,1000,5
intF,2685,3552,0.4037094934773309,867,Unchanged,1000,5
yagN,1014,572,-0.8259706002249511,-442,Unchanged,1000,5
yagM,18,256,3.8300749985576874,238,Unchanged,1000,5
yagL,29,285,3.296837113924532,256,Unchanged,1000,5
yagK,133,768,2.5296800652199667,635,Unchanged,1000,5
yagJ,170,1756,3.3686861933976564,1586,Upregulated,1000,5
insA3,35,320,3.192645077942396,285,Unchanged,1000,5
insB3,86,1523,4.146435471785194,1437,Upregulated,1000,5
argF,1092,5038,2.2058782658143885,3946,Upregulated,1000,5
xynR,739,2431,1.7179036238825778,1692,Upregulated,1000,5
yagH,1344,5885,2.130509277147046,4541,Upregulated,1000,5
yagG,917,4804,2.3892425121105796,3887,Upregulated,1000,5
yagF,553,6133,3.4712415654059843,5580,Upregulated,1000,5
yagE,247,2714,3.457837773834177,2467,Upregulated,1000,5
yagA,24,3061,6.994824828805835,3037,Upregulated,1000,5
yagB,140,454,1.6972654703459484,314,Unchanged,1000,5
insA2,49,420,3.0995356735509145,371,Unchanged,1000,5
insB2,137,1026,2.9047829326465275,889,Unchanged,1000,5
afuB,13,723,5.797412118810025,710,Unchanged,1000,5
afuC,73,2857,5.290460762056354,2784,Upregulated,1000,5
mmuM,922,2421,1.3927644235695986,1499,Upregulated,1000,5
mmuP,690,3402,2.3017148739978537,2712,Upregulated,1000,5
insH1,1717,3867,1.171324725080673,2150,Upregulated,1000,5
ykfC,398,2407,2.596395805930848,2009,Upregulated,1000,5
insI1,38,36,-0.07800251200127321,-2,Unchanged,1000,5
perR,105,1528,3.8631833103696263,1423,Upregulated,1000,5
ykfA,98,1401,3.83753139631561,1303,Upregulated,1000,5
yafZ,13,1392,6.742503777707636,1379,Upregulated,1000,5
yafY,26,405,3.9613383796308947,379,Unchanged,1000,5
ykfB,199,666,1.7427537465276133,467,Unchanged,1000,5
ykfF,25,264,3.400537929583729,239,Unchanged,1000,5
yafX,193,841,2.123504952987064,648,Unchanged,1000,5
ykfG,30,753,4.649615459063409,723,Unchanged,1000,5
yafW,29,438,3.9168060644736014,409,Unchanged,1000,5
ykfI,13,288,4.46948528330122,275,Unchanged,1000,5
proA,4837,3447,-0.48877123907859327,-1390,Downregulated,1000,5
proB,4802,3678,-0.3847139238184788,-1124,Downregulated,1000,5
phoE,29,1090,5.232131424536717,1061,Upregulated,1000,5
crl,1340,5219,1.961540401275384,3879,Upregulated,1000,5
frsA,2630,2974,0.1773418478727541,344,Unchanged,1000,5
gpt,2604,538,-2.2750513706090114,-2066,Downregulated,1000,5
pepD,16229,5064,-1.6802247966312664,-11165,Downregulated,1000,5
prfH,13,644,5.630477159973525,631,Unchanged,1000,5
ykfJ,1,74,6.20945336562895,73,Unchanged,1000,5
yafP,55,337,2.6152450676571988,282,Unchanged,1000,5
yafO,81,303,1.9033239805883262,222,Unchanged,1000,5
yafN,129,210,0.7030182622428686,81,Unchanged,1000,5
dinB,1003,2105,1.0694986273415776,1102,Upregulated,1000,5
lafU,62,898,3.8563753243542718,836,Unchanged,1000,5
lfhA,70,2642,5.238131734301861,2572,Upregulated,1000,5
rayT,213,419,0.9760968134735133,206,Unchanged,1000,5
yafL,92,957,3.3788131584290126,865,Unchanged,1000,5
dinJ,620,294,-1.0764520604378731,-326,Unchanged,1000,5
yafQ,299,177,-0.7563961241151075,-122,Unchanged,1000,5
ldtF,1510,934,-0.6930540945027793,-576,Unchanged,1000,5
yafJ,1260,1166,-0.11185594518678231,-94,Unchanged,1000,5
gmhA,3326,1753,-0.923962172527731,-1573,Downregulated,1000,5
fadE,380,4336,3.512293433022924,3956,Upregulated,1000,5
ivy,29038,2907,-3.3203391141626644,-26131,Downregulated,1000,5
yafV,755,1097,0.5390149761907516,342,Unchanged,1000,5
yafU,2,115,5.845490050944375,113,Unchanged,1000,5
yafT,39,546,3.807354922057604,507,Unchanged,1000,5
dnaQ,1774,1192,-0.5736217738389024,-582,Unchanged,1000,5
rnhA,404,533,0.39978024000738116,129,Unchanged,1000,5
yafS,498,701,0.4932687019425422,203,Unchanged,1000,5
gloB,457,575,0.33136779077366796,118,Unchanged,1000,5
mltD,6965,2992,-1.2190131776009787,-3973,Downregulated,1000,5
yafE,268,588,1.133583154378592,320,Unchanged,1000,5
yafD,2492,1788,-0.4789573318406841,-704,Unchanged,1000,5
yafC,561,1334,1.2496859905757922,773,Unchanged,1000,5
dkgB,225,648,1.5260688116675876,423,Unchanged,1000,5
gmhB,710,586,-0.2769183599697965,-124,Unchanged,1000,5
metN,10879,2560,-2.0873302345090456,-8319,Downregulated,1000,5
metI,4930,1454,-1.7615603773456796,-3476,Downregulated,1000,5
metQ,21292,2202,-3.273425097361117,-19090,Downregulated,1000,5
rcsF,1432,673,-1.0893530826539393,-759,Unchanged,1000,5
trmO,1062,1145,0.10856383218015271,83,Unchanged,1000,5
proS,10167,4531,-1.1659926466917614,-5636,Downregulated,1000,5
yaeF,61,896,3.876617584494718,835,Unchanged,1000,5
nlpE,768,1121,0.5456080620842706,353,Unchanged,1000,5
arfB,333,619,0.8944172321430025,286,Unchanged,1000,5
yaeQ,566,989,0.8051684679272285,423,Unchanged,1000,5
rof,1094,336,-1.7030796000137962,-758,Unchanged,1000,5
tilS,1674,2348,0.4881328805597085,674,Unchanged,1000,5
yaeR,330,418,0.3410369178350669,88,Unchanged,1000,5
ldcC,1860,3413,0.8757377931034717,1553,Upregulated,1000,5
accA,5631,2604,-1.112661702386395,-3027,Downregulated,1000,5
dnaE,6065,7506,0.30753664487910326,1441,Upregulated,1000,5
rnhB,1058,1287,0.282672426106676,229,Unchanged,1000,5
lpxB,3900,3379,-0.20687777347317152,-521,Unchanged,1000,5
lpxA,5579,3083,-0.8556716619409007,-2496,Downregulated,1000,5
fabZ,3247,1462,-1.1511640733336508,-1785,Downregulated,1000,5
lpxD,22317,4821,-2.2107387686637288,-17496,Downregulated,1000,5
skp,13479,2175,-2.6316261616211416,-11304,Downregulated,1000,5
bamA,23333,8136,-1.5199802269520264,-15197,Downregulated,1000,5
rseP,7681,3889,-0.9818949148622766,-3792,Downregulated,1000,5
cdsA,3120,1808,-0.7871513513344228,-1312,Downregulated,1000,5
uppS,3244,1321,-1.2961433529704454,-1923,Downregulated,1000,5
dxr,1423,2224,0.644221126197025,801,Unchanged,1000,5
frr,9176,2046,-2.1650592462704963,-7130,Downregulated,1000,5
pyrH,6446,2314,-1.4780153239520553,-4132,Downregulated,1000,5
tsf,26993,6595,-2.033140762144993,-20398,Downregulated,1000,5
rpsB,49068,9015,-2.4443830719278177,-40053,Downregulated,1000,5
map,3894,1640,-1.2475570692148488,-2254,Downregulated,1000,5
glnD,3717,4862,0.3874112051669712,1145,Upregulated,1000,5
dapD,9718,3613,-1.4274621776848422,-6105,Downregulated,1000,5
yaeI,218,969,2.152168530638155,751,Unchanged,1000,5
yaeH,1102,437,-1.3344190390705593,-665,Unchanged,1000,5
cdaR,234,1737,2.8920173191269885,1503,Upregulated,1000,5
degP,8840,7139,-0.3083243676423581,-1701,Downregulated,1000,5
dgt,1210,2212,0.8703443380727502,1002,Upregulated,1000,5
mtn,2775,2447,-0.18147367004544102,-328,Unchanged,1000,5
btuF,455,1461,1.6830177277174398,1006,Upregulated,1000,5
yadS,192,945,2.299208018387279,753,Unchanged,1000,5
erpA,1638,749,-1.1288977331822576,-889,Unchanged,1000,5
clcA,1423,3073,1.1107121050664799,1650,Upregulated,1000,5
hemL,6309,4937,-0.35377670571183883,-1372,Downregulated,1000,5
fhuB,289,4831,4.063180454931398,4542,Upregulated,1000,5
fhuD,183,1865,3.349260076858558,1682,Upregulated,1000,5
fhuC,240,1911,2.993221467368938,1671,Upregulated,1000,5
fhuA,812,4226,2.3797411347497643,3414,Upregulated,1000,5
mrcB,3223,6379,0.9849260901198685,3156,Upregulated,1000,5
hrpB,2277,6513,1.516187935199678,4236,Upregulated,1000,5
thpR,338,842,1.3167969867842118,504,Unchanged,1000,5
sfsA,796,1123,0.4965175918569524,327,Unchanged,1000,5
dksA,5898,1898,-1.6357458300406276,-4000,Downregulated,1000,5
gluQ,257,1532,2.575576032731079,1275,Upregulated,1000,5
pcnB,7003,4320,-0.6969417750889682,-2683,Downregulated,1000,5
folK,364,621,0.7706548180217851,257,Unchanged,1000,5
yadN,7,534,6.25334100962995,527,Unchanged,1000,5
yadV,8,686,6.422064766172812,678,Unchanged,1000,5
htrE,90,2363,4.714550817644172,2273,Upregulated,1000,5
yadM,45,400,3.15200309344505,355,Unchanged,1000,5
yadL,68,365,2.4242898125170402,297,Unchanged,1000,5
yadK,19,312,4.037474705418663,293,Unchanged,1000,5
yadC,68,607,3.1580898650053424,539,Unchanged,1000,5
panB,7600,4583,-0.7297071328439977,-3017,Downregulated,1000,5
panC,9902,4616,-1.1010767253166782,-5286,Downregulated,1000,5
rpnC,118,1048,3.150779952175609,930,Unchanged,1000,5
panD,3277,590,-2.4735888132935564,-2687,Downregulated,1000,5
yadE,379,1857,2.2927040617643293,1478,Upregulated,1000,5
yadI,187,516,1.4643327955356173,329,Unchanged,1000,5
yadH,773,1126,0.5426665081553823,353,Unchanged,1000,5
yadG,974,1747,0.8428859308344173,773,Unchanged,1000,5
can,1783,1054,-0.7584318359877802,-729,Unchanged,1000,5
hpt,1728,1087,-0.6687512771361593,-641,Unchanged,1000,5
gcd,365,4715,3.6912894017950793,4350,Upregulated,1000,5
cueO,1526,2906,0.9292797407983108,1380,Upregulated,1000,5
yacC,374,449,0.26367717485351017,75,Unchanged,1000,5
speE,3965,2539,-0.6430604709438351,-1426,Downregulated,1000,5
speD,5051,1945,-1.3767988865576484,-3106,Downregulated,1000,5
yacL,367,499,0.44325975249404775,132,Unchanged,1000,5
acnB,11551,12248,0.08452843305444614,697,Unchanged,1000,5
yacH,108,3410,4.980668521748067,3302,Upregulated,1000,5
lpd,4924,9621,0.9663560926783457,4697,Upregulated,1000,5
aceF,3333,15117,2.1812786395806607,11784,Upregulated,1000,5
aceE,4427,20500,2.2112226311823053,16073,Upregulated,1000,5
pdhR,214,3051,3.833599478177509,2837,Upregulated,1000,5
aroP,1341,3309,1.303086054408065,1968,Upregulated,1000,5
ampE,966,1616,0.7423321039160216,650,Unchanged,1000,5
ampD,585,977,0.7399219374976185,392,Unchanged,1000,5
nadC,880,1755,0.9958956016672635,875,Unchanged,1000,5
ppdD,6,668,6.798741791752896,662,Unchanged,1000,5
hofB,207,2662,3.6848078984125667,2455,Upregulated,1000,5
hofC,144,2558,4.150875547439325,2414,Upregulated,1000,5
guaC,8293,2263,-1.8736575077294848,-6030,Downregulated,1000,5
coaE,500,1018,1.0257375614136082,518,Unchanged,1000,5
zapD,1011,1439,0.5092835948372834,428,Unchanged,1000,5
yacG,75,157,1.0658020583957462,82,Unchanged,1000,5
mutT,74,281,1.9249729545919763,207,Unchanged,1000,5
secA,8479,11743,0.46983499204021323,3264,Upregulated,1000,5
secM,1363,1227,-0.15165031314230443,-136,Unchanged,1000,5
lpxC,40225,24484,-0.716253147691607,-15741,Downregulated,1000,5
ftsZ,22718,8607,-1.4002534575093086,-14111,Downregulated,1000,5
ftsA,5696,4396,-0.37375776001716665,-1300,Downregulated,1000,5
ftsQ,3490,2794,-0.3208950156875514,-696,Unchanged,1000,5
ddlB,5291,3034,-0.8023193321603057,-2257,Downregulated,1000,5
murC,6363,4643,-0.45464984068504954,-1720,Downregulated,1000,5
murG,3622,2956,-0.2931402768040169,-666,Unchanged,1000,5
ftsW,3563,3704,0.05599161512693684,141,Unchanged,1000,5
murD,5300,4248,-0.31920859353377024,-1052,Downregulated,1000,5
mraY,3504,2775,-0.3365150034763427,-729,Unchanged,1000,5
murF,6004,4034,-0.573712893007727,-1970,Downregulated,1000,5
murE,7043,4850,-0.5382053354274857,-2193,Downregulated,1000,5
ftsI,3873,4417,0.18961533101180636,544,Unchanged,1000,5
ftsL,783,608,-0.3649409838474552,-175,Unchanged,1000,5
rsmH,5264,3646,-0.5298449276961072,-1618,Downregulated,1000,5
mraZ,2814,1921,-0.5507648095710056,-893,Unchanged,1000,5
cra,4031,3394,-0.24815121830841616,-637,Unchanged,1000,5
ilvH,1567,1606,0.03546671304473432,39,Unchanged,1000,5
ilvI,6468,6503,0.007785744966595214,35,Unchanged,1000,5
leuO,356,1323,1.8938639153122792,967,Unchanged,1000,5
leuL,1,1,0.0,0,Unchanged,1000,5
leuA,9070,4953,-0.8727999297814705,-4117,Downregulated,1000,5
leuB,9512,3489,-1.4469351175512815,-6023,Downregulated,1000,5
leuC,13063,5585,-1.225857073092109,-7478,Downregulated,1000,5
leuD,4945,1867,-1.4052485934202712,-3078,Downregulated,1000,5
setA,654,2432,1.894780687945503,1778,Upregulated,1000,5
sgrR,629,4527,2.8474233843685504,3898,Upregulated,1000,5
thiB,676,2262,1.7425037777076362,1586,Upregulated,1000,5
thiP,254,3743,3.8812946461277957,3489,Upregulated,1000,5
thiQ,147,1537,3.3862291048544066,1390,Upregulated,1000,5
yabI,336,1797,2.4190572707311815,1461,Upregulated,1000,5
araC,558,2223,1.9941709211978025,1665,Upregulated,1000,5
araB,96,4012,5.385143389891025,3916,Upregulated,1000,5
araA,169,3659,4.436354264056903,3490,Upregulated,1000,5
araD,34,1458,5.422312163076597,1424,Upregulated,1000,5
polB,1148,4883,2.0886451359617757,3735,Upregulated,1000,5
rapA,1702,6270,1.8812344060034387,4568,Upregulated,1000,5
rluA,323,1135,1.8130862274843524,812,Unchanged,1000,5
djlA,683,1745,1.353269552806924,1062,Upregulated,1000,5
lptD,15687,8100,-0.9535756629086479,-7587,Downregulated,1000,5
surA,9386,5589,-0.7479202853654693,-3797,Downregulated,1000,5
pdxA,2187,2558,0.22606304383354378,371,Unchanged,1000,5
rsmA,3304,2135,-0.6299776169115925,-1169,Downregulated,1000,5
apaG,1093,832,-0.3936379675308125,-261,Unchanged,1000,5
apaH,1602,1895,0.2423237006497438,293,Unchanged,1000,5
folA,663,764,0.2045637679231608,101,Unchanged,1000,5
kefC,818,4462,2.4475177653023916,3644,Upregulated,1000,5
kefF,220,912,2.0515303006400822,692,Unchanged,1000,5
yaaU,31,2853,6.524067721194845,2822,Upregulated,1000,5
fixX,5,294,5.877744249949002,289,Unchanged,1000,5
fixC,46,2992,6.023332503830623,2946,Upregulated,1000,5
fixB,59,2155,5.190829104614619,2096,Upregulated,1000,5
fixA,58,1677,4.853685978436774,1619,Upregulated,1000,5
caiT,36,2922,6.3428154613611865,2886,Upregulated,1000,5
caiA,466,2368,2.3452672209746694,1902,Upregulated,1000,5
caiB,244,2260,3.211369719739664,2016,Upregulated,1000,5
caiC,312,2861,3.196901563460935,2549,Upregulated,1000,5
caiD,56,1653,4.883516087234709,1597,Upregulated,1000,5
caiE,49,1168,4.575114714764809,1119,Upregulated,1000,5
caiF,2125,1004,-1.0817035719616543,-1121,Downregulated,1000,5
carB,87261,11084,-2.976858390979492,-76177,Downregulated,1000,5
carA,39642,3752,-3.4012980175830543,-35890,Downregulated,1000,5
dapB,2670,1893,-0.4961653308712111,-777,Unchanged,1000,5
rihC,369,2201,2.576466423831161,1832,Upregulated,1000,5
ispH,3204,3048,-0.0720112449153881,-156,Unchanged,1000,5
fkpB,1220,1102,-0.14675692387909103,-118,Unchanged,1000,5
lspA,2428,1585,-0.6152855812289125,-843,Unchanged,1000,5
ileS,26188,16243,-0.6890877684242107,-9945,Downregulated,1000,5
ribF,5326,3097,-0.7821810455359511,-2229,Downregulated,1000,5
yaaY,16,143,3.1598713367783895,127,Unchanged,1000,5
rpsT,3080,393,-2.9703291333236574,-2687,Downregulated,1000,5
insA1,18,180,3.321928094887362,162,Unchanged,1000,5
insB1,37,444,3.584962500721156,407,Unchanged,1000,5
nhaR,999,1918,0.9410461372257125,919,Unchanged,1000,5
nhaA,4014,5155,0.36093181089285364,1141,Upregulated,1000,5
mokC,20,112,2.4854268271702415,92,Unchanged,1000,5
insL1,1370,2634,0.9430794524086253,1264,Upregulated,1000,5
dnaJ,4436,7278,0.7142826856799565,2842,Upregulated,1000,5
dnaK,59018,42708,-0.4666486929157538,-16310,Downregulated,1000,5
yaaI,10,571,5.83541884047548,561,Unchanged,1000,5
yaaW,51,1140,4.482392767080609,1089,Upregulated,1000,5
satP,321,1268,1.981909543017104,947,Unchanged,1000,5
mog,716,1296,0.8560342256203683,580,Unchanged,1000,5
talB,30807,7264,-2.0844220911612354,-23543,Downregulated,1000,5
yaaJ,622,2970,2.255476445557526,2348,Upregulated,1000,5
yaaA,1210,1732,0.5174318825647681,522,Unchanged,1000,5
yaaX,114,320,1.4890380807226207,206,Unchanged,1000,5
thrC,8008,11992,0.5825584091118661,3984,Upregulated,1000,5
thrB,5969,11160,0.9027758682667467,5191,Upregulated,1000,5
thrA,18297,38832,1.0856388918640891,20535,Upregulated,1000,5
thrL,1,1,0.0,0,Unchanged,1000,5
sokX,1,1,0.0,0,Unchanged,10000,5
sokE,1,1,0.0,0,Unchanged,10000,5
fnrS,1,2,1.0,1,Unchanged,10000,5
mgrR,1,1,0.0,0,Unchanged,10000,5
yrdF,2,5,1.3219280948873624,3,Unchanged,10000,5
yneO,1069,5385,2.3326844917110794,4316,Unchanged,10000,5
aaaE,138,1397,3.339591848631294,1259,Unchanged,10000,5
oweE,13,123,3.2420747871981477,110,Unchanged,10000,5
sroH,2,16,3.0,14,Unchanged,10000,5
eyeA,1,1,0.0,0,Unchanged,10000,5
rzoQ,2,22,3.4594316186372973,20,Unchanged,10000,5
ykgS,29,83,1.5170584362193527,54,Unchanged,10000,5
shoB,1,1,0.0,0,Unchanged,10000,5
yshB,4,2,-1.0,-2,Unchanged,10000,5
yrbN,1,1,0.0,0,Unchanged,10000,5
yqfG,1,1,0.0,0,Unchanged,10000,5
yqeL,1,1,0.0,0,Unchanged,10000,5
yqcG,1,1,0.0,0,Unchanged,10000,5
ypdK,1,1,0.0,0,Unchanged,10000,5
yohP,1,1,0.0,0,Unchanged,10000,5
yoeI,1,1,0.0,0,Unchanged,10000,5
yobI,1,1,0.0,0,Unchanged,10000,5
yoaK,1,1,0.0,0,Unchanged,10000,5
yoaJ,1,1,0.0,0,Unchanged,10000,5
ynbG,1,1,0.0,0,Unchanged,10000,5
ymjD,1,1,0.0,0,Unchanged,10000,5
ymiB,1,1,0.0,0,Unchanged,10000,5
ykgR,1,1,0.0,0,Unchanged,10000,5
yjeV,1,1,0.0,0,Unchanged,10000,5
ilvX,1,1,0.0,0,Unchanged,10000,5
ibsB,1,1,0.0,0,Unchanged,10000,5
ibsA,1,1,0.0,0,Unchanged,10000,5
ibsE,1,1,0.0,0,Unchanged,10000,5
ibsC,1,1,0.0,0,Unchanged,10000,5
ibsD,1,1,0.0,0,Unchanged,10000,5
azuC,1,1,0.0,0,Unchanged,10000,5
sgrT,5,10,1.0,5,Unchanged,10000,5
yfcU,353,3690,3.385880727676578,3337,Unchanged,10000,5
yhiL,32,433,3.758223214726725,401,Unchanged,10000,5
yghX,317,1052,1.730579959152895,735,Unchanged,10000,5
yjhZ,2,70,5.129283016944966,68,Unchanged,10000,5
yjhY,311,271,-0.19862172877673107,-40,Unchanged,10000,5
ythA,1,1,0.0,0,Unchanged,10000,5
yjdQ,1,12,3.584962500721156,11,Unchanged,10000,5
yicT,1,8,3.0,7,Unchanged,10000,5
yibU,1,47,5.554588851677638,46,Unchanged,10000,5
yibW,3,83,4.7900769306257684,80,Unchanged,10000,5
yibS,3,105,5.129283016944966,102,Unchanged,10000,5
ysaD,1,79,6.303780748177103,78,Unchanged,10000,5
ysaC,1,1,0.0,0,Unchanged,10000,5
mokA,1,15,3.9068905956085187,14,Unchanged,10000,5
yrdE,18,203,3.495410915742864,185,Unchanged,10000,5
psaA,1,1,0.0,0,Unchanged,10000,5
ypjI,5,176,5.137503523749935,171,Unchanged,10000,5
pawZ,1,1,0.0,0,Unchanged,10000,5
yoeD,1,4,2.0,3,Unchanged,10000,5
yoeH,27,18,-0.5849625007211563,-9,Unchanged,10000,5
yoeG,160,321,1.0045013922349408,161,Unchanged,10000,5
yeeH,1,1,0.0,0,Unchanged,10000,5
ttcC,1,1,0.0,0,Unchanged,10000,5
uof,1,1,0.0,0,Unchanged,10000,5
ybfI,1,14,3.807354922057604,13,Unchanged,10000,5
aaaD,6,264,5.459431618637297,258,Unchanged,10000,5
xisD,77,169,1.1340928955872829,92,Unchanged,10000,5
ylbI,1,1,0.0,0,Unchanged,10000,5
ykgQ,1,1,0.0,0,Unchanged,10000,5
ykgP,1,1,0.0,0,Unchanged,10000,5
ykfK,2,92,5.523561956057013,90,Unchanged,10000,5
ykfL,8,186,4.539158811108031,178,Unchanged,10000,5
ykfN,1,1,0.0,0,Unchanged,10000,5
symR,1,1,0.0,0,Unchanged,10000,5
ryjB,1,1,0.0,0,Unchanged,10000,5
insO,334,3978,3.5741232683596915,3644,Unchanged,10000,5
ytcA,1,290,8.179909090014934,289,Unchanged,10000,5
yjbS,1,7,2.807354922057604,6,Unchanged,10000,5
yjbT,8,164,4.357552004618084,156,Unchanged,10000,5
tisB,1,1,0.0,0,Unchanged,10000,5
istR,1,21,4.392317422778761,20,Unchanged,10000,5
yibV,3,94,4.9696263509564815,91,Unchanged,10000,5
sokA,1,1,0.0,0,Unchanged,10000,5
dinQ,2,7,1.8073549220576042,5,Unchanged,10000,5
yrhD,1,2,1.0,1,Unchanged,10000,5
sibE,3,3,0.0,0,Unchanged,10000,5
ryfD,13,3,-2.115477217419936,-10,Unchanged,10000,5
ohsC,1,1,0.0,0,Unchanged,10000,5
ypfM,1,1,0.0,0,Unchanged,10000,5
yojO,1,13,3.700439718141092,12,Unchanged,10000,5
rseX,1,1,0.0,0,Unchanged,10000,5
cydH,1,1,0.0,0,Unchanged,10000,5
ydgU,1,1,0.0,0,Unchanged,10000,5
mgtS,1,1,0.0,0,Unchanged,10000,5
yncL,1,1,0.0,0,Unchanged,10000,5
rydC,1,1,0.0,0,Unchanged,10000,5
yciZ,212,57,-1.8950304403984575,-155,Unchanged,10000,5
yciY,161,39,-2.0455146592523685,-122,Unchanged,10000,5
ymgJ,6,8,0.41503749927884376,2,Unchanged,10000,5
ymgI,1,3,1.584962500721156,2,Unchanged,10000,5
appX,1,1,0.0,0,Unchanged,10000,5
ybfK,1,97,6.599912842187128,96,Unchanged,10000,5
ylcI,30,66,1.1375035237499351,36,Unchanged,10000,5
ylcH,1,3,1.584962500721156,2,Unchanged,10000,5
insN,1725,3383,0.9717068152410945,1658,Unchanged,10000,5
ykfM,6,7,0.22239242133644802,1,Unchanged,10000,5
chiX,1,1,0.0,0,Unchanged,10000,5
yoeA,384,2481,2.6917435191712746,2097,Unchanged,10000,5
ybeM,368,1091,1.5678734302665942,723,Unchanged,10000,5
yaiT,548,5158,3.234563974828687,4610,Unchanged,10000,5
yncK,14,232,4.050626073069968,218,Unchanged,10000,5
sgrS,52,86,0.7258250365610057,34,Unchanged,10000,5
insB7,37,824,4.477047161554268,787,Unchanged,10000,5
yjgX,499,1673,1.745325724701092,1174,Unchanged,10000,5
insZ,103,1383,3.7470849139672757,1280,Unchanged,10000,5
ylbE,82,3030,5.20755007374223,2948,Unchanged,10000,5
lomR,148,2885,4.284902237903895,2737,Unchanged,10000,5
yhcE,1924,8506,2.144372055855722,6582,Unchanged,10000,5
ytjA,336,72,-2.222392421336448,-264,Unchanged,10000,5
yjjZ,6,136,4.502500340529183,130,Unchanged,10000,5
topAI,23,98,2.0911478880581953,75,Unchanged,10000,5
sgcB,7,172,4.618909832644494,165,Unchanged,10000,5
insM,19,45,1.2439255828860891,26,Unchanged,10000,5
ghoT,2,6,1.584962500721156,4,Unchanged,10000,5
yifL,297,143,-1.0544477840223765,-154,Unchanged,10000,5
yidD,474,222,-1.0943273825481532,-252,Unchanged,10000,5
ysdC,69,1626,4.558587085296859,1557,Unchanged,10000,5
yicS,31,198,2.6751603096927346,167,Unchanged,10000,5
yibT,231,122,-0.9210117038531713,-109,Unchanged,10000,5
ysaB,34,230,2.7580272096940357,196,Unchanged,10000,5
yrhC,7,137,4.290677160902923,130,Unchanged,10000,5
yheV,29,32,0.14201900487242786,3,Unchanged,10000,5
arfA,59,39,-0.5972408304995929,-20,Unchanged,10000,5
ypjJ,1,78,6.285402218862249,77,Unchanged,10000,5
ypfN,80,151,0.9164766444377165,71,Unchanged,10000,5
ypeB,91,111,0.28662122615140984,20,Unchanged,10000,5
ypdJ,1,1,0.0,0,Unchanged,10000,5
arnE,34,305,3.1652025911999093,271,Unchanged,10000,5
ypaA,50,53,0.08406426478847455,3,Unchanged,10000,5
yohO,1,1,0.0,0,Unchanged,10000,5
yehK,1,94,6.554588851677638,93,Unchanged,10000,5
yoeB,153,170,0.15200309344505006,17,Unchanged,10000,5
yoeF,1,10,3.321928094887362,9,Unchanged,10000,5
yecJ,185,148,-0.3219280948873623,-37,Unchanged,10000,5
yobH,203,65,-1.6429681041567217,-138,Unchanged,10000,5
yniD,1,2,1.0,1,Unchanged,10000,5
ynfO,16,90,2.4918530963296748,74,Unchanged,10000,5
hicA,39,37,-0.07594885323329863,-2,Unchanged,10000,5
ydbJ,957,354,-1.4347695644030283,-603,Unchanged,10000,5
rzoR,4,5,0.32192809488736235,1,Unchanged,10000,5
ydaF,2,31,3.9541963103868754,29,Unchanged,10000,5
ydaE,3,9,1.584962500721156,6,Unchanged,10000,5
ymjC,2,3,0.5849625007211562,1,Unchanged,10000,5
ymjB,29,1743,5.909375858998113,1714,Unchanged,10000,5
yciX,30,29,-0.0489096004809464,-1,Unchanged,10000,5
ymiA,3,11,1.874469117916141,8,Unchanged,10000,5
ycgI,32,227,2.826548487290915,195,Unchanged,10000,5
ymgF,9,22,1.289506617194985,13,Unchanged,10000,5
icdC,3,27,3.169925001442312,24,Unchanged,10000,5
ymdF,130,61,-1.0916304754655681,-69,Unchanged,10000,5
gnsA,44,57,0.37345839552744436,13,Unchanged,10000,5
insA4,7,262,5.226068079479846,255,Unchanged,10000,5
cydX,8,4,-1.0,-4,Unchanged,10000,5
ybfQ,10,66,2.722466024471091,56,Unchanged,10000,5
kdpF,1,1,0.0,0,Unchanged,10000,5
ybdD,18,71,1.9798221180623699,53,Unchanged,10000,5
ybdZ,2,133,6.05528243550119,131,Unchanged,10000,5
rzoD,5,9,0.8479969065549501,4,Unchanged,10000,5
ylcG,1,6,2.584962500721156,5,Unchanged,10000,5
peaD,2,231,6.851749041416057,229,Unchanged,10000,5
ykgO,1,6,2.584962500721156,5,Unchanged,10000,5
insX,130,242,0.89649542424614,112,Unchanged,10000,5
ykfH,7,152,4.4405725913859815,145,Unchanged,10000,5
yafF,3,90,4.906890595608519,87,Unchanged,10000,5
yeiW,4,202,5.658211482751795,198,Unchanged,10000,5
torI,13,29,1.15754127698648,16,Unchanged,10000,5
yfaS,364,7694,4.401723474097919,7330,Unchanged,10000,5
yehH,240,5701,4.570108690524543,5461,Unchanged,10000,5
yeeL,51,389,2.931201003014696,338,Unchanged,10000,5
yedS,262,791,1.5941108829353414,529,Unchanged,10000,5
yedN,29,211,2.863118193579613,182,Unchanged,10000,5
arpB,68,987,3.8594434332060583,919,Unchanged,10000,5
gapC,14295,3808,-1.9084052362105168,-10487,Downregulated,10000,5
ydbA,5237,15549,1.5700092896565043,10312,Upregulated,10000,5
ycgH,586,1826,1.639714195561974,1240,Unchanged,10000,5
efeU,20,1857,6.536830005048058,1837,Unchanged,10000,5
ilvG,7954,14887,0.9043005867860018,6933,Unchanged,10000,5
yjdP,165,637,1.9488273480104847,472,Unchanged,10000,5
yjiV,1271,5318,2.0649197468527087,4047,Unchanged,10000,5
ytfR,175,2691,3.9427155638080884,2516,Unchanged,10000,5
cpxP,1372,2510,0.8714068826653221,1138,Unchanged,10000,5
tatD,906,1419,0.6472916340143162,513,Unchanged,10000,5
yigE,43,1044,4.601641241867787,1001,Unchanged,10000,5
wecF,834,1273,0.6101131304566944,439,Unchanged,10000,5
hdfR,1225,1064,-0.20328359838874335,-161,Unchanged,10000,5
dgoR,326,1708,2.389364105389413,1382,Unchanged,10000,5
dgoD,115,2334,4.343098794762973,2219,Unchanged,10000,5
dgoA,39,973,4.6408937759188635,934,Unchanged,10000,5
gntU,350,3078,3.1365664044958814,2728,Unchanged,10000,5
rtcA,332,2851,3.102212892591028,2519,Unchanged,10000,5
frlC,64,1370,4.419960177847889,1306,Unchanged,10000,5
smf,493,951,0.9478576944826519,458,Unchanged,10000,5
yhdP,3334,6050,0.8596810380629025,2716,Unchanged,10000,5
tdcG,127,1768,3.799217872619266,1641,Unchanged,10000,5
cyuA,278,2229,3.003239828536245,1951,Unchanged,10000,5
ygiQ,1439,3832,1.4130309689958824,2393,Unchanged,10000,5
glcE,78,2695,5.11066733877762,2617,Unchanged,10000,5
glcF,301,3146,3.3856832786559847,2845,Unchanged,10000,5
yghJ,7703,8990,0.2229006904246339,1287,Unchanged,10000,5
yggP,89,1558,4.129746087095271,1469,Unchanged,10000,5
ghxQ,238,1659,2.8012804076479196,1421,Unchanged,10000,5
ygcU,68,1934,4.829909238226501,1866,Unchanged,10000,5
ygaQ,17,946,5.798233532089056,929,Unchanged,10000,5
yfjD,652,1551,1.2502548168050134,899,Unchanged,10000,5
araH,277,1225,2.1448238678407443,948,Unchanged,10000,5
ryjA,1,16,4.0,15,Unchanged,10000,5
oxyS,1,1,0.0,0,Unchanged,10000,5
csrC,64712,3906,-4.0502694117477835,-60806,Downregulated,10000,5
glmZ,2821,925,-1.608681395181897,-1896,Unchanged,10000,5
hokA,1,3,1.584962500721156,2,Unchanged,10000,5
rdlD,1,1,0.0,0,Unchanged,10000,5
ldrD,1,1,0.0,0,Unchanged,10000,5
gadY,1,1,0.0,0,Unchanged,10000,5
ryhB,1,1,0.0,0,Unchanged,10000,5
arcZ,1,1,0.0,0,Unchanged,10000,5
sraG,1,19,4.247927513443585,18,Unchanged,10000,5
sibD,3,12,2.0,9,Unchanged,10000,5
sibC,1,7,2.807354922057604,6,Unchanged,10000,5
omrB,1,1,0.0,0,Unchanged,10000,5
omrA,1,1,0.0,0,Unchanged,10000,5
gcvB,1042,50,-4.381283372503783,-992,Unchanged,10000,5
micA,1,1,0.0,0,Unchanged,10000,5
glmY,101,54,-0.9033239805883261,-47,Unchanged,10000,5
ryfA,185,389,1.0722448844698798,204,Unchanged,10000,5
micF,1,1,0.0,0,Unchanged,10000,5
cyaR,1,1,0.0,0,Unchanged,10000,5
sibB,1,6,2.584962500721156,5,Unchanged,10000,5
sibA,2,10,2.321928094887362,8,Unchanged,10000,5
isrC,35,18,-0.9593580155026542,-17,Unchanged,10000,5
sdsR,1,1,0.0,0,Unchanged,10000,5
ryeA,331,240,-0.46379681119869925,-91,Unchanged,10000,5
rprA,1,1,0.0,0,Unchanged,10000,5
rydB,1,1,0.0,0,Unchanged,10000,5
sokB,1,1,0.0,0,Unchanged,10000,5
hokB,6,11,0.874469117916141,5,Unchanged,10000,5
micC,1,1,0.0,0,Unchanged,10000,5
mcaS,1,13,3.700439718141092,12,Unchanged,10000,5
rttR,15,132,3.137503523749935,117,Unchanged,10000,5
rdlC,1,1,0.0,0,Unchanged,10000,5
ldrC,1,1,0.0,0,Unchanged,10000,5
rdlB,1,1,0.0,0,Unchanged,10000,5
ldrB,1,3,1.584962500721156,2,Unchanged,10000,5
rdlA,1,1,0.0,0,Unchanged,10000,5
ldrA,2,1,-1.0,-1,Unchanged,10000,5
sraB,2,14,2.807354922057604,12,Unchanged,10000,5
rybB,1,1,0.0,0,Unchanged,10000,5
rybA,1,1,0.0,0,Unchanged,10000,5
hokE,3,18,2.584962500721156,15,Unchanged,10000,5
tff,75,8,-3.228818690495881,-67,Unchanged,10000,5
sokC,1,1,0.0,0,Unchanged,10000,5
hokC,1,10,3.321928094887362,9,Unchanged,10000,5
ecnB,30,24,-0.3219280948873623,-6,Unchanged,10000,5
ecnA,2,3,0.5849625007211562,1,Unchanged,10000,5
blr,16,3,-2.415037499278844,-13,Unchanged,10000,5
csrB,623178,260368,-1.2590921550619776,-362810,Downregulated,10000,5
thiS,6,71,3.564784618783526,65,Unchanged,10000,5
yaeP,974,316,-1.6239972139052394,-658,Unchanged,10000,5
yjtD,303,1091,1.8482614028506563,788,Unchanged,10000,5
yjjY,1,12,3.584962500721156,11,Unchanged,10000,5
arcA,18961,3232,-2.55253595053786,-15729,Downregulated,10000,5
creD,132,2359,4.159565583881009,2227,Unchanged,10000,5
creC,331,3081,3.2184955602321335,2750,Unchanged,10000,5
creB,419,1320,1.6555157805464642,901,Unchanged,10000,5
creA,590,815,0.4660851048692364,225,Unchanged,10000,5
rob,3855,2200,-0.8092273363903748,-1655,Unchanged,10000,5
ytjC,1339,1457,0.12184491674020201,118,Unchanged,10000,5
yjjX,410,1130,1.4626269577971038,720,Unchanged,10000,5
trpR,367,545,0.5704761668210759,178,Unchanged,10000,5
slt,3688,5047,0.4525874308690885,1359,Unchanged,10000,5
ettA,10993,4743,-1.2127133793175484,-6250,Unchanged,10000,5
nadR,1902,2532,0.4127601585677778,630,Unchanged,10000,5
radA,2676,3891,0.5400628643313947,1215,Unchanged,10000,5
serB,1260,2385,0.920565532505595,1125,Unchanged,10000,5
ytjB,442,1204,1.4457171173682706,762,Unchanged,10000,5
lplA,857,2361,1.4620309321161429,1504,Unchanged,10000,5
yjjJ,688,2642,1.9411499965447296,1954,Unchanged,10000,5
deoD,7557,3615,-1.0638179756169173,-3942,Unchanged,10000,5
deoB,10766,7437,-0.5336896532115522,-3329,Unchanged,10000,5
deoA,4885,6684,0.4523531712054403,1799,Unchanged,10000,5
deoC,2561,3892,0.6038044571836431,1331,Unchanged,10000,5
yjjI,5004,5258,0.0714323524522261,254,Unchanged,10000,5
yjjW,1294,2319,0.841665202653496,1025,Unchanged,10000,5
yjjV,529,1681,1.6679800971221417,1152,Unchanged,10000,5
yjjU,1517,2120,0.48284317920352815,603,Unchanged,10000,5
osmY,3816,1635,-1.2227705356200667,-2181,Unchanged,10000,5
prfC,3488,3339,-0.06298394671381069,-149,Unchanged,10000,5
yjjG,1035,1347,0.3801190830756155,312,Unchanged,10000,5
rimI,804,829,0.04417660031682193,25,Unchanged,10000,5
holD,946,872,-0.11751204856246883,-74,Unchanged,10000,5
rsmC,1525,2059,0.4331345872946432,534,Unchanged,10000,5
fhuF,67,1197,4.15911824648573,1130,Unchanged,10000,5
bglJ,25,477,4.2539892662307865,452,Unchanged,10000,5
yjjQ,17,629,5.20945336562895,612,Unchanged,10000,5
yjjP,456,1375,1.5923258891346426,919,Unchanged,10000,5
yjjB,206,646,1.6488898275107065,440,Unchanged,10000,5
dnaT,209,718,1.7804809017421686,509,Unchanged,10000,5
dnaC,465,1575,1.7600492072792475,1110,Unchanged,10000,5
yjjA,498,897,0.8489622428511803,399,Unchanged,10000,5
opgB,2212,5627,1.3470145778228502,3415,Unchanged,10000,5
lgoD,25,2008,6.327687364176048,1983,Unchanged,10000,5
lgoR,244,1756,2.847339791972472,1512,Unchanged,10000,5
lgoT,158,3325,4.395357877098811,3167,Unchanged,10000,5
tsr,315,4676,3.8918511961443776,4361,Unchanged,10000,5
btsT,618,7336,3.5693148956906797,6718,Unchanged,10000,5
yjiX,29,104,1.84245872301352,75,Unchanged,10000,5
yjiA,1004,2341,1.2213656651612408,1337,Unchanged,10000,5
mrr,878,1767,1.0090091950162585,889,Unchanged,10000,5
hsdR,5342,8841,0.7268295852100465,3499,Unchanged,10000,5
hsdM,1239,2944,1.2486014839164112,1705,Unchanged,10000,5
hsdS,698,1184,0.7623701394192975,486,Unchanged,10000,5
symE,93,322,1.7917580670065856,229,Unchanged,10000,5
mcrB,870,1119,0.36312273024030334,249,Unchanged,10000,5
mcrC,279,477,0.773724144176324,198,Unchanged,10000,5
yjiT,3658,2524,-0.5353431647661675,-1134,Unchanged,10000,5
yjiS,2,38,4.247927513443585,36,Unchanged,10000,5
yjiR,298,2529,3.0851828012010767,2231,Unchanged,10000,5
mdtM,575,2213,1.944369589969274,1638,Unchanged,10000,5
yjiN,588,2484,2.078777113384117,1896,Unchanged,10000,5
yjiM,4315,3389,-0.34850092258232307,-926,Unchanged,10000,5
yjiL,1152,1680,0.5443205162238102,528,Unchanged,10000,5
yjiK,240,1022,2.090288885329103,782,Unchanged,10000,5
yjiJ,100,2147,4.424250286084049,2047,Unchanged,10000,5
kptA,173,822,2.2483663560449583,649,Unchanged,10000,5
yjiH,20255,4357,-2.2168710666586313,-15898,Downregulated,10000,5
yjiG,11863,2271,-2.3850692838713368,-9592,Unchanged,10000,5
iadA,53248,9915,-2.425042661024882,-43333,Downregulated,10000,5
hypT,7998,3191,-1.3256306725308171,-4807,Unchanged,10000,5
iraD,753,575,-0.3890879088401906,-178,Unchanged,10000,5
yjiC,34,450,3.7263183499666974,416,Unchanged,10000,5
uxuR,769,1481,0.9455161373270212,712,Unchanged,10000,5
uxuB,221,3413,3.9489221397074337,3192,Unchanged,10000,5
uxuA,200,2027,3.341274183692174,1827,Unchanged,10000,5
gntP,123,2064,4.068712750084014,1941,Unchanged,10000,5
fimH,225,1241,2.4635062089133197,1016,Unchanged,10000,5
fimG,119,676,2.5060616729742407,557,Unchanged,10000,5
fimF,73,604,3.0485801804450614,531,Unchanged,10000,5
fimD,455,3930,3.1105908620599103,3475,Unchanged,10000,5
fimC,251,746,1.5714882663044658,495,Unchanged,10000,5
fimI,604,797,0.4000311746653929,193,Unchanged,10000,5
fimA,5131,1171,-2.131498949690201,-3960,Unchanged,10000,5
fimE,36,611,4.085103568376417,575,Unchanged,10000,5
fimB,453,521,0.20177232223227326,68,Unchanged,10000,5
nanC,13,540,5.376375878909739,527,Unchanged,10000,5
nanM,473,1073,1.1817379874171268,600,Unchanged,10000,5
nanS,134,1239,3.2088712816828293,1105,Unchanged,10000,5
yjhR,61,1303,4.416884031005248,1242,Unchanged,10000,5
yjhQ,164,818,2.3184050283236655,654,Unchanged,10000,5
yjhP,281,1574,2.4857935052865603,1293,Unchanged,10000,5
sgcX,106,1900,4.163863248655111,1794,Unchanged,10000,5
sgcC,109,2384,4.450984195685235,2275,Unchanged,10000,5
sgcQ,91,1421,3.964896199044084,1330,Unchanged,10000,5
sgcA,87,645,2.890211854461888,558,Unchanged,10000,5
sgcE,126,1200,3.2515387669959646,1074,Unchanged,10000,5
sgcR,141,1365,3.275133883408421,1224,Unchanged,10000,5
yjhI,52,650,3.643856189774725,598,Unchanged,10000,5
yjhH,117,1553,3.7304773948038967,1436,Unchanged,10000,5
yjhG,585,4332,2.8885247131375604,3747,Unchanged,10000,5
yjhF,68,2459,5.176393178345743,2391,Unchanged,10000,5
yjhU,1749,2834,0.6963094689963659,1085,Unchanged,10000,5
insA7,35,295,3.0752881273042374,260,Unchanged,10000,5
fecI,59,1258,4.414273157517448,1199,Unchanged,10000,5
fecR,50,2024,5.339137384919585,1974,Unchanged,10000,5
fecA,161,6076,5.2379892763874665,5915,Unchanged,10000,5
fecB,171,2314,3.758320634221592,2143,Unchanged,10000,5
fecC,87,2035,4.547869583304881,1948,Unchanged,10000,5
fecD,71,1658,4.545481171991068,1587,Unchanged,10000,5
fecE,143,1471,3.3627101944764406,1328,Unchanged,10000,5
yjhV,7,388,5.792557920129523,381,Unchanged,10000,5
insI3,26,13,-1.0,-13,Unchanged,10000,5
yjhE,4,173,5.434628227636725,169,Unchanged,10000,5
yjhD,16,125,2.965784284662087,109,Unchanged,10000,5
nanY,303,814,1.425711000793296,511,Unchanged,10000,5
nanX,73,541,2.889660224946798,468,Unchanged,10000,5
insG,539,2030,1.9131225493200332,1491,Unchanged,10000,5
yjgZ,2,370,7.531381460516312,368,Unchanged,10000,5
insD6,314,333,0.08475761817963527,19,Unchanged,10000,5
insC6,297,262,-0.18089611926331556,-35,Unchanged,10000,5
intB,473,1343,1.5055472160880472,870,Unchanged,10000,5
ahr,1429,1372,-0.0587254349230041,-57,Unchanged,10000,5
idnK,61,375,2.620009447820357,314,Unchanged,10000,5
idnD,92,1218,3.7267364618493195,1126,Unchanged,10000,5
idnO,86,678,2.978876708434246,592,Unchanged,10000,5
idnT,135,1472,3.4467463590061818,1337,Unchanged,10000,5
idnR,316,1169,1.8872784663545534,853,Unchanged,10000,5
yjgR,999,2404,1.2668803129187671,1405,Unchanged,10000,5
lptG,1926,2552,0.4060206259214101,626,Unchanged,10000,5
lptF,1531,2441,0.6729980122813661,910,Unchanged,10000,5
pepA,14790,6269,-1.238314817550709,-8521,Unchanged,10000,5
holC,1329,781,-0.7669466511341951,-548,Unchanged,10000,5
valS,23802,10327,-1.204661592068277,-13475,Downregulated,10000,5
yjgN,38,420,3.466318004222537,382,Unchanged,10000,5
yjgM,397,541,0.4464895866838575,144,Unchanged,10000,5
rraB,3370,1086,-1.6337244882648594,-2284,Unchanged,10000,5
argI,736,3290,2.160309912565591,2554,Unchanged,10000,5
yjgL,292,252,-0.21254463538010074,-40,Unchanged,10000,5
tabA,1081,416,-1.377711089593558,-665,Unchanged,10000,5
bdcR,178,385,1.112981204615866,207,Unchanged,10000,5
bdcA,106,792,2.9014361655164103,686,Unchanged,10000,5
yjgH,120,294,1.292781749227846,174,Unchanged,10000,5
pyrL,186,20,-3.217230716220669,-166,Unchanged,10000,5
pyrB,140918,1708,-6.366404119239856,-139210,Downregulated,10000,5
pyrI,71072,608,-6.869066164103395,-70464,Downregulated,10000,5
ridA,34381,897,-5.26035971204243,-33484,Downregulated,10000,5
mgtA,1319,4158,1.6564451936068254,2839,Unchanged,10000,5
treR,678,1218,0.8451569547699884,540,Unchanged,10000,5
treB,191,2014,3.398419139971036,1823,Unchanged,10000,5
treC,173,2259,3.7068403277563595,2086,Unchanged,10000,5
nrdD,2249,4026,0.8400635111435228,1777,Unchanged,10000,5
nrdG,148,440,1.5719063478957098,292,Unchanged,10000,5
cybC,227,432,0.9283390148725535,205,Unchanged,10000,5
tldE,3937,2957,-0.41296246903871686,-980,Unchanged,10000,5
yjgA,957,820,-0.22289501498057954,-137,Unchanged,10000,5
mpl,4487,3051,-0.5564690040976888,-1436,Unchanged,10000,5
fbp,5724,2020,-1.5026683790875106,-3704,Unchanged,10000,5
yjfF,105,1226,3.5454977460246586,1121,Unchanged,10000,5
ytfT,94,1494,3.9903755811115995,1400,Unchanged,10000,5
ytfQ,214,1326,2.631398073711441,1112,Unchanged,10000,5
ppa,8657,1608,-2.4285997529658547,-7049,Unchanged,10000,5
chpB,91,412,2.178705886984522,321,Unchanged,10000,5
chpS,81,184,1.183711953172388,103,Unchanged,10000,5
ytfP,1536,413,-1.894964529301711,-1123,Unchanged,10000,5
tamB,4177,7508,0.8459615066680816,3331,Unchanged,10000,5
tamA,2349,3583,0.6091213301985393,1234,Unchanged,10000,5
msrA,1422,1071,-0.4089629848691594,-351,Unchanged,10000,5
ytfL,468,2004,2.0983020736118037,1536,Unchanged,10000,5
ytfK,137,44,-1.6386004643232295,-93,Unchanged,10000,5
ytfJ,73,630,3.1093834595072614,557,Unchanged,10000,5
ytfI,28,283,3.337303320774278,255,Unchanged,10000,5
cysQ,975,1065,0.12737930647622742,90,Unchanged,10000,5
cpdB,1721,2884,0.7448240672006189,1163,Unchanged,10000,5
ytfH,43,368,3.0972972013549147,325,Unchanged,10000,5
qorB,346,1323,1.934969118641952,977,Unchanged,10000,5
ytfF,77,1433,4.2180363535672445,1356,Unchanged,10000,5
ytfE,87,834,3.2609600775959353,747,Unchanged,10000,5
cycA,2479,2784,0.16740093976200615,305,Unchanged,10000,5
fklB,5501,1399,-1.9752979404805746,-4102,Unchanged,10000,5
ytfB,1143,1018,-0.16708784213878292,-125,Unchanged,10000,5
ytfA,5,159,4.990954860396993,154,Unchanged,10000,5
yjfZ,28,551,4.298553586513553,523,Unchanged,10000,5
rplI,15234,2078,-2.87402724146445,-13156,Downregulated,10000,5
rpsR,2683,578,-2.2147056567598424,-2105,Unchanged,10000,5
priB,5540,925,-2.582360705532876,-4615,Unchanged,10000,5
rpsF,13785,2732,-2.3350698786074626,-11053,Downregulated,10000,5
yjfY,23,146,2.666262602823004,123,Unchanged,10000,5
ulaF,109,1035,3.247230727609761,926,Unchanged,10000,5
ulaE,192,1468,2.9346737521220567,1276,Unchanged,10000,5
ulaD,166,1103,2.732177644244458,937,Unchanged,10000,5
ulaC,45,499,3.471042909007586,454,Unchanged,10000,5
ulaB,14,287,4.357552004618084,273,Unchanged,10000,5
ulaA,43,2279,5.727920454563199,2236,Unchanged,10000,5
ulaG,75,1749,4.543495883425772,1674,Unchanged,10000,5
ulaR,443,1254,1.5011587442470207,811,Unchanged,10000,5
yjfP,243,1078,2.1493289591467244,835,Unchanged,10000,5
bsmA,77,285,1.8880315683572026,208,Unchanged,10000,5
yjfN,41,141,1.78199934778071,100,Unchanged,10000,5
aidB,5102,2629,-0.9565487569844264,-2473,Unchanged,10000,5
yjfC,41,1601,5.287205587898173,1560,Unchanged,10000,5
yjfM,17,759,5.480493234165127,742,Unchanged,10000,5
yjfL,6,290,5.594946589293778,284,Unchanged,10000,5
yjfK,13,675,5.698303973797101,662,Unchanged,10000,5
yjfJ,41,1164,4.8273233382902,1123,Unchanged,10000,5
yjfI,12,106,3.142957953842043,94,Unchanged,10000,5
rlmB,1045,1441,0.46356739320650253,396,Unchanged,10000,5
rnr,10457,8416,-0.31326240762558943,-2041,Unchanged,10000,5
nsrR,295,477,0.6932743117563079,182,Unchanged,10000,5
purA,23089,18152,-0.3470771762571141,-4937,Unchanged,10000,5
yjeT,5,104,4.37851162325373,99,Unchanged,10000,5
hflC,6891,3677,-0.9061841808957836,-3214,Unchanged,10000,5
hflK,9808,6222,-0.6565805841563997,-3586,Unchanged,10000,5
hflX,7991,5306,-0.5907513788716409,-2685,Unchanged,10000,5
hfq,4476,1251,-1.839128246810574,-3225,Unchanged,10000,5
miaA,10145,7422,-0.45088895894649533,-2723,Unchanged,10000,5
mutL,2299,5565,1.2753752215111418,3266,Unchanged,10000,5
amiB,1778,3773,1.0854567759803395,1995,Unchanged,10000,5
tsaE,552,824,0.5779760704050493,272,Unchanged,10000,5
nnr,2667,4200,0.6551715030025589,1533,Unchanged,10000,5
queG,779,2929,1.9107129598176977,2150,Unchanged,10000,5
orn,1620,1054,-0.6201189461347726,-566,Unchanged,10000,5
rsgA,2150,2617,0.28357726457121224,467,Unchanged,10000,5
psd,3235,3212,-0.010293819362555372,-23,Unchanged,10000,5
mscM,1887,6836,1.857057974075694,4949,Unchanged,10000,5
yjeO,23,256,3.476438043942987,233,Unchanged,10000,5
yjeN,28,239,3.0935118859231445,211,Unchanged,10000,5
yjeM,151,1858,3.6211300470575742,1707,Unchanged,10000,5
epmA,421,1287,1.6121199151543057,866,Unchanged,10000,5
frdA,38764,8131,-2.253212748243349,-30633,Downregulated,10000,5
frdB,10822,2048,-2.4016795259824515,-8774,Unchanged,10000,5
frdC,4966,751,-2.725199448662569,-4215,Unchanged,10000,5
frdD,5398,836,-2.690850129385969,-4562,Unchanged,10000,5
ampC,749,1332,0.8305564586125112,583,Unchanged,10000,5
blc,259,528,1.0275858316718995,269,Unchanged,10000,5
gdx,132,288,1.1255308820838588,156,Unchanged,10000,5
efp,7060,1073,-2.7180181074020204,-5987,Unchanged,10000,5
epmB,1192,1594,0.41926739352831016,402,Unchanged,10000,5
yjeJ,98,792,3.014646775964401,694,Unchanged,10000,5
yjeI,2567,945,-1.4416970614669833,-1622,Unchanged,10000,5
groL,60572,25188,-1.2659144754207468,-35384,Downregulated,10000,5
groS,4494,1107,-2.0213449023983547,-3387,Unchanged,10000,5
yjeH,732,1696,1.2122206162791567,964,Unchanged,10000,5
fxsA,574,839,0.5476200737641356,265,Unchanged,10000,5
aspA,7847,3180,-1.3031144346913133,-4667,Unchanged,10000,5
dcuA,11019,3961,-1.4760566955481942,-7058,Unchanged,10000,5
cutA,328,248,-0.4033556942312085,-80,Unchanged,10000,5
dsbD,2441,2656,0.12178285156577087,215,Unchanged,10000,5
yjdC,1807,825,-1.1311304817314214,-982,Unchanged,10000,5
cadC,251,870,1.7933280367853186,619,Unchanged,10000,5
cadB,32,1087,5.086136225027309,1055,Unchanged,10000,5
cadA,78,2308,4.887025289783234,2230,Unchanged,10000,5
dtpC,250,1637,2.7110543218120666,1387,Unchanged,10000,5
lysU,3428,2158,-0.6676722446244828,-1270,Unchanged,10000,5
ghoS,46,65,0.4988058569714417,19,Unchanged,10000,5
yjdJ,160,156,-0.03652587602511404,-4,Unchanged,10000,5
yjdI,58,102,0.8144443468439234,44,Unchanged,10000,5
dcuS,1229,2441,0.9899873794084922,1212,Unchanged,10000,5
dcuR,766,929,0.2783342044576957,163,Unchanged,10000,5
dcuB,9416,4483,-1.070649820987756,-4933,Unchanged,10000,5
fumB,16430,6852,-1.2617354237534377,-9578,Unchanged,10000,5
yjdF,122,849,2.798883405990152,727,Unchanged,10000,5
melB,163,1347,3.0468059812312256,1184,Unchanged,10000,5
melA,196,1969,3.3285375517863454,1773,Unchanged,10000,5
melR,202,1317,2.7048281475047196,1115,Unchanged,10000,5
adiA,168,3617,4.428260459877014,3449,Unchanged,10000,5
adiY,269,467,0.7958163771530377,198,Unchanged,10000,5
adiC,127,1957,3.945743353854638,1830,Unchanged,10000,5
eptA,83,2242,4.755531131458502,2159,Unchanged,10000,5
basR,363,1064,1.551456697505439,701,Unchanged,10000,5
basS,231,1723,2.8989579448088905,1492,Unchanged,10000,5
proP,7138,11464,0.6835187082131229,4326,Unchanged,10000,5
rdcB,118,2059,4.125085065270413,1941,Unchanged,10000,5
rdcA,329,5157,3.970372556463976,4828,Unchanged,10000,5
yjdM,620,485,-0.3542834681997476,-135,Unchanged,10000,5
yjdN,279,1028,1.8815032373646905,749,Unchanged,10000,5
phnC,5,1596,8.318316841334983,1591,Unchanged,10000,5
phnD,10,2957,8.207990433232961,2947,Unchanged,10000,5
phnF,12,1817,7.242380203512959,1805,Unchanged,10000,5
phnG,4,1004,7.971543553950772,1000,Unchanged,10000,5
phnH,2,1362,9.411510988012072,1360,Unchanged,10000,5
phnI,4,2328,9.184875342908283,2324,Unchanged,10000,5
phnJ,12,2435,7.664743556248548,2423,Unchanged,10000,5
phnK,15,1614,6.749534267669262,1599,Unchanged,10000,5
phnL,40,2108,5.719731056749852,2068,Unchanged,10000,5
phnM,29,3408,6.876728625098266,3379,Unchanged,10000,5
phnN,33,1465,5.472290829951157,1432,Unchanged,10000,5
phnO,153,1071,2.807354922057604,918,Unchanged,10000,5
phnP,181,1876,3.373598225432171,1695,Unchanged,10000,5
rpiB,45,889,4.304186512500095,844,Unchanged,10000,5
alsR,590,1545,1.3888199785425335,955,Unchanged,10000,5
alsB,88,1801,4.355150847268979,1713,Unchanged,10000,5
alsA,24,2769,6.850186837645774,2745,Unchanged,10000,5
alsC,25,2036,6.34766565630097,2011,Unchanged,10000,5
alsE,43,1228,4.835830090668082,1185,Unchanged,10000,5
alsK,110,1821,4.0491554934521785,1711,Unchanged,10000,5
yjcS,27,3694,7.09608064881897,3667,Unchanged,10000,5
mdtN,13,1986,7.255210189387282,1973,Unchanged,10000,5
mdtO,55,4169,6.24412594328373,4114,Unchanged,10000,5
mdtP,42,3298,6.295058260658707,3256,Unchanged,10000,5
fdhF,4319,4771,0.14359436977728296,452,Unchanged,10000,5
yjcO,696,1490,1.0981531195007956,794,Unchanged,10000,5
gltP,6078,5245,-0.21265390205766438,-833,Unchanged,10000,5
nrfG,73,1005,3.7831552271862736,932,Unchanged,10000,5
nrfF,53,582,3.4569548883450847,529,Unchanged,10000,5
nrfE,331,3870,3.547430444224555,3539,Unchanged,10000,5
nrfD,2101,2167,0.04462299142062747,66,Unchanged,10000,5
nrfC,1432,1468,0.035820475578956346,36,Unchanged,10000,5
nrfB,1324,871,-0.604158498208353,-453,Unchanged,10000,5
nrfA,7611,3380,-1.1710627736155488,-4231,Unchanged,10000,5
acs,65,4302,6.0484239963946065,4237,Unchanged,10000,5
yjcH,5,271,5.760220946466509,266,Unchanged,10000,5
actP,86,3293,5.25892204189325,3207,Unchanged,10000,5
yjcF,11,168,3.932885804141463,157,Unchanged,10000,5
yjcE,1302,4311,1.7272931140128571,3009,Unchanged,10000,5
ghxP,2213,3334,0.5912506531854052,1121,Unchanged,10000,5
soxR,143,614,2.10222350859179,471,Unchanged,10000,5
soxS,84,345,2.038135128886771,261,Unchanged,10000,5
pdeC,217,2160,3.3152643646063513,1943,Unchanged,10000,5
yjcB,58,378,2.7042614290935005,320,Unchanged,10000,5
ssb,1912,1466,-0.3831974198469366,-446,Unchanged,10000,5
uvrA,5169,8394,0.6994732609398051,3225,Unchanged,10000,5
yjbR,2674,610,-2.132118317643104,-2064,Unchanged,10000,5
yjbQ,4184,979,-2.0955020866432466,-3205,Unchanged,10000,5
aphA,502,1096,1.1264885290097546,594,Unchanged,10000,5
tyrB,1916,2412,0.33213234616390447,496,Unchanged,10000,5
alr,2452,2474,0.012886521285588268,22,Unchanged,10000,5
dnaB,4407,3311,-0.41252988588043665,-1096,Unchanged,10000,5
qorA,3702,2050,-0.8526809854777657,-1652,Unchanged,10000,5
pspG,511,477,-0.09933402493210979,-34,Unchanged,10000,5
dusA,1120,1642,0.5519553948328383,522,Unchanged,10000,5
yjbM,14,219,3.967432137543569,205,Unchanged,10000,5
yjbL,3,4,0.41503749927884376,1,Unchanged,10000,5
zur,717,777,0.11594147970580533,60,Unchanged,10000,5
yjbJ,1018,58,-4.1335408509481235,-960,Unchanged,10000,5
dinF,680,1930,1.504994196017741,1250,Unchanged,10000,5
lexA,4786,1260,-1.92539666315122,-3526,Unchanged,10000,5
dgkA,506,514,0.02263097449956785,8,Unchanged,10000,5
plsB,7820,5034,-0.6354633910337353,-2786,Unchanged,10000,5
ubiA,776,1208,0.6384918971379513,432,Unchanged,10000,5
ubiC,444,734,0.7252203864931068,290,Unchanged,10000,5
yjbI,18,224,3.6374299206152916,206,Unchanged,10000,5
malM,606,1216,1.0047535299706345,610,Unchanged,10000,5
lamB,1703,1893,0.15259597602516287,190,Unchanged,10000,5
malK,892,1622,0.8626582042969683,730,Unchanged,10000,5
malE,3388,2359,-0.5222584560927361,-1029,Unchanged,10000,5
malF,1100,2518,1.1947747593069946,1418,Unchanged,10000,5
malG,644,1494,1.2140475546746203,850,Unchanged,10000,5
xylE,1738,4744,1.4486759277316035,3006,Unchanged,10000,5
psiE,269,421,0.6462140605097719,152,Unchanged,10000,5
yjbH,366,3374,3.2045444200035234,3008,Unchanged,10000,5
yjbG,73,1306,4.161114622666413,1233,Unchanged,10000,5
yjbF,90,934,3.3754256433799874,844,Unchanged,10000,5
yjbE,250,121,-1.0469210473874926,-129,Unchanged,10000,5
pgi,21407,9183,-1.2210451783558893,-12224,Downregulated,10000,5
lysC,6664,3490,-0.9331613642685329,-3174,Unchanged,10000,5
yjbD,238,190,-0.3249621549769956,-48,Unchanged,10000,5
rluF,494,1309,1.4058821503605632,815,Unchanged,10000,5
pepE,2509,1372,-0.8708319892363603,-1137,Unchanged,10000,5
yjbB,443,2954,2.737291222209771,2511,Unchanged,10000,5
metH,13700,9762,-0.4889272363415674,-3938,Unchanged,10000,5
iclR,1078,1486,0.4630769377860907,408,Unchanged,10000,5
arpA,24,1138,5.567322341585426,1114,Unchanged,10000,5
aceK,4932,4807,-0.03703599626494348,-125,Unchanged,10000,5
aceA,39373,30142,-0.38543149521528347,-9231,Unchanged,10000,5
aceB,48476,32756,-0.5655114666724081,-15720,Downregulated,10000,5
metA,6858,1375,-2.31835628563625,-5483,Unchanged,10000,5
yjaB,112,468,2.0630097975258006,356,Unchanged,10000,5
yjaA,13,288,4.46948528330122,275,Unchanged,10000,5
purH,11038,4174,-1.4029762850318608,-6864,Unchanged,10000,5
purD,6179,2666,-1.2126965930140288,-3513,Unchanged,10000,5
zraR,567,2598,2.1959807905056525,2031,Unchanged,10000,5
zraS,213,2435,3.5149964367438664,2222,Unchanged,10000,5
zraP,319,591,0.8896017064126631,272,Unchanged,10000,5
yjaH,570,1236,1.1166449188522707,666,Unchanged,10000,5
hupA,5686,487,-3.5454204215951854,-5199,Unchanged,10000,5
yjaG,1224,1253,0.033782856629208644,29,Unchanged,10000,5
nfi,1213,1625,0.42186016768266893,412,Unchanged,10000,5
hemE,3464,2625,-0.40012150728587764,-839,Unchanged,10000,5
nudC,1125,1230,0.12873331412220274,105,Unchanged,10000,5
rsd,379,476,0.32876372513685176,97,Unchanged,10000,5
thiC,591,3711,2.6505779655199935,3120,Unchanged,10000,5
thiE,139,918,2.7234092706903006,779,Unchanged,10000,5
thiF,187,906,2.276472780158598,719,Unchanged,10000,5
thiG,156,1144,2.8744691179161412,988,Unchanged,10000,5
thiH,228,1708,2.9052022454557487,1480,Unchanged,10000,5
yjaZ,84,404,2.2658940599730344,320,Unchanged,10000,5
rpoC,116263,31573,-1.880628786716989,-84690,Downregulated,10000,5
rpoB,100349,30032,-1.7404537796026385,-70317,Downregulated,10000,5
rplL,47998,10674,-2.1688733758491825,-37324,Downregulated,10000,5
rplJ,38001,8268,-2.2004270898396565,-29733,Downregulated,10000,5
rplA,44628,10175,-2.132920359292172,-34453,Downregulated,10000,5
rplK,16587,2793,-2.5701654987930755,-13794,Downregulated,10000,5
nusG,7247,1625,-2.156944176181562,-5622,Unchanged,10000,5
secE,4402,956,-2.203076621910809,-3446,Unchanged,10000,5
tufB,124091,9085,-3.771768159629583,-115006,Downregulated,10000,5
coaA,1280,570,-1.1671099858352583,-710,Unchanged,10000,5
birA,972,1054,0.11684664803143371,82,Unchanged,10000,5
murB,1710,1051,-0.7022336558110819,-659,Unchanged,10000,5
murI,1263,1275,0.01364260795866807,12,Unchanged,10000,5
btuB,5171,2278,-1.1826755577752772,-2893,Unchanged,10000,5
trmA,2850,1745,-0.7077348828424518,-1105,Unchanged,10000,5
yijD,1185,541,-1.1311865599588062,-644,Unchanged,10000,5
fabR,1822,1364,-0.41767931477787823,-458,Unchanged,10000,5
sthA,1523,3118,1.0337049862104926,1595,Unchanged,10000,5
oxyR,3882,2868,-0.436755094011759,-1014,Unchanged,10000,5
argH,2694,6244,1.2127206865156057,3550,Unchanged,10000,5
argB,873,2858,1.7109523574663763,1985,Unchanged,10000,5
argC,1060,4182,1.9801287971390178,3122,Unchanged,10000,5
argE,1712,2751,0.6842734379150636,1039,Unchanged,10000,5
ppc,57960,21570,-1.4260314183964753,-36390,Downregulated,10000,5
eptC,2362,2543,0.10652249729294909,181,Unchanged,10000,5
yijO,313,1320,2.0763033673131974,1007,Unchanged,10000,5
frwD,15,370,4.624490864907794,355,Unchanged,10000,5
pflC,71,1403,4.3045521741152175,1332,Unchanged,10000,5
pflD,215,3525,4.0352146925840575,3310,Unchanged,10000,5
frwB,15,292,4.282933963271499,277,Unchanged,10000,5
frwC,24,1926,6.3264294871223035,1902,Unchanged,10000,5
ptsA,64,5236,6.354249381945241,5172,Unchanged,10000,5
fsaB,58,1113,4.262256882214388,1055,Unchanged,10000,5
gldA,4373,3057,-0.5165067961942377,-1316,Unchanged,10000,5
yijF,41,1245,4.924378022337359,1204,Unchanged,10000,5
yijE,232,2071,3.15813084309294,1839,Unchanged,10000,5
katG,12988,8272,-0.6508711989711533,-4716,Unchanged,10000,5
metF,9695,1797,-2.431650489484213,-7898,Unchanged,10000,5
metL,6845,6356,-0.10693141679674281,-489,Unchanged,10000,5
metB,3035,2976,-0.028321990035013005,-59,Unchanged,10000,5
metJ,1479,629,-1.2334901302197785,-850,Unchanged,10000,5
yiiX,291,1184,2.024578022720666,893,Unchanged,10000,5
rpmE,2756,248,-3.474163862317416,-2508,Unchanged,10000,5
priA,1969,5388,1.4522867395607493,3419,Unchanged,10000,5
cytR,1719,2338,0.4437053850535952,619,Unchanged,10000,5
ftsN,3531,2793,-0.33826124747965053,-738,Unchanged,10000,5
hslV,1400,1369,-0.03230438057442922,-31,Unchanged,10000,5
hslU,6710,4604,-0.5434249329553156,-2106,Unchanged,10000,5
menA,336,1485,2.143929792909368,1149,Unchanged,10000,5
rraA,3976,1609,-1.30515343083884,-2367,Unchanged,10000,5
zapB,2193,353,-2.6351657234024133,-1840,Unchanged,10000,5
glpF,859,2218,1.3685293290232465,1359,Unchanged,10000,5
glpK,3569,5846,0.71192992775703,2277,Unchanged,10000,5
glpX,1094,1723,0.6553099634323917,629,Unchanged,10000,5
fpr,1073,1284,0.2589951263657812,211,Unchanged,10000,5
uspD,2255,405,-2.4771336203707564,-1850,Unchanged,10000,5
yiiS,752,232,-1.6966078565500653,-520,Unchanged,10000,5
yiiR,154,406,1.3985493764902748,252,Unchanged,10000,5
yiiQ,930,718,-0.3732468721723423,-212,Unchanged,10000,5
tpiA,23875,4031,-2.566291044846756,-19844,Downregulated,10000,5
cdh,263,737,1.4866018198027673,474,Unchanged,10000,5
sbp,188,1385,2.8810814092589134,1197,Unchanged,10000,5
pfkA,23466,6406,-1.873076238679418,-17060,Downregulated,10000,5
fieF,1262,1614,0.3549286682952314,352,Unchanged,10000,5
cpxR,3536,1738,-1.0246901925770315,-1798,Unchanged,10000,5
cpxA,5040,3645,-0.4675049191729794,-1395,Unchanged,10000,5
yiiM,550,882,0.6813470371454985,332,Unchanged,10000,5
kdgT,125,1308,3.3873625408359955,1183,Unchanged,10000,5
sodA,141,699,2.3095972929766426,558,Unchanged,10000,5
rhaT,82,1367,4.059245522987976,1285,Unchanged,10000,5
rhaR,66,853,3.6920078119598365,787,Unchanged,10000,5
rhaS,56,951,4.085946608802959,895,Unchanged,10000,5
rhaB,29,1677,5.853685978436774,1648,Unchanged,10000,5
rhaA,52,1817,5.1269029860930235,1765,Unchanged,10000,5
rhaD,20,1098,5.778734244117836,1078,Unchanged,10000,5
rhaM,6,192,5.0,186,Unchanged,10000,5
frvA,4,396,6.6293566200796095,392,Unchanged,10000,5
frvB,43,1811,5.39630607624807,1768,Unchanged,10000,5
frvX,155,1366,3.139617363015853,1211,Unchanged,10000,5
frvR,66,1954,4.887820632609932,1888,Unchanged,10000,5
yiiG,38,1003,4.7221783771685955,965,Unchanged,10000,5
fdhD,786,1084,0.4637635390952651,298,Unchanged,10000,5
fdoG,2541,8206,1.6912827788391802,5665,Unchanged,10000,5
fdoH,474,1652,1.8012547225211863,1178,Unchanged,10000,5
fdoI,222,822,1.888578717331577,600,Unchanged,10000,5
fdhE,1278,1682,0.3962898693081497,404,Unchanged,10000,5
yiiF,26,65,1.3219280948873624,39,Unchanged,10000,5
yiiE,2,97,5.599912842187128,95,Unchanged,10000,5
fabY,2113,1982,-0.09233580474845246,-131,Unchanged,10000,5
dtd,706,729,0.046250631055756906,23,Unchanged,10000,5
yihY,840,1367,0.7025520099399374,527,Unchanged,10000,5
yihX,974,1073,0.13965639867417973,99,Unchanged,10000,5
csqR,594,1412,1.2492052524704145,818,Unchanged,10000,5
yihV,218,1613,2.887346398378716,1395,Unchanged,10000,5
yihU,85,1370,4.010569241710187,1285,Unchanged,10000,5
yihT,130,1527,3.5541165337683966,1397,Unchanged,10000,5
yihS,193,1833,3.2475340332718052,1640,Unchanged,10000,5
yihR,26,1212,5.542734265331859,1186,Unchanged,10000,5
yihQ,73,2759,5.240105182473256,2686,Unchanged,10000,5
yihP,59,1762,4.900355159558573,1703,Unchanged,10000,5
yihO,49,1320,4.751612370130608,1271,Unchanged,10000,5
ompL,23,310,3.7525624492172245,287,Unchanged,10000,5
yihN,30,1034,5.107129874706416,1004,Unchanged,10000,5
yihM,202,784,1.9564983613634135,582,Unchanged,10000,5
yihL,123,686,2.479550260833572,563,Unchanged,10000,5
bipA,15404,6513,-1.241910896460685,-8891,Unchanged,10000,5
glnA,37650,4026,-3.2252307875253132,-33624,Downregulated,10000,5
glnL,2170,1207,-0.8462693665768202,-963,Unchanged,10000,5
glnG,2812,1939,-0.5362837909657429,-873,Unchanged,10000,5
hemN,3168,2152,-0.5578942575229855,-1016,Unchanged,10000,5
yihI,1747,591,-1.563649572739227,-1156,Unchanged,10000,5
yihA,1405,982,-0.5167752007935955,-423,Unchanged,10000,5
spf,1,1,0.0,0,Unchanged,10000,5
polA,6942,4346,-0.6756631906473631,-2596,Unchanged,10000,5
yihG,94,663,2.81827620843495,569,Unchanged,10000,5
yihF,73,909,3.6383119253140896,836,Unchanged,10000,5
dsbA,3208,1199,-1.4198424830406966,-2009,Unchanged,10000,5
srkA,1460,1400,-0.060541541935050854,-60,Unchanged,10000,5
yihD,1200,263,-2.1898997012035784,-937,Unchanged,10000,5
mobA,482,536,0.15319985422781088,54,Unchanged,10000,5
mobB,199,411,1.046369963138034,212,Unchanged,10000,5
hemG,824,961,0.22189209359053216,137,Unchanged,10000,5
trkH,2179,2871,0.39788713409127496,692,Unchanged,10000,5
yigZ,910,988,0.11864449649861893,78,Unchanged,10000,5
pepQ,7192,4804,-0.5821568698088132,-2388,Unchanged,10000,5
fadB,83,4238,5.674128441025245,4155,Unchanged,10000,5
fadA,113,1989,4.137648598418556,1876,Unchanged,10000,5
fre,2208,2326,0.07511092469504942,118,Unchanged,10000,5
ubiD,3612,3922,0.11879164271129077,310,Unchanged,10000,5
rfaH,413,538,0.38146439113717884,125,Unchanged,10000,5
tatC,2151,1476,-0.5433148033626648,-675,Unchanged,10000,5
tatB,2415,1601,-0.5930498812068785,-814,Unchanged,10000,5
tatA,1202,482,-1.318331844481224,-720,Unchanged,10000,5
ubiB,2176,2923,0.4257712725557133,747,Unchanged,10000,5
ubiJ,1465,1552,0.08322789287751733,87,Unchanged,10000,5
ubiE,2522,1969,-0.3571051644266662,-553,Unchanged,10000,5
rmuC,764,2777,1.8618826337830974,2013,Unchanged,10000,5
udp,4338,3195,-0.44121412183791714,-1143,Unchanged,10000,5
ysgA,990,1785,0.85042364394949,795,Unchanged,10000,5
metE,151815,8934,-4.086864277642487,-142881,Downregulated,10000,5
metR,1649,1797,0.12399901007247463,148,Unchanged,10000,5
bioP,168,1461,3.120423040024738,1293,Unchanged,10000,5
yigL,1041,1303,0.3238670152687173,262,Unchanged,10000,5
pldB,1659,1719,0.05125565852219775,60,Unchanged,10000,5
rhtB,317,927,1.5480864984861236,610,Unchanged,10000,5
rhtC,1200,1291,0.1054545948113099,91,Unchanged,10000,5
recQ,2236,4352,0.9607583684071493,2116,Unchanged,10000,5
pldA,1157,1401,0.2760680913233281,244,Unchanged,10000,5
yigI,35,564,4.010268335453827,529,Unchanged,10000,5
rarD,35,1308,5.223863808553117,1273,Unchanged,10000,5
yigG,19,41,1.1096244911744981,22,Unchanged,10000,5
yigF,51,39,-0.38702312310924736,-12,Unchanged,10000,5
corA,1730,1625,-0.09033231972090777,-105,Unchanged,10000,5
uvrD,4390,4846,0.1425734650286259,456,Unchanged,10000,5
yigB,1270,1401,0.14162845877128982,131,Unchanged,10000,5
xerC,1449,1497,0.04701662650148736,48,Unchanged,10000,5
yigA,1139,1302,0.19296170145752364,163,Unchanged,10000,5
dapF,2502,1799,-0.4758866029143375,-703,Unchanged,10000,5
cyaY,526,360,-0.5470658929626278,-166,Unchanged,10000,5
cyaA,19913,8497,-1.228685117159587,-11416,Downregulated,10000,5
hemC,4656,3040,-0.6150197345773359,-1616,Unchanged,10000,5
hemD,2000,1464,-0.4500844463780446,-536,Unchanged,10000,5
hemX,3758,2514,-0.5799804169995477,-1244,Unchanged,10000,5
hemY,3585,2489,-0.5264068886082314,-1096,Unchanged,10000,5
aslA,190,1831,3.268560467466389,1641,Unchanged,10000,5
aslB,67,1339,4.320851054866538,1272,Unchanged,10000,5
yifK,1189,1944,0.7092795038601252,755,Unchanged,10000,5
rffM,364,754,1.0506260730699681,390,Unchanged,10000,5
wzyE,423,1677,1.9871531204443966,1254,Unchanged,10000,5
wzxE,861,1705,0.9856865965146908,844,Unchanged,10000,5
wecE,1198,1202,0.004808987922399752,4,Unchanged,10000,5
rffC,535,801,0.5822633511202008,266,Unchanged,10000,5
rffH,1371,1245,-0.1390828288237825,-126,Unchanged,10000,5
rffG,1148,1197,0.06030051026781422,49,Unchanged,10000,5
wecC,1649,1850,0.1659338719662074,201,Unchanged,10000,5
wecB,1558,1501,-0.05377125644098082,-57,Unchanged,10000,5
wzzE,1756,1541,-0.1884259830205729,-215,Unchanged,10000,5
rfe,2529,1782,-0.5050697001413166,-747,Unchanged,10000,5
rho,16327,6259,-1.3832556462639225,-10068,Downregulated,10000,5
trxA,4974,1611,-1.6264500135103377,-3363,Unchanged,10000,5
rhlB,9617,4307,-1.1589035953510602,-5310,Unchanged,10000,5
gpp,4838,3572,-0.437678688858702,-1266,Unchanged,10000,5
rep,2378,3712,0.6424479953819163,1334,Unchanged,10000,5
yifN,148,317,1.0988856645104577,169,Unchanged,10000,5
ppiC,458,285,-0.68438567904484,-173,Unchanged,10000,5
ilvC,6527,7258,0.15315201751530103,731,Unchanged,10000,5
ilvY,298,1789,2.5857691515897465,1491,Unchanged,10000,5
ilvA,2139,6251,1.5471505200137825,4112,Unchanged,10000,5
ilvD,2843,7254,1.3513626462927524,4411,Unchanged,10000,5
ilvE,2849,3534,0.31084641822776565,685,Unchanged,10000,5
ilvM,57,152,1.4150374992788437,95,Unchanged,10000,5
ilvL,5,1,-2.321928094887362,-4,Unchanged,10000,5
yifB,119,1868,3.9724609764017185,1749,Unchanged,10000,5
maoP,2495,247,-3.336456868639945,-2248,Unchanged,10000,5
yieP,1498,800,-0.9049657186840264,-698,Unchanged,10000,5
hsrA,532,1203,1.177138491674887,671,Unchanged,10000,5
rbsR,261,826,1.6620919748495608,565,Unchanged,10000,5
rbsK,955,894,-0.09522590173979334,-61,Unchanged,10000,5
rbsB,965,1040,0.10798268087301181,75,Unchanged,10000,5
rbsC,372,847,1.1870593482241671,475,Unchanged,10000,5
rbsA,354,1341,1.9214879718214766,987,Unchanged,10000,5
rbsD,178,276,0.6327910258117713,98,Unchanged,10000,5
kup,1100,2089,0.9253089686550864,989,Unchanged,10000,5
ravA,3473,2132,-0.7039749726229158,-1341,Unchanged,10000,5
viaA,1679,1845,0.13601858601072842,166,Unchanged,10000,5
asnA,9999,1668,-2.583664529386741,-8331,Unchanged,10000,5
asnC,246,265,0.10733404411132155,19,Unchanged,10000,5
mioC,1426,709,-1.008116449204372,-717,Unchanged,10000,5
mnmG,5984,3809,-0.6516978873242968,-2175,Unchanged,10000,5
rsmG,492,515,0.0659141167313407,23,Unchanged,10000,5
atpI,2245,1032,-1.121272474205255,-1213,Unchanged,10000,5
atpB,9110,2765,-1.7201715735673437,-6345,Unchanged,10000,5
atpE,5496,1686,-1.7047774678760177,-3810,Unchanged,10000,5
atpF,13857,5874,-1.2381997812453418,-7983,Unchanged,10000,5
atpH,7853,2508,-1.6467065489612145,-5345,Unchanged,10000,5
atpA,51387,15621,-1.7179166167467441,-35766,Downregulated,10000,5
atpG,16560,4776,-1.7938279311218825,-11784,Downregulated,10000,5
atpD,33969,10488,-1.6954791572393584,-23481,Downregulated,10000,5
atpC,6559,1406,-2.2218792806442558,-5153,Unchanged,10000,5
glmU,7570,2271,-1.7369655941662063,-5299,Unchanged,10000,5
glmS,12007,3506,-1.7759778313677734,-8501,Unchanged,10000,5
pstS,1038,2492,1.2634976246661211,1454,Unchanged,10000,5
pstC,536,1468,1.4535470623854403,932,Unchanged,10000,5
pstA,473,1526,1.6898428734951354,1053,Unchanged,10000,5
pstB,650,1187,0.8688083117260899,537,Unchanged,10000,5
phoU,715,840,0.23244608600037084,125,Unchanged,10000,5
bglG,5,424,6.405992359675837,419,Unchanged,10000,5
bglF,59,1846,4.967543788283933,1787,Unchanged,10000,5
bglB,45,1355,4.9122240399115595,1310,Unchanged,10000,5
bglH,41,1037,4.660648174195142,996,Unchanged,10000,5
yieL,57,1066,4.225101708594434,1009,Unchanged,10000,5
yieK,52,704,3.758991900496205,652,Unchanged,10000,5
cbrC,123,406,1.7228214118459364,283,Unchanged,10000,5
cbrB,41,199,2.279072615925565,158,Unchanged,10000,5
yieH,349,562,0.6873430940112738,213,Unchanged,10000,5
adeP,3864,2057,-0.9095533003108393,-1807,Unchanged,10000,5
yieF,2244,796,-1.495232340065144,-1448,Unchanged,10000,5
yieE,1616,1097,-0.5588636723486019,-519,Unchanged,10000,5
yidZ,274,1110,2.0183118782769416,836,Unchanged,10000,5
mdtL,89,1617,4.183370532507264,1528,Unchanged,10000,5
tnaB,83,1333,4.005421633742048,1250,Unchanged,10000,5
tnaA,470,1770,1.9130166984053603,1300,Unchanged,10000,5
tnaC,1,1,0.0,0,Unchanged,10000,5
mnmE,1854,3190,0.7829151800267009,1336,Unchanged,10000,5
yidC,10512,5470,-0.9424244426424108,-5042,Unchanged,10000,5
rnpA,2093,1162,-0.8489622428511804,-931,Unchanged,10000,5
rpmH,189,26,-2.8618027060799807,-163,Unchanged,10000,5
dnaA,5764,6098,0.08126581483500073,334,Unchanged,10000,5
dnaN,3270,3696,0.17667412103061272,426,Unchanged,10000,5
recF,909,2547,1.4864467600800875,1638,Unchanged,10000,5
gyrB,7976,8286,0.05501041058101118,310,Unchanged,10000,5
yidB,364,505,0.4723449374404608,141,Unchanged,10000,5
yidA,1879,1853,-0.020102185392789726,-26,Unchanged,10000,5
yidX,161,616,1.9358696625802845,455,Unchanged,10000,5
dgoK,141,1492,3.4034804678564443,1351,Unchanged,10000,5
dgoT,128,2796,4.449148645375437,2668,Unchanged,10000,5
cbrA,60,1845,4.94251450533924,1785,Unchanged,10000,5
yidR,743,2342,1.656306959962619,1599,Unchanged,10000,5
yidQ,507,566,0.15881630582854173,59,Unchanged,10000,5
ibpA,1901,1915,0.010585860163767334,14,Unchanged,10000,5
ibpB,1602,1879,0.2300909190113455,277,Unchanged,10000,5
yidE,1562,3542,1.181169758609935,1980,Unchanged,10000,5
yidP,33,1110,5.0719498418790145,1077,Unchanged,10000,5
glvC,49,3064,5.966490737809749,3015,Unchanged,10000,5
yidL,84,792,3.237039197300849,708,Unchanged,10000,5
yidK,33,3442,6.70463726268175,3409,Unchanged,10000,5
yidJ,85,2930,5.1072940131719085,2845,Unchanged,10000,5
yidI,157,881,2.4883774600287865,724,Unchanged,10000,5
yidH,104,569,2.4518451241654895,465,Unchanged,10000,5
yidG,69,634,3.199814573361238,565,Unchanged,10000,5
yidF,118,977,3.049571702606544,859,Unchanged,10000,5
emrD,362,2620,2.8555052093416076,2258,Unchanged,10000,5
ivbL,2,1,-1.0,-1,Unchanged,10000,5
ilvB,2579,4890,0.923022692050382,2311,Unchanged,10000,5
ilvN,261,440,0.7534537169547751,179,Unchanged,10000,5
uhpA,1530,1855,0.2778875339281514,325,Unchanged,10000,5
uhpB,725,3971,2.4534494606221715,3246,Unchanged,10000,5
uhpC,293,2916,3.3150181499046893,2623,Unchanged,10000,5
uhpT,121,2792,4.528219988935057,2671,Unchanged,10000,5
adeD,284,3768,3.729836130108101,3484,Unchanged,10000,5
adeQ,29,2189,6.238075244053374,2160,Unchanged,10000,5
yicN,133,757,2.508867054484542,624,Unchanged,10000,5
nepI,74,2570,5.1180992784522905,2496,Unchanged,10000,5
nlpA,741,1189,0.682203267439822,448,Unchanged,10000,5
yicL,776,1500,0.9508339431961156,724,Unchanged,10000,5
setC,33,1329,5.3317312699177215,1296,Unchanged,10000,5
yicJ,417,2121,2.3466253320858916,1704,Unchanged,10000,5
yicI,1128,3650,1.6941293962559485,2522,Unchanged,10000,5
yicH,2902,3471,0.25830384576190163,569,Unchanged,10000,5
xanP,2237,4150,0.8915460800625307,1913,Unchanged,10000,5
gltS,1632,2468,0.5967013371779223,836,Unchanged,10000,5
recG,2589,3699,0.514740335223884,1110,Unchanged,10000,5
trmH,1288,1093,-0.23683919244271237,-195,Unchanged,10000,5
spoT,8066,4697,-0.7801138121480885,-3369,Unchanged,10000,5
rpoZ,1832,499,-1.8763077827596835,-1333,Unchanged,10000,5
gmk,1941,875,-1.1494451959939727,-1066,Unchanged,10000,5
ligB,164,2345,3.837820202784655,2181,Unchanged,10000,5
yicG,59,579,3.294776488627395,520,Unchanged,10000,5
dinD,187,612,1.7104933828050153,425,Unchanged,10000,5
yicC,2695,1634,-0.7218772894941843,-1061,Unchanged,10000,5
rph,1482,1167,-0.3447408865984856,-315,Unchanged,10000,5
pyrE,218,712,1.7075491061894714,494,Unchanged,10000,5
slmA,1552,783,-0.9870443448960871,-769,Unchanged,10000,5
dut,2074,802,-1.3707417523583054,-1272,Unchanged,10000,5
dfp,1410,2259,0.6799891081069284,849,Unchanged,10000,5
yicR,125,535,2.097610796626422,410,Unchanged,10000,5
rpmB,4413,578,-2.9326183494753075,-3835,Unchanged,10000,5
rpmG,394,33,-3.5776577000979226,-361,Unchanged,10000,5
mutM,346,964,1.4782611085932371,618,Unchanged,10000,5
coaD,486,455,-0.09508976851972227,-31,Unchanged,10000,5
waaA,1954,1881,-0.0549306184451902,-73,Unchanged,10000,5
waaQ,1321,1036,-0.3506064635602737,-285,Unchanged,10000,5
waaG,1122,1171,0.06166839989242229,49,Unchanged,10000,5
waaP,522,600,0.2009126939259963,78,Unchanged,10000,5
waaS,596,124,-2.2649722100752863,-472,Unchanged,10000,5
waaB,819,655,-0.3223685452161959,-164,Unchanged,10000,5
waaO,758,478,-0.6651872301903431,-280,Unchanged,10000,5
waaJ,573,241,-1.2495019925269433,-332,Unchanged,10000,5
waaY,324,199,-0.703225382340976,-125,Unchanged,10000,5
waaZ,462,191,-1.2743202133803089,-271,Unchanged,10000,5
waaU,601,230,-1.3857311297668102,-371,Unchanged,10000,5
waaL,965,267,-1.8536892004678887,-698,Unchanged,10000,5
waaC,1000,1429,0.5150059164337295,429,Unchanged,10000,5
waaF,2318,1918,-0.273277845988341,-400,Unchanged,10000,5
rfaD,5066,2415,-1.0688238879893655,-2651,Unchanged,10000,5
htrL,436,534,0.29251160691062766,98,Unchanged,10000,5
kbl,2767,2368,-0.2246535629810049,-399,Unchanged,10000,5
tdh,2485,1837,-0.43589422533829897,-648,Unchanged,10000,5
waaH,48,1252,4.705056346211462,1204,Unchanged,10000,5
yibQ,874,1777,1.02373849652808,903,Unchanged,10000,5
envC,2596,2798,0.10810557916561489,202,Unchanged,10000,5
gpmM,25148,9653,-1.3813943842068739,-15495,Downregulated,10000,5
yibN,1884,721,-1.3857278003719606,-1163,Unchanged,10000,5
grxC,501,377,-0.4102460799265441,-124,Unchanged,10000,5
secB,4683,1272,-1.8803343674147095,-3411,Unchanged,10000,5
gpsA,6796,3582,-0.9239205151982594,-3214,Unchanged,10000,5
cysE,2197,2354,0.09957945061516768,157,Unchanged,10000,5
trmL,404,793,0.9729655729521837,389,Unchanged,10000,5
lldD,149,2275,3.9324823095112595,2126,Unchanged,10000,5
lldR,36,1328,5.205114429904612,1292,Unchanged,10000,5
lldP,71,2903,5.35358173712198,2832,Unchanged,10000,5
yibL,587,565,-0.05510963580750217,-22,Unchanged,10000,5
mtlR,485,1057,1.123918724308193,572,Unchanged,10000,5
mtlD,2605,3431,0.39734575339178413,826,Unchanged,10000,5
mtlA,2167,4386,1.0172066585799198,2219,Unchanged,10000,5
yibI,10,368,5.20163386116965,358,Unchanged,10000,5
yibH,98,2041,4.380350622917511,1943,Unchanged,10000,5
yibG,16,49,1.6147098441152081,33,Unchanged,10000,5
yibJ,130,1063,3.03155806850265,933,Unchanged,10000,5
yibA,450,424,-0.08586073665383794,-26,Unchanged,10000,5
rhsA,366,10019,4.774751061072336,9653,Unchanged,10000,5
yibF,208,1199,2.5271762252731316,991,Unchanged,10000,5
selA,1966,3509,0.835796626061586,1543,Unchanged,10000,5
selB,3610,4915,0.4451925794534096,1305,Unchanged,10000,5
yiaY,28,1916,6.096526923678576,1888,Unchanged,10000,5
aldB,438,3256,2.8940979246650738,2818,Unchanged,10000,5
yiaW,9,268,4.89616418901546,259,Unchanged,10000,5
yiaV,35,2012,5.845131572860561,1977,Unchanged,10000,5
yiaU,248,1570,2.6623525333921143,1322,Unchanged,10000,5
yiaT,41,1021,4.638215146259718,980,Unchanged,10000,5
sgbE,76,1240,4.028196891830652,1164,Unchanged,10000,5
sgbU,34,1839,5.7572429231615985,1805,Unchanged,10000,5
sgbH,30,1274,5.408258966647782,1244,Unchanged,10000,5
lyxK,57,3738,6.035160839580416,3681,Unchanged,10000,5
yiaO,19,1897,6.64157644996789,1878,Unchanged,10000,5
yiaN,5,1823,8.510170751151772,1818,Unchanged,10000,5
yiaM,4,369,6.527477006060396,365,Unchanged,10000,5
yiaL,4,501,6.968666793195208,497,Unchanged,10000,5
yiaK,31,1747,5.816467582529884,1716,Unchanged,10000,5
plaR,1332,1498,0.1694435413874888,166,Unchanged,10000,5
ysaA,128,592,2.2094533656289497,464,Unchanged,10000,5
avtA,4799,3973,-0.27250501962809504,-826,Unchanged,10000,5
malS,638,3422,2.423211430724544,2784,Unchanged,10000,5
bax,3282,3500,0.09277968320597837,218,Unchanged,10000,5
xylR,869,1948,1.1645655952679421,1079,Unchanged,10000,5
xylH,947,2923,1.6260134983376677,1976,Unchanged,10000,5
xylG,1210,3135,1.3734583955274444,1925,Unchanged,10000,5
xylF,2117,3345,0.659984941521234,1228,Unchanged,10000,5
xylA,13390,26193,0.9680253467260126,12803,Upregulated,10000,5
xylB,2209,6519,1.5612572565471643,4310,Unchanged,10000,5
yiaB,29,203,2.807354922057604,174,Unchanged,10000,5
yiaA,38,225,2.5658536777734517,187,Unchanged,10000,5
wecH,152,1242,3.0305219447768956,1090,Unchanged,10000,5
glyQ,3658,2820,-0.37535991246256056,-838,Unchanged,10000,5
glyS,11607,7367,-0.6558459868776659,-4240,Unchanged,10000,5
insK,34,542,3.994686200103532,508,Unchanged,10000,5
insJ,54,442,3.033015057227963,388,Unchanged,10000,5
cspA,215,104,-1.0477531314483681,-111,Unchanged,10000,5
yiaG,504,202,-1.3190684407481217,-302,Unchanged,10000,5
yiaF,4325,1494,-1.5335199846222123,-2831,Unchanged,10000,5
ghrB,4650,2724,-0.7715040128706849,-1926,Unchanged,10000,5
yiaD,712,957,0.4266416835196278,245,Unchanged,10000,5
bisC,2467,4695,0.9283674422410138,2228,Unchanged,10000,5
yiaC,184,610,1.7291034763932356,426,Unchanged,10000,5
tag,423,891,1.074767768401972,468,Unchanged,10000,5
yhjY,306,945,1.6267826764157833,639,Unchanged,10000,5
yhjX,239,2161,3.1766165488787586,1922,Unchanged,10000,5
eptB,570,3013,2.4021668485423593,2443,Unchanged,10000,5
dppA,43323,15745,-1.4602393916424727,-27578,Downregulated,10000,5
dppB,4233,3361,-0.33278994601041856,-872,Unchanged,10000,5
dppC,3717,2966,-0.32562009040712725,-751,Unchanged,10000,5
dppD,4792,3524,-0.44341398386837216,-1268,Unchanged,10000,5
dppF,5587,3683,-0.6011924230542905,-1904,Unchanged,10000,5
yhjV,149,2135,3.8408518340456914,1986,Unchanged,10000,5
bcsG,551,3352,2.604897925128194,2801,Unchanged,10000,5
bcsF,22,87,1.983511877211431,65,Unchanged,10000,5
bcsE,1412,3250,1.2026996295319987,1838,Unchanged,10000,5
yhjR,8,50,2.643856189774725,42,Unchanged,10000,5
bcsQ,98,1274,3.700439718141092,1176,Unchanged,10000,5
bcsA,220,6265,4.831739080684563,6045,Unchanged,10000,5
bcsB,286,5746,4.328470940754134,5460,Unchanged,10000,5
bcsZ,122,2522,4.369615222765334,2400,Unchanged,10000,5
bcsC,901,9157,3.3452760114038442,8256,Unchanged,10000,5
pdeK,1176,4903,2.0597767014493207,3727,Unchanged,10000,5
dctA,854,3817,2.1601312115950675,2963,Unchanged,10000,5
yhjJ,1582,3047,0.9456399002136937,1465,Unchanged,10000,5
kdgK,2716,2589,-0.06908851434462052,-127,Unchanged,10000,5
pdeH,154,1466,3.2508828474389104,1312,Unchanged,10000,5
yhjG,561,4057,2.85434062659748,3496,Unchanged,10000,5
yhjE,679,3384,2.3172460888752178,2705,Unchanged,10000,5
yhjD,1063,1813,0.7702373282130534,750,Unchanged,10000,5
rcdB,615,1504,1.2901462514510351,889,Unchanged,10000,5
yhjB,72,636,3.142957953842043,564,Unchanged,10000,5
treF,1655,3234,0.9664884617790815,1579,Unchanged,10000,5
ccp,626,2106,1.7502708740930986,1480,Unchanged,10000,5
gadA,84374,2314,-5.188337728783573,-82060,Downregulated,10000,5
gadX,7380,635,-3.5387923192882305,-6745,Unchanged,10000,5
gadW,1920,597,-1.6853034743437136,-1323,Unchanged,10000,5
mdtF,23634,5264,-2.1666324285999576,-18370,Downregulated,10000,5
mdtE,10863,1846,-2.5569481245515595,-9017,Unchanged,10000,5
gadE,8655,52,-7.378878386112909,-8603,Unchanged,10000,5
hdeD,19860,681,-4.866067014403665,-19179,Downregulated,10000,5
hdeA,47430,300,-7.304693557471008,-47130,Downregulated,10000,5
hdeB,21226,176,-6.914113284587107,-21050,Downregulated,10000,5
yhiD,1758,442,-1.9918167957519726,-1316,Unchanged,10000,5
dctR,778,294,-1.4039540001498274,-484,Unchanged,10000,5
slp,18758,480,-5.288327798153594,-18278,Downregulated,10000,5
insH11,2861,6302,1.1392902566943568,3441,Unchanged,10000,5
yhiS,30,1163,5.276744785864699,1133,Unchanged,10000,5
arsC,73,546,2.9029325820398353,473,Unchanged,10000,5
arsB,114,2219,4.28280393803227,2105,Unchanged,10000,5
arsR,52,495,3.25084499682588,443,Unchanged,10000,5
gor,3774,2762,-0.4503811033423945,-1012,Unchanged,10000,5
rlmJ,707,1402,0.9877042292012244,695,Unchanged,10000,5
prlC,5483,5545,0.01622198675227321,62,Unchanged,10000,5
rsmJ,413,1425,1.786748232520021,1012,Unchanged,10000,5
dtpB,380,2238,2.5581387126454462,1858,Unchanged,10000,5
uspA,13688,2505,-2.4500291564068424,-11183,Downregulated,10000,5
uspB,357,352,-0.020348645391802367,-5,Unchanged,10000,5
pitA,5346,3507,-0.6082224069902658,-1839,Unchanged,10000,5
yhiN,643,2561,1.993816610269521,1918,Unchanged,10000,5
yhiM,3659,1478,-1.3078031461929363,-2181,Unchanged,10000,5
yhiJ,177,922,2.3810173903463405,745,Unchanged,10000,5
yhiI,3338,4509,0.433823555274922,1171,Unchanged,10000,5
rbbA,5282,9113,0.7868417659846224,3831,Unchanged,10000,5
yhhJ,1056,3283,1.6364049152145272,2227,Unchanged,10000,5
yhhI,45,1287,4.837943241891027,1242,Unchanged,10000,5
yhhH,12,43,1.8413022539809418,31,Unchanged,10000,5
rhsB,323,9201,4.832184597294251,8878,Unchanged,10000,5
nikR,249,865,1.7965543904560062,616,Unchanged,10000,5
nikE,172,2038,3.566673581463716,1866,Unchanged,10000,5
nikD,159,1933,3.6037429669268803,1774,Unchanged,10000,5
nikC,118,2243,4.248570855724431,2125,Unchanged,10000,5
nikB,152,2281,3.907523217868552,2129,Unchanged,10000,5
nikA,585,4397,2.9100110027418804,3812,Unchanged,10000,5
acpT,303,1152,1.9267510179693614,849,Unchanged,10000,5
yhhT,245,2363,3.269765974971276,2118,Unchanged,10000,5
yhhS,753,3765,2.321928094887362,3012,Unchanged,10000,5
dcrB,2236,1765,-0.3412520046846474,-471,Unchanged,10000,5
yhhQ,321,1525,2.248164040215308,1204,Unchanged,10000,5
tusA,421,386,-0.12521938579831574,-35,Unchanged,10000,5
zntA,3321,8642,1.3797475080870254,5321,Unchanged,10000,5
yhhN,1888,1916,0.021238796374339088,28,Unchanged,10000,5
yhhM,339,570,0.7496766459157601,231,Unchanged,10000,5
yhhL,50,302,2.594548549550354,252,Unchanged,10000,5
rsmD,412,1156,1.4884251553174606,744,Unchanged,10000,5
ftsY,2698,5500,1.0275412703511169,2802,Unchanged,10000,5
ftsE,1354,2543,0.9093037231151095,1189,Unchanged,10000,5
ftsX,2279,3607,0.6623984985222731,1328,Unchanged,10000,5
rpoH,8677,7277,-0.2538525184568444,-1400,Unchanged,10000,5
livJ,931,5040,2.436570660828485,4109,Unchanged,10000,5
panZ,261,666,1.3514723705013778,405,Unchanged,10000,5
livK,1281,3323,1.375215817350385,2042,Unchanged,10000,5
livH,460,2082,2.178264302355042,1622,Unchanged,10000,5
livM,750,3537,2.2375637183176758,2787,Unchanged,10000,5
livG,384,1971,2.3597495603223297,1587,Unchanged,10000,5
livF,367,1917,2.3849983688249377,1550,Unchanged,10000,5
ugpB,66,3358,5.668992395578576,3292,Unchanged,10000,5
ugpA,14,1800,7.006426269159433,1786,Unchanged,10000,5
ugpE,16,1914,6.902375114486025,1898,Unchanged,10000,5
ugpC,224,3157,3.816983623255381,2933,Unchanged,10000,5
ugpQ,405,1696,2.0661423567912123,1291,Unchanged,10000,5
yhhA,691,681,-0.02103091237618736,-10,Unchanged,10000,5
ggt,726,4134,2.5094969354296968,3408,Unchanged,10000,5
yrhB,29,196,2.756728848987636,167,Unchanged,10000,5
insB6,27,582,4.429987840744816,555,Unchanged,10000,5
insA6,19,138,2.8605969433345835,119,Unchanged,10000,5
yrhA,64,1403,4.454299293619899,1339,Unchanged,10000,5
yhhZ,7,378,5.754887502163468,371,Unchanged,10000,5
yhhY,429,721,0.7490216117412769,292,Unchanged,10000,5
yhhX,2696,2337,-0.20616276239903314,-359,Unchanged,10000,5
yhhW,680,1364,1.0042369928864707,684,Unchanged,10000,5
gntR,1344,2156,0.6818240399737453,812,Unchanged,10000,5
gntK,215,998,2.2147031557478,783,Unchanged,10000,5
yhgN,306,1086,1.8274205451117096,780,Unchanged,10000,5
asd,23151,4703,-2.299421274271237,-18448,Downregulated,10000,5
glgB,28851,8488,-1.7651247633993101,-20363,Downregulated,10000,5
glgX,13428,6106,-1.13694494749077,-7322,Unchanged,10000,5
glgC,8727,4002,-1.1247646299157215,-4725,Unchanged,10000,5
glgA,10568,4664,-1.1800626780463312,-5904,Unchanged,10000,5
glgP,16457,6670,-1.3029426996386781,-9787,Unchanged,10000,5
yzgL,47,115,1.2909011992667379,68,Unchanged,10000,5
glpD,30707,17890,-0.7794141839751701,-12817,Downregulated,10000,5
glpE,324,612,0.9175378398080271,288,Unchanged,10000,5
glpG,1232,2371,0.9444934067871066,1139,Unchanged,10000,5
glpR,657,2284,1.7975973750405132,1627,Unchanged,10000,5
rtcR,143,4617,5.0128686802709765,4474,Unchanged,10000,5
rtcB,370,3291,3.152928850608037,2921,Unchanged,10000,5
malT,10083,14588,0.5328571563069545,4505,Unchanged,10000,5
malP,5521,6437,0.22145886771777157,916,Unchanged,10000,5
malQ,4684,5326,0.18531135270939908,642,Unchanged,10000,5
gntT,1015,3421,1.7529383766953612,2406,Unchanged,10000,5
nfuA,2759,1924,-0.520036657583231,-835,Unchanged,10000,5
yhgH,629,1596,1.3433287293430567,967,Unchanged,10000,5
bioH,668,1764,1.4009305530834684,1096,Unchanged,10000,5
rpnA,177,1433,3.0172173441791483,1256,Unchanged,10000,5
feoC,56,215,1.9408379275318561,159,Unchanged,10000,5
feoB,2414,5919,1.2939277806896936,3505,Unchanged,10000,5
feoA,72,142,0.9798221180623697,70,Unchanged,10000,5
yhgF,6540,7440,0.18601198560994894,900,Unchanged,10000,5
greB,449,909,1.01756484945296,460,Unchanged,10000,5
ompR,1923,2016,0.06813687616001932,93,Unchanged,10000,5
envZ,1475,3630,1.299254593746547,2155,Unchanged,10000,5
pck,8165,6843,-0.25482393841576373,-1322,Unchanged,10000,5
yhgE,711,2977,2.065937756618621,2266,Unchanged,10000,5
hslO,1596,2535,0.667525095668357,939,Unchanged,10000,5
hslR,435,945,1.1192989283723445,510,Unchanged,10000,5
yrfG,707,1153,0.705610392842373,446,Unchanged,10000,5
igaA,1772,5675,1.6792417885106214,3903,Unchanged,10000,5
nudE,580,1060,0.8699394594356271,480,Unchanged,10000,5
mrcA,1704,6041,1.8258620510107209,4337,Unchanged,10000,5
hofM,105,1517,3.852759852580911,1412,Unchanged,10000,5
hofN,39,875,4.487736987857443,836,Unchanged,10000,5
hofO,34,698,4.359620384959313,664,Unchanged,10000,5
hofP,36,553,3.9412106687923947,517,Unchanged,10000,5
hofQ,161,2253,3.806714720120811,2092,Unchanged,10000,5
aroK,3467,1619,-1.0985848509002676,-1848,Unchanged,10000,5
aroB,5938,3294,-0.8501365382603008,-2644,Unchanged,10000,5
damX,6548,4044,-0.6952713245711387,-2504,Unchanged,10000,5
dam,905,1159,0.3568908690359041,254,Unchanged,10000,5
rpe,2973,1410,-1.0762243006214884,-1563,Unchanged,10000,5
gph,2327,1466,-0.6665861072715368,-861,Unchanged,10000,5
trpS,5478,2391,-1.1960351359937502,-3087,Unchanged,10000,5
yhfZ,213,1677,2.976957353338508,1464,Unchanged,10000,5
yhfY,42,335,2.9956998625663744,293,Unchanged,10000,5
yhfX,59,2288,5.277228287416548,2229,Unchanged,10000,5
yhfW,50,2553,5.674121632632394,2503,Unchanged,10000,5
php,52,1707,5.036807624886646,1655,Unchanged,10000,5
yhfU,23,377,4.034858757211651,354,Unchanged,10000,5
yhfT,140,3035,4.438197784198078,2895,Unchanged,10000,5
yhfS,110,2446,4.474848975002727,2336,Unchanged,10000,5
frlR,517,1397,1.4340958350945283,880,Unchanged,10000,5
frlD,136,1943,3.8366073443350053,1807,Unchanged,10000,5
frlB,61,1723,4.819969648662062,1662,Unchanged,10000,5
frlA,19,2478,7.027032958697016,2459,Unchanged,10000,5
yhfL,5,10,1.0,5,Unchanged,10000,5
cysG,1554,2510,0.6917008604304243,956,Unchanged,10000,5
nirC,657,1034,0.6542709099926051,377,Unchanged,10000,5
nirD,656,394,-0.7355001851617075,-262,Unchanged,10000,5
nirB,10239,5867,-0.8033799231486566,-4372,Unchanged,10000,5
tsgA,224,1621,2.8553134534599374,1397,Unchanged,10000,5
ppiA,1448,1023,-0.5012554573378766,-425,Unchanged,10000,5
yhfG,38,34,-0.1604646721932461,-4,Unchanged,10000,5
fic,842,660,-0.3513542088205804,-182,Unchanged,10000,5
pabA,146,719,2.300023401559281,573,Unchanged,10000,5
argD,1848,6525,1.8200131449285517,4677,Unchanged,10000,5
yhfK,1403,2709,0.9492453845821154,1306,Unchanged,10000,5
crp,6168,1746,-1.8207492062855943,-4422,Unchanged,10000,5
yhfA,1356,527,-1.3634823114991292,-829,Unchanged,10000,5
prkB,1319,1280,-0.043300754364182376,-39,Unchanged,10000,5
yheU,93,68,-0.45169596985769195,-25,Unchanged,10000,5
yheT,1403,1497,0.0935592124385177,94,Unchanged,10000,5
yheS,3561,3585,0.009690683226204215,24,Unchanged,10000,5
kefG,71,510,2.844606317354176,439,Unchanged,10000,5
kefB,229,2317,3.338838540767878,2088,Unchanged,10000,5
slyD,10267,2496,-2.040324850873917,-7771,Unchanged,10000,5
slyX,499,96,-2.3779335046161045,-403,Unchanged,10000,5
fkpA,5129,1554,-1.7226910675696074,-3575,Unchanged,10000,5
yheO,2832,1316,-1.1056617763477559,-1516,Unchanged,10000,5
tusD,1063,721,-0.5600704322902822,-342,Unchanged,10000,5
tusC,439,369,-0.250600123474962,-70,Unchanged,10000,5
tusB,318,223,-0.5119830553640508,-95,Unchanged,10000,5
rpsL,12880,2267,-2.5062762972611936,-10613,Downregulated,10000,5
rpsG,40203,8973,-2.16364084490506,-31230,Downregulated,10000,5
fusA,259693,76012,-1.772508027192603,-183681,Downregulated,10000,5
tufA,160805,46439,-1.79190345454288,-114366,Downregulated,10000,5
chiA,831,2716,1.7085630974743873,1885,Unchanged,10000,5
bfd,22,34,0.6280312226130421,12,Unchanged,10000,5
bfr,3471,318,-3.4482526945442906,-3153,Unchanged,10000,5
gspO,53,459,3.1144298888506086,406,Unchanged,10000,5
gspM,31,274,3.1438357725736514,243,Unchanged,10000,5
gspL,78,964,3.6274871173677132,886,Unchanged,10000,5
gspK,37,703,4.247927513443585,666,Unchanged,10000,5
gspJ,16,389,4.603626344986192,373,Unchanged,10000,5
gspI,9,213,4.564784618783526,204,Unchanged,10000,5
gspH,16,345,4.430452551665532,329,Unchanged,10000,5
gspG,8,222,4.794415866350106,214,Unchanged,10000,5
gspF,51,1045,4.356861884996749,994,Unchanged,10000,5
gspE,44,1138,4.692853223669284,1094,Unchanged,10000,5
gspD,161,1577,3.2920500666758934,1416,Unchanged,10000,5
gspC,25,343,3.7782085763980877,318,Unchanged,10000,5
gspA,50,1087,4.442280035252584,1037,Unchanged,10000,5
gspB,54,179,1.728928275100788,125,Unchanged,10000,5
rpsJ,10057,3779,-1.4121235901216238,-6278,Unchanged,10000,5
rplC,42078,15345,-1.455297488040335,-26733,Downregulated,10000,5
rplD,31887,10386,-1.618328241472831,-21501,Downregulated,10000,5
rplW,8356,3575,-1.224869250513994,-4781,Unchanged,10000,5
rplB,39272,12341,-1.6700417699882626,-26931,Downregulated,10000,5
rpsS,11292,3428,-1.7198620193371932,-7864,Unchanged,10000,5
rplV,5558,1516,-1.8742960810294704,-4042,Unchanged,10000,5
rpsC,44308,14383,-1.6232025832147647,-29925,Downregulated,10000,5
rplP,22826,6892,-1.7276834589420342,-15934,Downregulated,10000,5
rpmC,3854,1490,-1.3710442409461971,-2364,Unchanged,10000,5
rpsQ,9771,1997,-2.2906718876730867,-7774,Unchanged,10000,5
rplN,31865,7634,-2.061461569083948,-24231,Downregulated,10000,5
rplX,12642,2961,-2.0940683243609084,-9681,Unchanged,10000,5
rplE,55153,19803,-1.4777203582025369,-35350,Downregulated,10000,5
rpsN,16351,6471,-1.337318288921691,-9880,Unchanged,10000,5
rpsH,20946,9110,-1.2011518035844966,-11836,Downregulated,10000,5
rplF,39469,15343,-1.3631393680768504,-24126,Downregulated,10000,5
rplR,16562,6565,-1.3350099846171433,-9997,Unchanged,10000,5
rpsE,31390,10710,-1.5513465488318592,-20680,Downregulated,10000,5
rpmD,1969,803,-1.2939912183842393,-1166,Unchanged,10000,5
rplO,38072,15326,-1.3127491487962615,-22746,Downregulated,10000,5
secY,81723,25549,-1.677475340973498,-56174,Downregulated,10000,5
rpmJ,14,8,-0.8073549220576042,-6,Unchanged,10000,5
rpsM,22470,6025,-1.8989669780625833,-16445,Downregulated,10000,5
rpsK,20635,6328,-1.705271933421605,-14307,Downregulated,10000,5
rpsD,39080,11165,-1.8074472161459116,-27915,Downregulated,10000,5
rpoA,81897,23791,-1.783394691518744,-58106,Downregulated,10000,5
rplQ,10483,1884,-2.476180772934456,-8599,Unchanged,10000,5
yhdN,514,336,-0.6133071264151178,-178,Unchanged,10000,5
zntR,422,374,-0.1742047288195484,-48,Unchanged,10000,5
mscL,1527,334,-2.192780054322799,-1193,Unchanged,10000,5
trkA,1754,1350,-0.3776893405065398,-404,Unchanged,10000,5
rsmB,1846,1650,-0.16193652851259613,-196,Unchanged,10000,5
fmt,2838,1732,-0.7124356593338266,-1106,Unchanged,10000,5
def,1586,634,-1.322838025564571,-952,Unchanged,10000,5
smg,2402,915,-1.3923925025342294,-1487,Unchanged,10000,5
yrdD,1185,647,-0.8730494417931141,-538,Unchanged,10000,5
tsaC,588,550,-0.09638453642434239,-38,Unchanged,10000,5
aroE,882,771,-0.19404779564248634,-111,Unchanged,10000,5
yrdB,113,102,-0.1477536204436922,-11,Unchanged,10000,5
yrdA,1919,639,-1.586466875248386,-1280,Unchanged,10000,5
yhdZ,82,517,2.6564684656968507,435,Unchanged,10000,5
yhdY,42,886,4.398845465776258,844,Unchanged,10000,5
yhdX,40,807,4.334496768390418,767,Unchanged,10000,5
yhdW,87,801,3.202714936559982,714,Unchanged,10000,5
yhdV,77,61,-0.33604920313201503,-16,Unchanged,10000,5
acrF,280,3050,3.4453105103926442,2770,Unchanged,10000,5
acrE,8,1076,7.071462362556624,1068,Unchanged,10000,5
envR,6,359,5.902877533101895,353,Unchanged,10000,5
yhdU,6,13,1.1154772174199359,7,Unchanged,10000,5
yhdJ,87,856,3.2985234905524186,769,Unchanged,10000,5
fis,2042,284,-2.8460200313731194,-1758,Unchanged,10000,5
dusB,5968,1842,-1.6959744741639022,-4126,Unchanged,10000,5
prmA,614,1175,0.9363501960821826,561,Unchanged,10000,5
panF,300,1753,2.5467915902636573,1453,Unchanged,10000,5
yhdT,35,112,1.6780719051126378,77,Unchanged,10000,5
accC,15629,4037,-1.9528699805079672,-11592,Downregulated,10000,5
accB,4322,1068,-2.0167874251719535,-3254,Unchanged,10000,5
yhdH,1520,1361,-0.1594042568269532,-159,Unchanged,10000,5
csrD,2543,2901,0.19001883350789106,358,Unchanged,10000,5
mreB,10632,4009,-1.4070986871254039,-6623,Unchanged,10000,5
mreC,2373,1876,-0.33905227267857135,-497,Unchanged,10000,5
mreD,621,560,-0.14916644127551495,-61,Unchanged,10000,5
yhdE,929,892,-0.05863488646234817,-37,Unchanged,10000,5
rng,2994,2528,-0.2440777578813138,-466,Unchanged,10000,5
tldD,3850,2725,-0.4986022159179751,-1125,Unchanged,10000,5
aaeR,571,1150,1.0100712104688947,579,Unchanged,10000,5
aaeX,7,59,3.0752881273042374,52,Unchanged,10000,5
aaeA,88,979,3.4757334309663976,891,Unchanged,10000,5
aaeB,184,2827,3.9414942117741627,2643,Unchanged,10000,5
yhcO,68,108,0.667424660913129,40,Unchanged,10000,5
yhcN,39,171,2.1324502960236495,132,Unchanged,10000,5
argR,2895,1486,-0.9621292323380028,-1409,Unchanged,10000,5
mdh,52912,3353,-3.9800705623973305,-49559,Downregulated,10000,5
degS,984,1573,0.6767884500764468,589,Unchanged,10000,5
degQ,1658,2030,0.2920357205767883,372,Unchanged,10000,5
yhcB,3230,1259,-1.3592558818622706,-1971,Unchanged,10000,5
zapE,1290,1824,0.4997346638541252,534,Unchanged,10000,5
rplM,14631,2459,-2.5728847381609414,-12172,Downregulated,10000,5
rpsI,24032,3493,-2.7824181701194073,-20539,Downregulated,10000,5
sspA,7161,3029,-1.2413194890075603,-4132,Unchanged,10000,5
sspB,3922,1919,-1.0312348239967688,-2003,Unchanged,10000,5
dcuD,47,1991,5.404688654042865,1944,Unchanged,10000,5
nanR,1477,1729,0.2272680428774925,252,Unchanged,10000,5
nanA,112,1531,3.7729036454421836,1419,Unchanged,10000,5
nanT,149,3044,4.3525841230413835,2895,Unchanged,10000,5
nanE,107,1248,3.5439352324611013,1141,Unchanged,10000,5
nanK,343,1588,2.2109304309701456,1245,Unchanged,10000,5
yhcH,175,441,1.3334237337251917,266,Unchanged,10000,5
yhcG,71,1640,4.529732980000764,1569,Unchanged,10000,5
yhcF,131,553,2.0777126686972567,422,Unchanged,10000,5
insH10,4199,3723,-0.17358017198350417,-476,Unchanged,10000,5
yhcD,160,2481,3.9547779250050685,2321,Unchanged,10000,5
yhcA,21,409,4.2836396101629886,388,Unchanged,10000,5
gltF,128,612,2.2573878426926517,484,Unchanged,10000,5
gltD,13762,7198,-0.9350221414734571,-6564,Unchanged,10000,5
gltB,43846,23742,-0.885003762782498,-20104,Downregulated,10000,5
yhcC,678,1574,1.2150783623711425,896,Unchanged,10000,5
arcB,2328,4031,0.7920467249427957,1703,Unchanged,10000,5
elbB,1816,1414,-0.36098208248151614,-402,Unchanged,10000,5
mtgA,490,1060,1.113210610447991,570,Unchanged,10000,5
yrbL,13706,5128,-1.418339425042558,-8578,Unchanged,10000,5
npr,157,161,0.03629612922298996,4,Unchanged,10000,5
rapZ,4030,2115,-0.9301221754080176,-1915,Unchanged,10000,5
ptsN,2341,1144,-1.0330378823336233,-1197,Unchanged,10000,5
hpf,2711,892,-1.6037094979174071,-1819,Unchanged,10000,5
rpoN,7574,5098,-0.5711240478622175,-2476,Unchanged,10000,5
lptB,2771,1705,-0.7006349715698823,-1066,Unchanged,10000,5
lptA,2797,1472,-0.9261025824191789,-1325,Unchanged,10000,5
lptC,1520,1064,-0.5145731728297583,-456,Unchanged,10000,5
kdsC,1998,1443,-0.46948528330122025,-555,Unchanged,10000,5
kdsD,2932,2230,-0.39484139332614476,-702,Unchanged,10000,5
yrbG,1016,1370,0.43127549107572327,354,Unchanged,10000,5
mlaF,2567,2111,-0.2821567172282624,-456,Unchanged,10000,5
mlaE,2524,2167,-0.22001275688887545,-357,Unchanged,10000,5
mlaD,1460,1055,-0.4687253701728321,-405,Unchanged,10000,5
mlaC,3345,1922,-0.7993978747550728,-1423,Unchanged,10000,5
mlaB,737,497,-0.5684187675327834,-240,Unchanged,10000,5
ibaG,791,237,-1.7387906355745328,-554,Unchanged,10000,5
murA,4837,2509,-0.94700006703669,-2328,Unchanged,10000,5
sfsB,58,246,2.0845335102116676,188,Unchanged,10000,5
ispB,3351,1721,-0.9613445891642675,-1630,Unchanged,10000,5
rplU,8615,2069,-2.057917151252301,-6546,Unchanged,10000,5
rpmA,5837,1321,-2.1435966016354113,-4516,Unchanged,10000,5
yhbE,700,1310,0.9041399845924838,610,Unchanged,10000,5
obgE,1606,3346,1.0589655525210382,1740,Unchanged,10000,5
dacB,1392,1814,0.3820152446797941,422,Unchanged,10000,5
greA,624,583,-0.0980501456617519,-41,Unchanged,10000,5
yhbY,719,377,-0.9314272471706336,-342,Unchanged,10000,5
rlmE,3352,2370,-0.5001350899137301,-982,Unchanged,10000,5
ftsH,20778,14521,-0.5169159842939776,-6257,Unchanged,10000,5
folP,2274,1280,-0.8290884440048853,-994,Unchanged,10000,5
glmM,6991,3076,-1.1844433316791783,-3915,Unchanged,10000,5
secG,4618,641,-2.848871911155374,-3977,Unchanged,10000,5
yhbX,129,1075,3.0588936890535687,946,Unchanged,10000,5
argG,3641,5672,0.6395227917950013,2031,Unchanged,10000,5
rimP,2598,1236,-1.0717226875435064,-1362,Unchanged,10000,5
nusA,11192,7760,-0.5283393100902632,-3432,Unchanged,10000,5
infB,31405,17363,-0.8549780294361183,-14042,Downregulated,10000,5
rbfA,1438,1041,-0.46609360713988074,-397,Unchanged,10000,5
truB,2889,2497,-0.21037438263640323,-392,Unchanged,10000,5
rpsO,5789,553,-3.387962770994172,-5236,Unchanged,10000,5
pnp,29966,11315,-1.4050899345052204,-18651,Downregulated,10000,5
nlpI,9908,3930,-1.334064556100394,-5978,Unchanged,10000,5
deaD,5729,8287,0.5325665844045654,2558,Unchanged,10000,5
mtr,727,2577,1.8256652679400254,1850,Unchanged,10000,5
yhbW,269,1946,2.8548336322244876,1677,Unchanged,10000,5
ubiV,1423,1744,0.2934643782504439,321,Unchanged,10000,5
ubiU,1769,2243,0.34249557239581396,474,Unchanged,10000,5
ubiT,3518,1679,-1.0671532525349308,-1839,Unchanged,10000,5
yhbS,2449,1725,-0.5055964120110843,-724,Unchanged,10000,5
yhbQ,85,508,2.579293750634464,423,Unchanged,10000,5
yhbP,213,737,1.7908111888692315,524,Unchanged,10000,5
yhbO,578,736,0.34863627355633403,158,Unchanged,10000,5
yraR,222,1063,2.259510015180999,841,Unchanged,10000,5
yraQ,471,2233,2.2451842862096902,1762,Unchanged,10000,5
yraP,1666,1291,-0.36789940005835703,-375,Unchanged,10000,5
diaA,1427,1028,-0.4731450702818853,-399,Unchanged,10000,5
yraN,346,640,0.8872998672506377,294,Unchanged,10000,5
lpoA,3959,5243,0.40525647848625845,1284,Unchanged,10000,5
rsmI,692,1425,1.0421179763027415,733,Unchanged,10000,5
yraK,109,1207,3.469025635978095,1098,Unchanged,10000,5
yraJ,163,3021,4.212082314496864,2858,Unchanged,10000,5
yraI,12,449,5.225609134019991,437,Unchanged,10000,5
yraH,59,597,3.3389440719029637,538,Unchanged,10000,5
agaI,21,875,5.380821783940931,854,Unchanged,10000,5
agaD,18,995,5.788627713988699,977,Unchanged,10000,5
agaC,9,770,6.4187896341399515,761,Unchanged,10000,5
agaB,10,321,5.004501392234941,311,Unchanged,10000,5
kbaY,11,1421,7.013259220605483,1410,Unchanged,10000,5
agaS,19,1984,6.70626879694329,1965,Unchanged,10000,5
agaA,67,841,3.6498727997973717,774,Unchanged,10000,5
agaW,26,328,3.6571122864769916,302,Unchanged,10000,5
agaV,32,553,4.111135670234707,521,Unchanged,10000,5
kbaZ,38,2119,5.801240358928585,2081,Unchanged,10000,5
agaR,1420,1559,0.13472999830574028,139,Unchanged,10000,5
yhaV,555,633,0.18971772819087288,78,Unchanged,10000,5
prlF,314,392,0.32008909522358114,78,Unchanged,10000,5
garD,643,2624,2.0288770772901366,1981,Unchanged,10000,5
garP,21,2163,6.6865005271832185,2142,Unchanged,10000,5
garL,42,927,4.464108105846771,885,Unchanged,10000,5
garR,216,1252,2.53513134476915,1036,Unchanged,10000,5
garK,299,1832,2.615202113898839,1533,Unchanged,10000,5
rnpB,949408,275071,-1.7872241582140715,-674337,Downregulated,10000,5
yhaC,11,117,3.4109331009461075,106,Unchanged,10000,5
yhaB,7,86,3.6189098326444937,79,Unchanged,10000,5
tdcR,2,15,2.9068905956085187,13,Unchanged,10000,5
tdcA,40,605,3.9188632372745946,565,Unchanged,10000,5
tdcB,36,1199,5.057690941971911,1163,Unchanged,10000,5
tdcC,202,1948,3.2695664793305474,1746,Unchanged,10000,5
tdcD,57,1434,4.6529392945371635,1377,Unchanged,10000,5
tdcE,222,3579,4.010924962066278,3357,Unchanged,10000,5
tdcF,30,425,3.8244284354165456,395,Unchanged,10000,5
cyuP,131,1930,3.8809621306179922,1799,Unchanged,10000,5
yhaL,111,66,-0.7500217469916525,-45,Unchanged,10000,5
yhaK,139,1084,2.963207968630364,945,Unchanged,10000,5
yhaJ,943,1548,0.7150757954693138,605,Unchanged,10000,5
yhaI,16,271,4.082149041353872,255,Unchanged,10000,5
yhaH,548,468,-0.22766736337712226,-80,Unchanged,10000,5
yqjG,576,1330,1.2072855289462394,754,Unchanged,10000,5
yqjF,83,468,2.49532528823648,385,Unchanged,10000,5
yqjK,5091,625,-3.02602097071437,-4466,Unchanged,10000,5
yqjE,7344,706,-3.3788259701426275,-6638,Unchanged,10000,5
yqjD,3018,458,-2.7201733024297394,-2560,Unchanged,10000,5
yqjC,2697,650,-2.0528438983197868,-2047,Unchanged,10000,5
mzrA,327,492,0.5893676798411575,165,Unchanged,10000,5
yqjA,831,1014,0.287137270232996,183,Unchanged,10000,5
exuR,1427,1820,0.35095311561029513,393,Unchanged,10000,5
exuT,368,2439,2.7285120867391712,2071,Unchanged,10000,5
uxaC,489,2861,2.5486131273709494,2372,Unchanged,10000,5
uxaA,383,2925,2.933020327433172,2542,Unchanged,10000,5
ygjV,107,638,2.5759456273637227,531,Unchanged,10000,5
sstT,12868,4460,-1.5286722258450713,-8408,Unchanged,10000,5
alx,105,1615,3.9430729319151645,1510,Unchanged,10000,5
ygjR,700,1752,1.3235759477688445,1052,Unchanged,10000,5
ygjQ,17,893,5.715053523870884,876,Unchanged,10000,5
ygjP,190,618,1.7016074195734268,428,Unchanged,10000,5
rlmG,328,2153,2.71458059954915,1825,Unchanged,10000,5
higB,38,164,2.109624491174498,126,Unchanged,10000,5
higA,160,706,2.1415962783838176,546,Unchanged,10000,5
fadH,130,3960,4.928916901938518,3830,Unchanged,10000,5
ygjK,111,4518,5.347052689042978,4407,Unchanged,10000,5
ygjJ,7,1654,7.884388597113671,1647,Unchanged,10000,5
ygjI,12,2141,7.479106579664354,2129,Unchanged,10000,5
ebgC,9,445,5.627736524411448,436,Unchanged,10000,5
ebgA,111,5640,5.66706358093605,5529,Unchanged,10000,5
ebgR,444,1662,1.9042888004202385,1218,Unchanged,10000,5
ygjH,6,380,5.984893107609792,374,Unchanged,10000,5
patA,306,2431,2.989946335336077,2125,Unchanged,10000,5
aer,185,2941,3.990709608370752,2756,Unchanged,10000,5
nfeR,1179,1221,0.05049948200764056,42,Unchanged,10000,5
nfeF,133,1323,3.314314910777487,1190,Unchanged,10000,5
mug,1050,1094,0.05922341023907156,44,Unchanged,10000,5
rpoD,12120,7711,-0.6523998257123927,-4409,Unchanged,10000,5
dnaG,4439,4268,-0.05667453250066833,-171,Unchanged,10000,5
rpsU,3308,384,-3.1067810184501186,-2924,Unchanged,10000,5
tsaD,2887,2215,-0.3822644087936013,-672,Unchanged,10000,5
ttdT,78,2873,5.202940058670276,2795,Unchanged,10000,5
ttdB,137,1004,2.873511470990245,867,Unchanged,10000,5
ttdA,194,1390,2.840956325423742,1196,Unchanged,10000,5
ttdR,134,1392,3.376854305390956,1258,Unchanged,10000,5
plsY,481,899,0.9022842217444054,418,Unchanged,10000,5
folB,235,528,1.1678771727934538,293,Unchanged,10000,5
bacA,997,1647,0.7241751453281589,650,Unchanged,10000,5
cca,2899,2989,0.044107563616697605,90,Unchanged,10000,5
ygiM,3729,2044,-0.8673936008360197,-1685,Unchanged,10000,5
ygiF,1686,2589,0.618790428958029,903,Unchanged,10000,5
glnE,4421,6303,0.5116659284401358,1882,Unchanged,10000,5
hldE,2863,3195,0.15828826083500397,332,Unchanged,10000,5
yqiK,77,2629,5.093511885923145,2552,Unchanged,10000,5
yqiJ,19,397,4.385067683699372,378,Unchanged,10000,5
glgS,276,80,-1.7865963618908067,-196,Unchanged,10000,5
yqiI,47,517,3.4594316186372973,470,Unchanged,10000,5
yqiH,40,361,3.1739269319998087,321,Unchanged,10000,5
yqiG,258,3301,3.677460167799282,3043,Unchanged,10000,5
insD5,419,649,0.631268234299787,230,Unchanged,10000,5
insC5,388,374,-0.05301838229949099,-14,Unchanged,10000,5
ygiL,11,351,4.9958956016672635,340,Unchanged,10000,5
ubiK,1100,370,-1.5719063478957098,-730,Unchanged,10000,5
ribB,4708,1358,-1.7936308407937125,-3350,Unchanged,10000,5
zupT,1120,1151,0.03938910118726399,31,Unchanged,10000,5
ygiD,168,1069,2.6697287149417304,901,Unchanged,10000,5
ygiC,4783,2546,-0.9096833720849474,-2237,Unchanged,10000,5
ygiB,3032,1622,-0.9024959339538187,-1410,Unchanged,10000,5
tolC,11961,4410,-1.439487450273604,-7551,Unchanged,10000,5
nudF,1144,892,-0.35897143685808475,-252,Unchanged,10000,5
yqiB,709,558,-0.3455205054103285,-151,Unchanged,10000,5
cpdA,2709,1885,-0.5231958700459878,-824,Unchanged,10000,5
yqiA,967,941,-0.039321166748304485,-26,Unchanged,10000,5
parE,4327,4059,-0.09224278072419789,-268,Unchanged,10000,5
ygiN,3693,622,-2.5698067770750113,-3071,Unchanged,10000,5
mdaB,921,842,-0.12938092302493956,-79,Unchanged,10000,5
ygiZ,9,59,2.712718047919529,50,Unchanged,10000,5
qseC,371,2323,2.6464980621880043,1952,Unchanged,10000,5
qseB,184,911,2.3077452877450377,727,Unchanged,10000,5
ygiW,2630,545,-2.270734664515376,-2085,Unchanged,10000,5
ygiV,424,532,0.32736198093799046,108,Unchanged,10000,5
mqsR,432,412,-0.06838697498025013,-20,Unchanged,10000,5
mqsA,613,779,0.3457362543708877,166,Unchanged,10000,5
ygiS,629,2644,2.071590254628403,2015,Unchanged,10000,5
parC,6193,5018,-0.3035259753083543,-1175,Unchanged,10000,5
plsC,947,891,-0.087938993946463,-56,Unchanged,10000,5
ftsP,2332,2706,0.2145940507760408,374,Unchanged,10000,5
yqhH,15,163,3.441837558622559,148,Unchanged,10000,5
yqhG,108,1103,3.352329573427914,995,Unchanged,10000,5
dkgA,3767,3626,-0.05503710820323461,-141,Unchanged,10000,5
yqhD,7937,12203,0.6205701546581761,4266,Unchanged,10000,5
yqhC,450,1404,1.6415460290875237,954,Unchanged,10000,5
yghB,859,888,0.04790154521164227,29,Unchanged,10000,5
metC,3522,1898,-0.891914916810099,-1624,Unchanged,10000,5
exbB,410,941,1.1985708132230906,531,Unchanged,10000,5
exbD,152,357,1.2318527505855144,205,Unchanged,10000,5
yghA,3921,1504,-1.3824170748389522,-2417,Unchanged,10000,5
yqhA,1118,1033,-0.11407993397813058,-85,Unchanged,10000,5
gpr,1742,2642,0.600885842647963,900,Unchanged,10000,5
yghW,10,275,4.78135971352466,265,Unchanged,10000,5
hybO,9003,6137,-0.552872236181934,-2866,Unchanged,10000,5
hybA,6466,4321,-0.5815082765363517,-2145,Unchanged,10000,5
hybB,4812,3264,-0.5599955852045808,-1548,Unchanged,10000,5
hybC,7003,6707,-0.06230548542503315,-296,Unchanged,10000,5
hybD,1761,1393,-0.3381996512299555,-368,Unchanged,10000,5
hybE,1558,1264,-0.3016987698845663,-294,Unchanged,10000,5
hybF,270,331,0.2938718097563867,61,Unchanged,10000,5
hybG,260,180,-0.5305147166987798,-80,Unchanged,10000,5
yghU,2035,1817,-0.16347037491949354,-218,Unchanged,10000,5
gss,6278,3983,-0.6564495492179292,-2295,Unchanged,10000,5
pitB,49,2667,5.766292265435718,2618,Unchanged,10000,5
yghT,11,860,6.288761230952163,849,Unchanged,10000,5
yghS,23,980,5.413075982945558,957,Unchanged,10000,5
yghR,22,1246,5.823656734386705,1224,Unchanged,10000,5
yghQ,28,1654,5.884388597113671,1626,Unchanged,10000,5
insH9,8435,3459,-1.286033054802,-4976,Unchanged,10000,5
yghO,58,2245,5.274518734500937,2187,Unchanged,10000,5
glcC,36,1427,5.308844618033451,1391,Unchanged,10000,5
glcD,108,3740,5.11393505261153,3632,Unchanged,10000,5
glcG,194,630,1.6992951762001511,436,Unchanged,10000,5
glcB,1975,5449,1.4641388376246995,3474,Unchanged,10000,5
glcA,80,2929,5.194264382992005,2849,Unchanged,10000,5
pppA,608,1301,1.0974777332742098,693,Unchanged,10000,5
yghG,100,363,1.859969548221026,263,Unchanged,10000,5
yghF,109,1375,3.657031578522458,1266,Unchanged,10000,5
yghE,429,1651,1.9442905674137125,1222,Unchanged,10000,5
yghD,63,678,3.4278615396364276,615,Unchanged,10000,5
yqgA,202,1036,2.358596804934759,834,Unchanged,10000,5
speC,4947,3646,-0.4402393381194889,-1301,Unchanged,10000,5
nupG,776,2199,1.5027190466678404,1423,Unchanged,10000,5
mltC,1057,1697,0.6830111881599804,640,Unchanged,10000,5
yggX,571,233,-1.2931607907085627,-338,Unchanged,10000,5
mutY,1232,2016,0.7104933828050152,784,Unchanged,10000,5
trmB,1644,1293,-0.3464880238714287,-351,Unchanged,10000,5
yggL,1162,400,-1.5385381636298043,-762,Unchanged,10000,5
yggN,575,1372,1.2546466203410749,797,Unchanged,10000,5
ansB,3176,2156,-0.5588537343904522,-1020,Unchanged,10000,5
yggM,43,1205,4.808552676415226,1162,Unchanged,10000,5
hemW,835,2153,1.3665002168058191,1318,Unchanged,10000,5
rdgB,792,1168,0.5604679388004076,376,Unchanged,10000,5
yggU,186,265,0.5106897383425302,79,Unchanged,10000,5
yggT,1213,916,-0.40516004702356645,-297,Unchanged,10000,5
yggS,575,1072,0.898671044626035,497,Unchanged,10000,5
yggR,43,1759,5.354275012769863,1716,Unchanged,10000,5
yqgF,396,591,0.5776577000979228,195,Unchanged,10000,5
yqgE,1563,1407,-0.15169544976313168,-156,Unchanged,10000,5
gshB,1785,1954,0.13050639305192333,169,Unchanged,10000,5
rsmE,922,1206,0.38739125147074693,284,Unchanged,10000,5
endA,144,930,2.6911619045530815,786,Unchanged,10000,5
yggI,237,550,1.214544559513763,313,Unchanged,10000,5
galP,6076,3254,-0.9009076188295557,-2822,Unchanged,10000,5
metK,44281,4382,-3.3370264134996166,-39899,Downregulated,10000,5
yqgC,53,60,0.1789701410453193,7,Unchanged,10000,5
yqgB,4,3,-0.4150374992788438,-1,Unchanged,10000,5
speA,8034,4151,-0.9526595294418588,-3883,Unchanged,10000,5
speB,1381,1420,0.04017761013399361,39,Unchanged,10000,5
loiP,1397,1491,0.09394823687397919,94,Unchanged,10000,5
tktA,40006,8739,-2.194676280715382,-31267,Downregulated,10000,5
cmtB,7,241,5.105534414172357,234,Unchanged,10000,5
cmtA,42,1733,5.366738516381409,1691,Unchanged,10000,5
yggF,58,1365,4.556704240679642,1307,Unchanged,10000,5
fumE,555,924,0.7354050801785893,369,Unchanged,10000,5
yggC,563,1177,1.0639074929582146,614,Unchanged,10000,5
epd,15423,4216,-1.8711366458342684,-11207,Downregulated,10000,5
pgk,58834,15751,-1.9012066999993138,-43083,Downregulated,10000,5
fbaA,127930,16826,-2.926590466055984,-111104,Downregulated,10000,5
mscS,16583,3317,-2.3217541085098135,-13266,Downregulated,10000,5
argO,334,855,1.3560763172992079,521,Unchanged,10000,5
yggE,6522,1741,-1.9053982380973644,-4781,Unchanged,10000,5
ygfI,231,959,2.0536379636020734,728,Unchanged,10000,5
scpC,118,2210,4.227187604916953,2092,Unchanged,10000,5
scpB,81,979,3.59531504671907,898,Unchanged,10000,5
argK,68,1382,4.34507905913792,1314,Unchanged,10000,5
scpA,140,3559,4.667973200564819,3419,Unchanged,10000,5
argP,1776,1544,-0.20195882908202553,-232,Unchanged,10000,5
yqfE,17,187,3.4594316186372973,170,Unchanged,10000,5
rpiA,7654,2989,-1.3565510039904012,-4665,Unchanged,10000,5
serA,48418,9691,-2.3208260392246167,-38727,Downregulated,10000,5
fau,364,706,0.955729733072484,342,Unchanged,10000,5
ssrS,6382,624,-3.3543906744170635,-5758,Unchanged,10000,5
zapA,1183,460,-1.362744307395413,-723,Unchanged,10000,5
ygfB,4239,1617,-1.390404287581434,-2622,Unchanged,10000,5
pepP,10390,4728,-1.1358937136140417,-5662,Unchanged,10000,5
ubiH,4132,3224,-0.3579885103370922,-908,Unchanged,10000,5
ubiI,3056,2643,-0.20946811839417878,-413,Unchanged,10000,5
gcvT,2759,2186,-0.3358520556813683,-573,Unchanged,10000,5
gcvH,1286,556,-1.2097338546044398,-730,Unchanged,10000,5
gcvP,4765,5353,0.16787143851768954,588,Unchanged,10000,5
ygfF,137,1043,2.928491359559239,906,Unchanged,10000,5
bglA,3541,2603,-0.443981531986804,-938,Unchanged,10000,5
yqfB,500,296,-0.7563309190331373,-204,Unchanged,10000,5
yqfA,468,1126,1.266626392496825,658,Unchanged,10000,5
ygfZ,5845,3029,-0.9483614466236463,-2816,Unchanged,10000,5
sdhE,872,598,-0.5441826505788212,-274,Unchanged,10000,5
ygfX,1050,993,-0.08052370502511108,-57,Unchanged,10000,5
fldB,1045,708,-0.5616816768852476,-337,Unchanged,10000,5
xerD,2425,1805,-0.425985910187319,-620,Unchanged,10000,5
dsbC,2407,1563,-0.6229183634748325,-844,Unchanged,10000,5
recJ,4869,4760,-0.03266392707382181,-109,Unchanged,10000,5
prfB,6706,3578,-0.9062990957418762,-3128,Unchanged,10000,5
lysS,11239,5398,-1.0580167942800915,-5841,Unchanged,10000,5
idi,181,509,1.49167595899249,328,Unchanged,10000,5
uacT,14,1355,6.59672221418363,1341,Unchanged,10000,5
ygfT,170,2332,3.777961137062795,2162,Unchanged,10000,5
ygfS,41,420,3.356693513048039,379,Unchanged,10000,5
guaD,321,1480,2.204951973394009,1159,Unchanged,10000,5
xanQ,81,1283,3.985455452205058,1202,Unchanged,10000,5
xdhD,412,3601,3.127681357007062,3189,Unchanged,10000,5
ygfM,55,791,3.846174170948132,736,Unchanged,10000,5
ssnA,48,1502,4.967706596793116,1454,Unchanged,10000,5
ygfK,131,3110,4.569275863480515,2979,Unchanged,10000,5
mocA,72,366,2.34577483684173,294,Unchanged,10000,5
yqeC,68,788,3.534588978206037,720,Unchanged,10000,5
yqeB,312,1897,2.604101744549227,1585,Unchanged,10000,5
yqeA,155,781,2.333054332867742,626,Unchanged,10000,5
hyuA,67,1470,4.455511249265954,1403,Unchanged,10000,5
ygeY,108,1108,3.3588546638857197,1000,Unchanged,10000,5
ygeX,68,1344,4.304854581528421,1276,Unchanged,10000,5
ygeW,39,1194,4.936184902402557,1155,Unchanged,10000,5
ygeV,542,1615,1.5751694082274157,1073,Unchanged,10000,5
xdhC,85,400,2.234465253637023,315,Unchanged,10000,5
xdhB,119,982,3.0447614510067496,863,Unchanged,10000,5
xdhA,362,2539,2.8101987925643006,2177,Unchanged,10000,5
ygeR,833,936,0.16819203421785683,103,Unchanged,10000,5
ygeQ,169,600,1.8279392542136965,431,Unchanged,10000,5
insC4,261,494,0.9204612350147932,233,Unchanged,10000,5
insD4,297,752,1.3402697308768716,455,Unchanged,10000,5
ygeO,36,68,0.9175378398080271,32,Unchanged,10000,5
ygeN,36,39,0.11547721741993588,3,Unchanged,10000,5
ygeL,9,132,3.8744691179161412,123,Unchanged,10000,5
pbl,2,58,4.857980995127572,56,Unchanged,10000,5
ygeI,2,3,0.5849625007211562,1,Unchanged,10000,5
ygeH,12,130,3.4374053123072983,118,Unchanged,10000,5
ygeG,4,20,2.321928094887362,16,Unchanged,10000,5
ygeF,5,52,3.37851162325373,47,Unchanged,10000,5
yqeK,5,7,0.48542682717024166,2,Unchanged,10000,5
yqeJ,45,37,-0.282399730700725,-8,Unchanged,10000,5
yqeI,222,245,0.14222207265246467,23,Unchanged,10000,5
yqeH,37,138,1.8990710911492192,101,Unchanged,10000,5
yqeG,393,779,0.9870940158030628,386,Unchanged,10000,5
yqeF,130,1295,3.3163685695454617,1165,Unchanged,10000,5
kduI,78,740,3.2459792416540636,662,Unchanged,10000,5
kduD,153,772,2.3350691945754285,619,Unchanged,10000,5
araE,535,1642,1.6178433304892954,1107,Unchanged,10000,5
ygeA,439,672,0.6142402932434021,233,Unchanged,10000,5
lysR,267,1107,2.0517435750939983,840,Unchanged,10000,5
lysA,718,1585,1.1424270912037182,867,Unchanged,10000,5
galR,663,1519,1.1960410943894957,856,Unchanged,10000,5
aas,1936,2778,0.5209676467067981,842,Unchanged,10000,5
lplT,801,1632,1.0267669095627856,831,Unchanged,10000,5
tas,3231,2100,-0.6215914227118787,-1131,Unchanged,10000,5
ygdR,408,99,-2.043068721891886,-309,Unchanged,10000,5
ygdQ,382,1163,1.6062065534374697,781,Unchanged,10000,5
mutH,409,1181,1.5298362164554085,772,Unchanged,10000,5
rppH,3547,1514,-1.228234124949457,-2033,Unchanged,10000,5
ptsP,6027,5486,-0.13568544260617083,-541,Unchanged,10000,5
lgt,796,1141,0.5194584557450329,345,Unchanged,10000,5
thyA,1386,1144,-0.27684020535882436,-242,Unchanged,10000,5
ppdA,46,565,3.618545101245537,519,Unchanged,10000,5
ppdB,135,734,2.442820655792382,599,Unchanged,10000,5
ygdB,95,409,2.106101424610801,314,Unchanged,10000,5
ppdC,58,262,2.1754420064098783,204,Unchanged,10000,5
recC,3896,6288,0.6906075401762644,2392,Unchanged,10000,5
ptrA,3035,5745,0.9206103763904312,2710,Unchanged,10000,5
recB,4763,9327,0.9695425686981982,4564,Unchanged,10000,5
recD,1512,3949,1.385029228239276,2437,Unchanged,10000,5
argA,2043,5720,1.4853259429325243,3677,Unchanged,10000,5
amiC,3720,2741,-0.44060029316961863,-979,Unchanged,10000,5
mltA,2422,1986,-0.28633324216595485,-436,Unchanged,10000,5
tcdA,309,1510,2.2888698063080666,1201,Unchanged,10000,5
csdE,474,826,0.8012547225211862,352,Unchanged,10000,5
csdA,2838,3493,0.29959205333431327,655,Unchanged,10000,5
ygdI,787,166,-2.2451803941605615,-621,Unchanged,10000,5
gcvA,1154,1751,0.6015358597880753,597,Unchanged,10000,5
ygdD,429,674,0.6517709436823129,245,Unchanged,10000,5
rlmM,1847,2280,0.30384995806966586,433,Unchanged,10000,5
fucR,551,939,0.7690728390826168,388,Unchanged,10000,5
fucU,454,560,0.3027345296540515,106,Unchanged,10000,5
fucK,235,2406,3.355903980611077,2171,Unchanged,10000,5
fucI,240,3344,3.8004685364723643,3104,Unchanged,10000,5
fucP,40,1792,5.485426827170242,1752,Unchanged,10000,5
fucA,37,822,4.473541218052733,785,Unchanged,10000,5
fucO,1239,2308,0.8974670365048809,1069,Unchanged,10000,5
ygdG,509,1252,1.2984970008569232,743,Unchanged,10000,5
sdaB,1306,2363,0.855464732427416,1057,Unchanged,10000,5
sdaC,3225,2429,-0.40893667056211386,-796,Unchanged,10000,5
ppnN,5017,3382,-0.5689482783543135,-1635,Unchanged,10000,5
queF,935,1189,0.3467104449706569,254,Unchanged,10000,5
syd,688,840,0.28798076296402464,152,Unchanged,10000,5
yqcC,227,274,0.2714835956696118,47,Unchanged,10000,5
truC,600,1086,0.8559896973084807,486,Unchanged,10000,5
yqcA,1328,630,-1.0758314129596458,-698,Unchanged,10000,5
gudP,63,1746,4.792557920129523,1683,Unchanged,10000,5
gudX,179,1748,3.287673692236342,1569,Unchanged,10000,5
gudD,447,2124,2.248437029620836,1677,Unchanged,10000,5
barA,1859,3721,1.001163620206291,1862,Unchanged,10000,5
rlmD,961,2028,1.0774493162295902,1067,Unchanged,10000,5
relA,4341,4857,0.1620380637708414,516,Unchanged,10000,5
mazE,228,461,1.0157329262645964,233,Unchanged,10000,5
mazF,274,358,0.3857836943037298,84,Unchanged,10000,5
mazG,1247,2351,0.9148130738233513,1104,Unchanged,10000,5
pyrG,25298,7476,-1.7586848591770456,-17822,Downregulated,10000,5
eno,95671,30399,-1.6540578123284673,-65272,Downregulated,10000,5
ygcG,13,321,4.625989768981211,308,Unchanged,10000,5
queE,539,1103,1.0330756128388772,564,Unchanged,10000,5
ygcE,81,1673,4.368371727153728,1592,Unchanged,10000,5
yqcE,24,1512,5.977279923499917,1488,Unchanged,10000,5
ygcW,14,671,5.582814034142579,657,Unchanged,10000,5
ygcS,56,1777,4.987873043971074,1721,Unchanged,10000,5
ygcR,42,1244,4.888453347351843,1202,Unchanged,10000,5
ygcQ,80,1208,3.9164766444377164,1128,Unchanged,10000,5
ygcP,85,530,2.6404576133128597,445,Unchanged,10000,5
ygcO,10,142,3.8278190246173196,132,Unchanged,10000,5
ygcN,370,1949,2.3971369147415778,1579,Unchanged,10000,5
queD,429,405,-0.08305573972755852,-24,Unchanged,10000,5
cysJ,422,5213,3.626798955888827,4791,Unchanged,10000,5
cysI,469,5428,3.5327608929034775,4959,Unchanged,10000,5
cysH,236,1489,2.6574849892202588,1253,Unchanged,10000,5
cas3,306,2941,3.264703226194412,2635,Unchanged,10000,5
casA,164,1734,3.4023361786037514,1570,Unchanged,10000,5
casB,92,504,2.4537179674429037,412,Unchanged,10000,5
casC,353,1240,1.8126000320030573,887,Unchanged,10000,5
casD,180,898,2.3187185384114724,718,Unchanged,10000,5
casE,222,731,1.7193117296023313,509,Unchanged,10000,5
cas1,318,1412,2.150641417986825,1094,Unchanged,10000,5
cas2,60,276,2.2016338611696504,216,Unchanged,10000,5
iap,545,1587,1.5419739931708931,1042,Unchanged,10000,5
cysD,382,3783,3.3078862330136274,3401,Unchanged,10000,5
cysN,880,6089,2.7906298840799177,5209,Unchanged,10000,5
cysC,130,1389,3.417463070952938,1259,Unchanged,10000,5
ygbE,61,298,2.2884311828992754,237,Unchanged,10000,5
ftsB,714,479,-0.5758984182929195,-235,Unchanged,10000,5
ispD,1716,1620,-0.08305573972755852,-96,Unchanged,10000,5
ispF,1077,709,-0.6031607173046915,-368,Unchanged,10000,5
truD,3937,2572,-0.6142060698310937,-1365,Unchanged,10000,5
umpG,2166,1754,-0.30438449516359406,-412,Unchanged,10000,5
pcm,1324,1128,-0.23113605440842414,-196,Unchanged,10000,5
nlpD,8032,12648,0.6550780984075988,4616,Unchanged,10000,5
rpoS,26810,22547,-0.24983573142950463,-4263,Unchanged,10000,5
ygbN,132,1960,3.892243819644117,1828,Unchanged,10000,5
ygbM,92,1072,3.5425272344007595,980,Unchanged,10000,5
ygbL,54,1100,4.3484003062485534,1046,Unchanged,10000,5
ygbK,103,2074,4.331699651630007,1971,Unchanged,10000,5
ygbJ,62,1604,4.693262116068045,1542,Unchanged,10000,5
ygbI,471,1357,1.5266217558060708,886,Unchanged,10000,5
pphB,34,493,3.8579809951275723,459,Unchanged,10000,5
mutS,2242,5382,1.2633561128349906,3140,Unchanged,10000,5
ygbA,37,463,3.6454150176312865,426,Unchanged,10000,5
fhlA,1088,4631,2.089645200453354,3543,Unchanged,10000,5
hypE,1891,2273,0.2654483208680863,382,Unchanged,10000,5
hypD,2762,3198,0.21145661922228126,436,Unchanged,10000,5
hypC,262,377,0.5249977117312139,115,Unchanged,10000,5
hypB,2678,2636,-0.022805590316258825,-42,Unchanged,10000,5
hypA,168,614,1.869777422591419,446,Unchanged,10000,5
hycA,178,814,2.1931515532998493,636,Unchanged,10000,5
hycB,153,1186,2.954500451853352,1033,Unchanged,10000,5
hycC,477,4998,3.389289730081192,4521,Unchanged,10000,5
hycD,215,2287,3.4110478008222125,2072,Unchanged,10000,5
hycE,590,4908,3.0563483894137016,4318,Unchanged,10000,5
hycF,162,1198,2.886562189904161,1036,Unchanged,10000,5
hycG,319,1666,2.3847600716006783,1347,Unchanged,10000,5
hycH,180,694,1.9469387562485863,514,Unchanged,10000,5
hycI,257,836,1.7017345828870047,579,Unchanged,10000,5
ascB,431,3340,2.9540883282723165,2909,Unchanged,10000,5
ascF,310,3787,3.610715300610182,3477,Unchanged,10000,5
ascG,412,2505,2.6040943608993525,2093,Unchanged,10000,5
hydN,207,768,1.8914755432218309,561,Unchanged,10000,5
hypF,1876,6526,1.7985391595764877,4650,Unchanged,10000,5
norW,116,2928,4.65771884315647,2812,Unchanged,10000,5
norV,249,3637,3.868531278387536,3388,Unchanged,10000,5
norR,792,3969,2.3252032269202236,3177,Unchanged,10000,5
gutQ,1080,2405,1.1550055816065732,1325,Unchanged,10000,5
srlR,672,1493,1.1516810273557812,821,Unchanged,10000,5
gutM,45,461,3.356769844099663,416,Unchanged,10000,5
srlD,346,1916,2.4692536180994558,1570,Unchanged,10000,5
srlB,36,591,4.03708931873522,555,Unchanged,10000,5
srlE,87,1760,4.338416217675931,1673,Unchanged,10000,5
srlA,41,699,4.091596640757353,658,Unchanged,10000,5
mltB,1378,2250,0.7073491134001081,872,Unchanged,10000,5
pncC,685,778,0.18366616713830297,93,Unchanged,10000,5
recA,17576,4915,-1.8383434531953335,-12661,Downregulated,10000,5
recX,112,628,2.487265826834023,516,Unchanged,10000,5
alaS,28405,11168,-1.3467740563194006,-17237,Downregulated,10000,5
csrA,1690,209,-3.015448399088664,-1481,Unchanged,10000,5
yqaB,769,951,0.3064617428987369,182,Unchanged,10000,5
yqaA,623,484,-0.36422511574940736,-139,Unchanged,10000,5
gshA,5324,3238,-0.7174075856093258,-2086,Unchanged,10000,5
luxS,7464,1341,-2.4766397489472847,-6123,Unchanged,10000,5
emrB,1165,2349,1.0117167584705542,1184,Unchanged,10000,5
emrA,1958,1855,-0.07796157809552932,-103,Unchanged,10000,5
mprA,4158,1218,-1.7713756249520376,-2940,Unchanged,10000,5
ygaH,691,555,-0.3161979391507903,-136,Unchanged,10000,5
ygaZ,3482,2195,-0.6656952632283807,-1287,Unchanged,10000,5
ygaY,261,2112,3.016488122788569,1851,Unchanged,10000,5
proX,21168,17839,-0.24685022229369336,-3329,Unchanged,10000,5
proW,20183,20659,0.0336297896684495,476,Unchanged,10000,5
proV,29020,25379,-0.19341229512175842,-3641,Unchanged,10000,5
nrdF,34,1274,5.227686721005961,1240,Unchanged,10000,5
nrdE,114,3660,5.004737919006663,3546,Unchanged,10000,5
nrdI,10,348,5.121015400961366,338,Unchanged,10000,5
nrdH,7,179,4.676460855206653,172,Unchanged,10000,5
ygaM,2129,484,-2.1370969971776996,-1645,Unchanged,10000,5
ygaC,795,346,-1.200182822534993,-449,Unchanged,10000,5
alaE,143,446,1.6410285631419153,303,Unchanged,10000,5
stpA,7718,1603,-2.2674526183867063,-6115,Unchanged,10000,5
ygaP,221,666,1.5914758076798305,445,Unchanged,10000,5
ygaV,67,246,1.8764253148814674,179,Unchanged,10000,5
yqaE,34,44,0.37196877738695794,10,Unchanged,10000,5
kbp,3208,787,-2.0272386009474337,-2421,Unchanged,10000,5
glaR,326,1185,1.861943189554544,859,Unchanged,10000,5
gabP,140,2040,3.8650704199138914,1900,Unchanged,10000,5
gabT,630,2902,2.2036237856794654,2272,Unchanged,10000,5
gabD,737,3073,2.0599112424978925,2336,Unchanged,10000,5
lhgD,230,2559,3.475874381095071,2329,Unchanged,10000,5
glaH,222,1571,2.8230515989440903,1349,Unchanged,10000,5
ypjC,10,184,4.20163386116965,174,Unchanged,10000,5
pinH,1,97,6.599912842187128,96,Unchanged,10000,5
ypjA,579,5165,3.1571330957631853,4586,Unchanged,10000,5
ypjF,12,137,3.5130695822393703,125,Unchanged,10000,5
yfjZ,3,115,5.260527550223219,112,Unchanged,10000,5
yfjY,9,350,5.281286110390016,341,Unchanged,10000,5
yfjX,10,488,5.608809242675524,478,Unchanged,10000,5
yfjW,751,237,-1.6639258486160127,-514,Unchanged,10000,5
yfjV,226,1065,2.236458752698013,839,Unchanged,10000,5
yfjU,3,2,-0.5849625007211563,-1,Unchanged,10000,5
yfjT,47,384,3.030373649043519,337,Unchanged,10000,5
yfjS,14,289,4.3675707604430745,275,Unchanged,10000,5
ypjK,7,109,3.9608294027193223,102,Unchanged,10000,5
yfjR,27,593,4.457000792382535,566,Unchanged,10000,5
yfjQ,18,800,5.473931188332412,782,Unchanged,10000,5
yfjP,75,952,3.665999072812063,877,Unchanged,10000,5
rnlB,396,325,-0.28506071216379275,-71,Unchanged,10000,5
rnlA,4217,1619,-1.3811140359765677,-2598,Unchanged,10000,5
yfjM,14,109,2.9608294027193223,95,Unchanged,10000,5
abpA,1810,1794,-0.01280980705130656,-16,Unchanged,10000,5
abpB,1926,2173,0.1740804713378237,247,Unchanged,10000,5
yfjJ,25,146,2.5459683691052923,121,Unchanged,10000,5
yfjI,45,437,3.2796363731709235,392,Unchanged,10000,5
alpA,7,62,3.146841388329271,55,Unchanged,10000,5
yfjH,292,345,0.2406279927855141,53,Unchanged,10000,5
intA,1577,1368,-0.20511442990461237,-209,Unchanged,10000,5
ssrA,836700,230403,-1.8605509333377752,-606297,Downregulated,10000,5
smpB,1129,586,-0.9460729163507529,-543,Unchanged,10000,5
ratA,1459,749,-0.9619422594591398,-710,Unchanged,10000,5
yfjF,337,212,-0.6686843266186594,-125,Unchanged,10000,5
bamE,2178,451,-2.271804615461526,-1727,Unchanged,10000,5
recN,4802,2374,-1.0163154685885099,-2428,Unchanged,10000,5
nadK,1039,895,-0.21523606675259307,-144,Unchanged,10000,5
grpE,13820,4361,-1.6640267201940149,-9459,Unchanged,10000,5
ypjD,620,749,0.2726975031845134,129,Unchanged,10000,5
ffh,7914,4949,-0.677270023105698,-2965,Unchanged,10000,5
rpsP,3736,790,-2.241569896645197,-2946,Unchanged,10000,5
rimM,20347,4125,-2.302350072026451,-16222,Downregulated,10000,5
trmD,22564,4815,-2.2284151388740416,-17749,Downregulated,10000,5
rplS,6860,906,-2.9206256210139396,-5954,Unchanged,10000,5
yfiB,519,272,-0.9321278871075415,-247,Unchanged,10000,5
dgcN,547,986,0.8500468135853549,439,Unchanged,10000,5
yfiR,386,430,0.1557358123213798,44,Unchanged,10000,5
yfiL,47,144,1.615336149764675,97,Unchanged,10000,5
aroF,1014,3907,1.9460036031803325,2893,Unchanged,10000,5
tyrA,1266,3519,1.4748881093213233,2253,Unchanged,10000,5
pheA,2987,1816,-0.7179330350198756,-1171,Unchanged,10000,5
pheL,1,1,0.0,0,Unchanged,10000,5
raiA,10047,3287,-1.6119214203475616,-6760,Unchanged,10000,5
bamD,6003,1875,-1.6787930723562918,-4128,Unchanged,10000,5
rluD,2293,1726,-0.40980389040183846,-567,Unchanged,10000,5
pgeF,778,832,0.0968133731549001,54,Unchanged,10000,5
clpB,36074,29838,-0.27380856564118633,-6236,Unchanged,10000,5
kgtP,3210,4043,0.3328529062620291,833,Unchanged,10000,5
yfiM,100,301,1.5897634869849773,201,Unchanged,10000,5
pssA,4784,2306,-1.0528248765463333,-2478,Unchanged,10000,5
patZ,2061,4108,0.9950916767789388,2047,Unchanged,10000,5
tapT,142,783,2.4631213777863588,641,Unchanged,10000,5
trxC,116,351,1.5973462251769885,235,Unchanged,10000,5
yfiF,2027,1938,-0.06477751805181789,-89,Unchanged,10000,5
ung,1231,1055,-0.22258776288990983,-176,Unchanged,10000,5
grcA,2592,1976,-0.39148277129994696,-616,Unchanged,10000,5
eamB,196,795,2.0201012060565096,599,Unchanged,10000,5
yfiE,174,1283,2.882361959240954,1109,Unchanged,10000,5
srmB,3008,3387,0.17120341981651963,379,Unchanged,10000,5
yfiC,508,1020,1.005668750086692,512,Unchanged,10000,5
nadB,16222,3755,-2.1110668866170283,-12467,Downregulated,10000,5
rpoE,9016,2998,-1.5884871322243617,-6018,Unchanged,10000,5
rseA,13743,5654,-1.2813531804079885,-8089,Unchanged,10000,5
rseB,7779,2854,-1.4465993720986874,-4925,Unchanged,10000,5
rseC,2917,1030,-1.5018410488275968,-1887,Unchanged,10000,5
lepA,10039,5222,-0.9429412046435173,-4817,Unchanged,10000,5
lepB,3404,1888,-0.8503722723241213,-1516,Unchanged,10000,5
rnc,2100,1337,-0.6513898624601321,-763,Unchanged,10000,5
era,3271,2582,-0.3412427587755877,-689,Unchanged,10000,5
recO,630,1027,0.7050124479309162,397,Unchanged,10000,5
pdxJ,2397,1487,-0.6888252615967143,-910,Unchanged,10000,5
acpS,605,552,-0.13226687538378784,-53,Unchanged,10000,5
yfhL,99,112,0.17799830197799443,13,Unchanged,10000,5
yfhH,425,1286,1.597355896302883,861,Unchanged,10000,5
pgpC,1126,1457,0.3717940499842829,331,Unchanged,10000,5
tadA,684,952,0.4769652484220457,268,Unchanged,10000,5
mltF,354,2764,2.964936350305261,2410,Unchanged,10000,5
purL,26525,18325,-0.533539552780953,-8200,Unchanged,10000,5
glrK,1115,3405,1.6106110880917666,2290,Unchanged,10000,5
qseG,780,1496,0.9395641461380261,716,Unchanged,10000,5
glrR,1138,3048,1.4213623451867403,1910,Unchanged,10000,5
glnB,1054,452,-1.2214801892220268,-602,Unchanged,10000,5
hmp,402,2387,2.569931159902848,1985,Unchanged,10000,5
glyA,93445,9592,-3.2842139072946566,-83853,Downregulated,10000,5
yphH,303,2184,2.8495831574469017,1881,Unchanged,10000,5
yphG,152,6405,5.397055341785423,6253,Unchanged,10000,5
yphF,51,1392,4.770518153877233,1341,Unchanged,10000,5
yphE,52,3191,5.93935317513822,3139,Unchanged,10000,5
yphD,58,1914,5.044394119358453,1856,Unchanged,10000,5
yphC,290,2141,2.884159990370575,1851,Unchanged,10000,5
yphB,183,1595,3.1236408703681895,1412,Unchanged,10000,5
yphA,471,473,0.006113123726612006,2,Unchanged,10000,5
hcaD,206,2111,3.3572103361639374,1905,Unchanged,10000,5
hcaB,180,1745,3.27715822476734,1565,Unchanged,10000,5
hcaC,50,475,3.2479275134435857,425,Unchanged,10000,5
hcaF,53,665,3.649290075825353,612,Unchanged,10000,5
hcaE,854,3166,1.8903532805166907,2312,Unchanged,10000,5
hcaR,164,1769,3.4311663280723748,1605,Unchanged,10000,5
hcaT,380,2506,2.7213150909909127,2126,Unchanged,10000,5
csiE,616,2389,1.955404597761431,1773,Unchanged,10000,5
yfhR,49,1977,5.334387311614,1928,Unchanged,10000,5
suhB,2777,1927,-0.5271706055231249,-850,Unchanged,10000,5
trmJ,2986,4118,0.463729664497713,1132,Unchanged,10000,5
iscR,525,1270,1.274439169106043,745,Unchanged,10000,5
iscS,4420,5898,0.41617945278294277,1478,Unchanged,10000,5
iscU,1186,1325,0.1598883497919203,139,Unchanged,10000,5
iscA,1381,1280,-0.10956950937068856,-101,Unchanged,10000,5
hscB,757,1434,0.9216798187161731,677,Unchanged,10000,5
hscA,5431,7576,0.48021846754418435,2145,Unchanged,10000,5
fdx,758,794,0.06694115897186609,36,Unchanged,10000,5
iscX,121,228,0.9140267768901471,107,Unchanged,10000,5
pepB,2829,5045,0.8345620925974669,2216,Unchanged,10000,5
sseB,1007,1602,0.6698104644019254,595,Unchanged,10000,5
sseA,2118,2089,-0.019890096925228282,-29,Unchanged,10000,5
yfhM,7373,14354,0.9611291637400687,6981,Unchanged,10000,5
pbpC,591,5700,3.269731883761934,5109,Unchanged,10000,5
ndk,263,834,1.6649845841523612,571,Unchanged,10000,5
rlmN,1606,2891,0.848096715959735,1285,Unchanged,10000,5
rodZ,3168,3074,-0.043455170388838255,-94,Unchanged,10000,5
ispG,5829,4374,-0.41429518125840753,-1455,Unchanged,10000,5
hisS,7522,4323,-0.7990834701444027,-3199,Unchanged,10000,5
yfgM,3246,1861,-0.8025849444888199,-1385,Unchanged,10000,5
bamB,9072,4553,-0.9946031809230298,-4519,Unchanged,10000,5
der,2925,3850,0.3964218211114968,925,Unchanged,10000,5
yfgJ,25,92,1.8797057662822882,67,Unchanged,10000,5
xseA,2388,2775,0.21668493486002566,387,Unchanged,10000,5
guaB,42100,4813,-3.1288119048762484,-37287,Downregulated,10000,5
guaA,43232,4688,-3.205055104903437,-38544,Downregulated,10000,5
yfgI,48,854,4.153129758899334,806,Unchanged,10000,5
yfgH,25,453,4.17951105027151,428,Unchanged,10000,5
yfgG,37,84,1.1828640571498104,47,Unchanged,10000,5
pdeF,214,3472,4.020084246043332,3258,Unchanged,10000,5
ppx,3634,3416,-0.0892504446136255,-218,Unchanged,10000,5
ppk,6678,5093,-0.39090037616558193,-1585,Unchanged,10000,5
purN,3619,1701,-1.0892079667091537,-1918,Unchanged,10000,5
purM,12455,5024,-1.3098166522365717,-7431,Unchanged,10000,5
upp,17025,1252,-3.7653483308541777,-15773,Downregulated,10000,5
uraA,7735,2163,-1.8383676263744193,-5572,Unchanged,10000,5
hda,1509,1751,0.21458627790687457,242,Unchanged,10000,5
yfgD,1555,699,-1.1535502196425285,-856,Unchanged,10000,5
bepA,3959,4232,0.09620356008392907,273,Unchanged,10000,5
yfgO,1210,2575,1.0895653847959863,1365,Unchanged,10000,5
focB,97,1824,4.232977171977614,1727,Unchanged,10000,5
hyfR,167,4278,4.679016474690992,4111,Unchanged,10000,5
hyfJ,33,563,4.092596992721776,530,Unchanged,10000,5
hyfI,71,1370,4.270213058343207,1299,Unchanged,10000,5
hyfH,61,982,4.008841876751807,921,Unchanged,10000,5
hyfG,231,3849,4.0585189143947815,3618,Unchanged,10000,5
hyfF,92,2853,4.954702075524707,2761,Unchanged,10000,5
hyfE,19,1270,6.062685268215943,1251,Unchanged,10000,5
hyfD,34,2758,6.341943900263641,2724,Unchanged,10000,5
hyfC,10,1798,7.490249210627085,1788,Unchanged,10000,5
hyfB,105,4560,5.4405725913859815,4455,Unchanged,10000,5
hyfA,13,1186,6.511448576404911,1173,Unchanged,10000,5
bcp,4909,1094,-2.1658164285734918,-3815,Unchanged,10000,5
gcvR,2622,1276,-1.0390393564568852,-1346,Unchanged,10000,5
dapA,12848,5392,-1.252651396335456,-7456,Unchanged,10000,5
bamC,10846,6171,-0.8135868757691186,-4675,Unchanged,10000,5
purC,16539,4418,-1.9044066834569928,-12121,Downregulated,10000,5
ypfJ,1889,2527,0.41980296255640537,638,Unchanged,10000,5
tmcA,1729,5079,1.5546066049745162,3350,Unchanged,10000,5
ypfH,1234,1969,0.6741207167521358,735,Unchanged,10000,5
dapE,1373,2801,1.028610357927406,1428,Unchanged,10000,5
yffB,299,509,0.7675201718775903,210,Unchanged,10000,5
acrD,590,7637,3.694219164132008,7047,Unchanged,10000,5
narQ,1044,3821,1.8718285457876267,2777,Unchanged,10000,5
aegA,577,4592,2.9924794180302055,4015,Unchanged,10000,5
nudK,547,1258,1.2015191840867327,711,Unchanged,10000,5
ypfG,1168,2779,1.2505255603205445,1611,Unchanged,10000,5
tktB,9029,5549,-0.7023384089773067,-3480,Unchanged,10000,5
talA,4121,1996,-1.045882742943239,-2125,Unchanged,10000,5
maeB,3955,7260,0.8762918535229589,3305,Unchanged,10000,5
eutS,3,592,7.624490864907794,589,Unchanged,10000,5
eutP,8,762,6.573647187493322,754,Unchanged,10000,5
eutQ,28,1891,6.077578725892158,1863,Unchanged,10000,5
eutT,34,2262,6.0559203727394815,2228,Unchanged,10000,5
eutD,40,3074,6.263973354803409,3034,Unchanged,10000,5
eutM,22,300,3.7693870718585836,278,Unchanged,10000,5
eutN,1,410,8.679480099505446,409,Unchanged,10000,5
eutE,41,3690,6.491853096329675,3649,Unchanged,10000,5
eutJ,17,2236,7.0392416315928505,2219,Unchanged,10000,5
eutG,58,3404,5.87503432655839,3346,Unchanged,10000,5
eutH,64,3375,5.720671786825555,3311,Unchanged,10000,5
eutA,68,3885,5.8362360420447335,3817,Unchanged,10000,5
yffS,1061,1909,0.8473924464891729,848,Unchanged,10000,5
yffR,350,616,0.8155754288625726,266,Unchanged,10000,5
yffQ,19,335,4.1400897719015495,316,Unchanged,10000,5
yffP,70,1248,4.156119201917282,1178,Unchanged,10000,5
yffO,52,584,3.489384840738925,532,Unchanged,10000,5
yffN,21,491,4.547261791535933,470,Unchanged,10000,5
yffM,6,238,5.309855262586788,232,Unchanged,10000,5
yffL,322,1063,1.7230090034164878,741,Unchanged,10000,5
intZ,335,2598,2.9551684301027463,2263,Unchanged,10000,5
eutB,1718,4213,1.2941178794237909,2495,Unchanged,10000,5
eutC,532,1618,1.604713456928788,1086,Unchanged,10000,5
eutL,472,1549,1.7144783794277272,1077,Unchanged,10000,5
eutK,305,1070,1.8107296488382607,765,Unchanged,10000,5
eutR,393,2680,2.7696317830865285,2287,Unchanged,10000,5
hemF,810,1930,1.2526070343834557,1120,Unchanged,10000,5
amiA,1373,2284,0.7342310252157421,911,Unchanged,10000,5
ypeA,656,1134,0.7896529203241452,478,Unchanged,10000,5
yfeZ,277,934,1.7535365736604736,657,Unchanged,10000,5
yfeY,758,1244,0.7147167319595109,486,Unchanged,10000,5
yfeX,5567,2892,-0.9448325309147156,-2675,Unchanged,10000,5
yfeW,108,2888,4.740967524723702,2780,Unchanged,10000,5
murP,144,3370,4.548607874626908,3226,Unchanged,10000,5
murQ,163,2127,3.7058761637295947,1964,Unchanged,10000,5
murR,216,2029,3.2316656475931906,1813,Unchanged,10000,5
ucpA,1306,2375,0.8627726165592418,1069,Unchanged,10000,5
cysP,329,4508,3.7763280264369796,4179,Unchanged,10000,5
cysU,126,2847,4.4979468542423495,2721,Unchanged,10000,5
cysW,204,3261,3.99867338377697,3057,Unchanged,10000,5
cysA,366,5022,3.7783464749874573,4656,Unchanged,10000,5
cysM,795,3112,1.9688152948144741,2317,Unchanged,10000,5
yfeS,267,511,0.9364835492500674,244,Unchanged,10000,5
yfeK,103,367,1.8331357256599945,264,Unchanged,10000,5
pdxK,2480,1933,-0.35949848306300186,-547,Unchanged,10000,5
crr,33596,4329,-2.9561837677075102,-29267,Downregulated,10000,5
ptsI,141378,27201,-2.377826042236528,-114177,Downregulated,10000,5
ptsH,17812,2381,-2.9032099911725697,-15431,Downregulated,10000,5
cysK,9227,22902,1.3115400305896625,13675,Upregulated,10000,5
cysZ,1228,1754,0.5143381870745536,526,Unchanged,10000,5
zipA,6068,3569,-0.7657011841980108,-2499,Unchanged,10000,5
ligA,3873,5243,0.43694104448800836,1370,Unchanged,10000,5
yfeH,505,1848,1.8716094637769005,1343,Unchanged,10000,5
yfeR,249,1853,2.895645233959185,1604,Unchanged,10000,5
yfeN,124,972,2.970616193218906,848,Unchanged,10000,5
xapA,27,1285,5.572665141917772,1258,Unchanged,10000,5
xapB,252,1929,2.936357504549187,1677,Unchanged,10000,5
xapR,432,1545,1.8385036206282683,1113,Unchanged,10000,5
gltX,10436,4711,-1.147463612149531,-5725,Unchanged,10000,5
yfeD,238,384,0.6901447374132127,146,Unchanged,10000,5
yfeC,183,310,0.7604245669901952,127,Unchanged,10000,5
pdeA,2579,3873,0.5866397282391328,1294,Unchanged,10000,5
insL3,895,2493,1.4779232953398818,1598,Unchanged,10000,5
nupC,4556,2436,-0.9032536138017795,-2120,Unchanged,10000,5
mntH,249,2205,3.146561008376802,1956,Unchanged,10000,5
ypeC,313,495,0.6612658680343536,182,Unchanged,10000,5
yfeO,189,1851,3.2918467556495017,1662,Unchanged,10000,5
glk,3112,4006,0.36432036082651587,894,Unchanged,10000,5
fryB,3,312,6.700439718141092,309,Unchanged,10000,5
fryC,28,2076,6.212235806300277,2048,Unchanged,10000,5
ypdF,49,1997,5.348908773328764,1948,Unchanged,10000,5
ypdE,24,1459,5.925801667196735,1435,Unchanged,10000,5
fryA,199,4641,4.543595361626543,4442,Unchanged,10000,5
ypdC,232,1474,2.6675398139674975,1242,Unchanged,10000,5
pyrR,434,979,1.1736138171592156,545,Unchanged,10000,5
pyrS,303,2444,3.0118545863457786,2141,Unchanged,10000,5
alaC,1743,2657,0.6082256583648216,914,Unchanged,10000,5
lpxP,110,1433,3.703463180737486,1323,Unchanged,10000,5
yfdY,183,163,-0.16697168405296492,-20,Unchanged,10000,5
ypdI,5,106,4.405992359675837,101,Unchanged,10000,5
yfdX,40,573,3.8404632338695426,533,Unchanged,10000,5
frc,63,1091,4.114155462823691,1028,Unchanged,10000,5
oxc,43,1478,5.103165799444053,1435,Unchanged,10000,5
yfdV,24,609,4.6653359171851765,585,Unchanged,10000,5
yfdE,57,951,4.060411516695822,894,Unchanged,10000,5
evgS,3760,2604,-0.5300032133993643,-1156,Unchanged,10000,5
evgA,2842,729,-1.9629158349158433,-2113,Unchanged,10000,5
emrK,75,574,2.936088236179807,499,Unchanged,10000,5
emrY,53,797,3.910515459427273,744,Unchanged,10000,5
dsdA,519,1365,1.3950945074493342,846,Unchanged,10000,5
dsdX,86,1253,3.8649059446197627,1167,Unchanged,10000,5
dsdC,460,896,0.9618648711132289,436,Unchanged,10000,5
yfdT,8,130,4.022367813028454,122,Unchanged,10000,5
yfdS,5,163,5.026800059343715,158,Unchanged,10000,5
yfdR,2,349,7.447083226209652,347,Unchanged,10000,5
yfdQ,53,650,3.616375453352618,597,Unchanged,10000,5
yfdP,8,218,4.768184324776926,210,Unchanged,10000,5
yfdO,5,596,6.897240425574799,591,Unchanged,10000,5
yfdN,3,448,7.222392421336448,445,Unchanged,10000,5
yfdM,2,163,6.348728154231077,161,Unchanged,10000,5
yfdL,5,424,6.405992359675837,419,Unchanged,10000,5
yfdK,61,245,2.0059006014396843,184,Unchanged,10000,5
tfaS,22,129,2.5517956367859567,107,Unchanged,10000,5
yfdI,514,142,-1.855877429689196,-372,Unchanged,10000,5
yfdH,920,562,-0.7110637307234491,-358,Unchanged,10000,5
yfdG,289,212,-0.4470052279374796,-77,Unchanged,10000,5
intS,574,1301,1.1804983200421075,727,Unchanged,10000,5
yfdC,477,900,0.9159357352115255,423,Unchanged,10000,5
mlaA,5785,1100,-2.3948134355828303,-4685,Unchanged,10000,5
yfdF,46,258,2.4876652993662414,212,Unchanged,10000,5
fadL,415,1341,1.6921259956701868,926,Unchanged,10000,5
yfcZ,971,280,-1.7940444684742258,-691,Unchanged,10000,5
fadI,57,1688,4.888209174542443,1631,Unchanged,10000,5
fadJ,295,3042,3.366233293475293,2747,Unchanged,10000,5
sixA,1782,871,-1.0327527129230574,-911,Unchanged,10000,5
yfcV,9,496,5.784271308944563,487,Unchanged,10000,5
yfcS,23,1040,5.498805856971441,1017,Unchanged,10000,5
yfcR,35,439,3.6487941125903918,404,Unchanged,10000,5
yfcQ,22,441,4.325203226920223,419,Unchanged,10000,5
yfcP,27,675,4.643856189774724,648,Unchanged,10000,5
yfcO,624,971,0.6379252665569439,347,Unchanged,10000,5
smrB,1050,1099,0.06580205839574609,49,Unchanged,10000,5
prmB,4764,2105,-1.1783531799103557,-2659,Unchanged,10000,5
aroC,6610,3877,-0.7697095366438736,-2733,Unchanged,10000,5
mepA,2355,1967,-0.25973010222161524,-388,Unchanged,10000,5
yfcA,1300,1687,0.3759483503717489,387,Unchanged,10000,5
epmC,1294,1022,-0.34044242105488615,-272,Unchanged,10000,5
yfcL,394,370,-0.09067035894006407,-24,Unchanged,10000,5
mnmC,1426,4951,1.7957459675182725,3525,Unchanged,10000,5
fabB,4505,8243,0.8716423888252957,3738,Unchanged,10000,5
yfcJ,390,2621,2.7485713245788066,2231,Unchanged,10000,5
flk,872,1911,1.1319277382005304,1039,Unchanged,10000,5
pdxB,3710,3424,-0.11573648510701863,-286,Unchanged,10000,5
usg,1978,2961,0.5820420644184431,983,Unchanged,10000,5
truA,555,1242,1.162105496983013,687,Unchanged,10000,5
dedA,692,1230,0.8298143725898777,538,Unchanged,10000,5
accD,13002,4494,-1.5326615296349224,-8508,Unchanged,10000,5
folC,2611,3447,0.40073884105442764,836,Unchanged,10000,5
dedD,2006,1673,-0.26188416057382796,-333,Unchanged,10000,5
cvpA,4868,2123,-1.1972247968083507,-2745,Unchanged,10000,5
purF,7738,5515,-0.48859984296447145,-2223,Unchanged,10000,5
ubiX,634,1019,0.6845993060264066,385,Unchanged,10000,5
argT,206,1178,2.515623296647242,972,Unchanged,10000,5
hisJ,1225,3490,1.5104452872070817,2265,Unchanged,10000,5
hisQ,422,1865,2.143860726435415,1443,Unchanged,10000,5
hisM,278,1192,2.100227447738654,914,Unchanged,10000,5
hisP,311,1687,2.4394734881569633,1376,Unchanged,10000,5
rpnB,127,895,2.817059185379453,768,Unchanged,10000,5
yfcH,1907,2064,0.11413812711049784,157,Unchanged,10000,5
folX,662,308,-1.1039008661123162,-354,Unchanged,10000,5
yfcG,248,841,1.761765679868269,593,Unchanged,10000,5
yfcF,507,894,0.8182890841799771,387,Unchanged,10000,5
yfcE,2076,1156,-0.8446650458572021,-920,Unchanged,10000,5
yfcD,2943,1323,-1.153474480661718,-1620,Unchanged,10000,5
yfcC,1489,2693,0.8548704759195719,1204,Unchanged,10000,5
pta,1966,4752,1.2732715144601852,2786,Unchanged,10000,5
ackA,2,1,-1.0,-1,Unchanged,10000,5
yfbV,1435,1347,-0.09130088610074703,-88,Unchanged,10000,5
yfbU,2808,1368,-1.0374747054186628,-1440,Unchanged,10000,5
hxpA,4106,2090,-0.9742306851403568,-2016,Unchanged,10000,5
yfbS,1499,3405,1.183654414951574,1906,Unchanged,10000,5
yfbR,796,862,0.1149194385454494,66,Unchanged,10000,5
alaA,4858,2801,-0.7944205065613587,-2057,Unchanged,10000,5
lrhA,1614,2427,0.5885335298733533,813,Unchanged,10000,5
nuoA,1799,1096,-0.7149473882909556,-703,Unchanged,10000,5
nuoB,4216,2742,-0.6206462958579887,-1474,Unchanged,10000,5
nuoC,9393,7895,-0.25064674311222684,-1498,Unchanged,10000,5
nuoE,2488,1928,-0.3678814339006409,-560,Unchanged,10000,5
nuoF,6727,5652,-0.2512017924974152,-1075,Unchanged,10000,5
nuoG,10852,10182,-0.09193998201804657,-670,Unchanged,10000,5
nuoH,3331,2832,-0.23413408859135365,-499,Unchanged,10000,5
nuoI,1099,1533,0.4801663107095463,434,Unchanged,10000,5
nuoJ,1365,1481,0.11767068948163283,116,Unchanged,10000,5
nuoK,291,389,0.418751002077908,98,Unchanged,10000,5
nuoL,4609,5209,0.17655266941405348,600,Unchanged,10000,5
nuoM,3547,3878,0.12871347317160373,331,Unchanged,10000,5
nuoN,5211,4153,-0.3274063830067539,-1058,Unchanged,10000,5
yfbP,59,838,3.8281633843375102,779,Unchanged,10000,5
yfbO,30,176,2.5525410230287786,146,Unchanged,10000,5
yfbN,19,398,4.3886971071000636,379,Unchanged,10000,5
yfbM,173,631,1.8668679673458244,458,Unchanged,10000,5
yfbL,28,1046,5.223312214189337,1018,Unchanged,10000,5
yfbK,79,2576,5.027136129937515,2497,Unchanged,10000,5
elaD,55,415,2.9156078127096277,360,Unchanged,10000,5
rbn,411,1558,1.9224849343799864,1147,Unchanged,10000,5
elaA,690,784,0.18425729244967684,94,Unchanged,10000,5
elaB,9861,641,-3.9433376951827253,-9220,Unchanged,10000,5
menF,1610,2641,0.7140236131651136,1031,Unchanged,10000,5
menD,1714,4043,1.238059094159195,2329,Unchanged,10000,5
menH,147,1329,3.17645304443981,1182,Unchanged,10000,5
menB,3115,2260,-0.4629093906088141,-855,Unchanged,10000,5
menC,2646,2405,-0.13777616762127248,-241,Unchanged,10000,5
menE,1821,3248,0.834820710208338,1427,Unchanged,10000,5
pmrD,174,246,0.49957100949051153,72,Unchanged,10000,5
arnF,69,400,2.5353317329965557,331,Unchanged,10000,5
arnT,173,2970,4.101618988051404,2797,Unchanged,10000,5
arnD,129,1585,3.6190398696035158,1456,Unchanged,10000,5
arnA,615,3468,2.4954455829952327,2853,Unchanged,10000,5
arnC,164,1267,2.9496488045227256,1103,Unchanged,10000,5
arnB,326,2036,2.6427936918446178,1710,Unchanged,10000,5
ais,34,458,3.7517409468466045,424,Unchanged,10000,5
nudI,203,508,1.3233487695869897,305,Unchanged,10000,5
yfaZ,155,796,2.3605002152694112,641,Unchanged,10000,5
yfaY,1564,2724,0.8004861907047189,1160,Unchanged,10000,5
yfaX,17,1011,5.894104440652675,994,Unchanged,10000,5
rhmD,49,2224,5.504231228608299,2175,Unchanged,10000,5
yfaV,37,2380,6.007292492566356,2343,Unchanged,10000,5
yfaU,40,1353,5.0800180290891745,1313,Unchanged,10000,5
rpnE,283,1170,2.0476345716388846,887,Unchanged,10000,5
glpC,14723,6938,-1.0854799232219399,-7785,Unchanged,10000,5
glpB,17244,9755,-0.8218806896821039,-7489,Unchanged,10000,5
glpA,27879,16500,-0.7567127892131932,-11379,Downregulated,10000,5
glpT,9621,4959,-0.956137629149333,-4662,Unchanged,10000,5
glpQ,8403,3497,-1.2647866880979461,-4906,Unchanged,10000,5
yfaH,3,106,5.142957953842043,103,Unchanged,10000,5
inaA,544,1205,1.1473545898669844,661,Unchanged,10000,5
yfaE,201,241,0.26183764505103296,40,Unchanged,10000,5
nrdB,2013,2355,0.2263798875788059,342,Unchanged,10000,5
nrdA,1142,4666,2.0306236566213562,3524,Unchanged,10000,5
yfaL,1171,6569,2.487932689709059,5398,Unchanged,10000,5
ubiG,1622,1788,0.14057291696604474,166,Unchanged,10000,5
gyrA,16891,12835,-0.39617144681057487,-4056,Unchanged,10000,5
yfaA,167,2759,4.046225448879221,2592,Unchanged,10000,5
yfaT,17,849,5.642157902302699,832,Unchanged,10000,5
yfaQ,111,2774,4.643336205973497,2663,Unchanged,10000,5
yfaP,28,1013,5.1770635367435345,985,Unchanged,10000,5
atoB,96,1658,4.110265790774594,1562,Unchanged,10000,5
atoE,62,2130,5.102441404726325,2068,Unchanged,10000,5
atoA,9,989,6.779901709316799,980,Unchanged,10000,5
atoD,12,953,6.311369903188786,941,Unchanged,10000,5
atoC,286,1897,2.7296326266330864,1611,Unchanged,10000,5
atoS,165,2557,3.953914230995833,2392,Unchanged,10000,5
rcsC,3070,5008,0.7059959066750766,1938,Unchanged,10000,5
rcsB,6121,2103,-1.5413185180747846,-4018,Unchanged,10000,5
rcsD,7900,6604,-0.25851253303856964,-1296,Unchanged,10000,5
ompC,353442,36375,-3.2804543343829895,-317067,Downregulated,10000,5
ftp,341,2012,2.5607866607813548,1671,Unchanged,10000,5
ada,613,2311,1.9145582807768495,1698,Unchanged,10000,5
alkB,157,1046,2.7360463873553145,889,Unchanged,10000,5
yojI,106,2952,4.799556551497197,2846,Unchanged,10000,5
mqo,82,3739,5.510884751240085,3657,Unchanged,10000,5
eco,1033,860,-0.26443168927559924,-173,Unchanged,10000,5
napF,210,1020,2.2801079191927354,810,Unchanged,10000,5
napD,41,288,2.812372996824229,247,Unchanged,10000,5
napA,1787,7122,1.9947428013215722,5335,Unchanged,10000,5
napG,268,1491,2.47597535182567,1223,Unchanged,10000,5
napH,250,1942,2.957543200757105,1692,Unchanged,10000,5
napB,144,787,2.450294824065174,643,Unchanged,10000,5
napC,321,946,1.5592668862170922,625,Unchanged,10000,5
ccmA,437,1405,1.68486494560769,968,Unchanged,10000,5
ccmB,202,1227,2.6027080509111102,1025,Unchanged,10000,5
ccmC,401,1443,1.8473971580362778,1042,Unchanged,10000,5
ccmD,39,184,2.2381597371947644,145,Unchanged,10000,5
ccmE,332,939,1.4999419163068497,607,Unchanged,10000,5
ccmF,792,4796,2.598259323334614,4004,Unchanged,10000,5
ccmG,203,921,2.1817214289061595,718,Unchanged,10000,5
ccmH,455,1900,2.0620609681322515,1445,Unchanged,10000,5
narP,1519,1264,-0.2651254063249806,-255,Unchanged,10000,5
insH8,7246,3927,-0.8837572077868905,-3319,Unchanged,10000,5
yejM,1918,3987,1.0557008849792,2069,Unchanged,10000,5
yejL,277,210,-0.3994966483830657,-67,Unchanged,10000,5
yejK,3066,2200,-0.47885417324675567,-866,Unchanged,10000,5
rplY,9196,1156,-2.991865068217501,-8040,Unchanged,10000,5
radD,504,3226,2.6782507996557263,2722,Unchanged,10000,5
rsuA,1416,1479,0.06280078701607025,63,Unchanged,10000,5
bcr,1387,2263,0.7062687969432897,876,Unchanged,10000,5
yejG,163,505,1.6314114234080794,342,Unchanged,10000,5
yejF,716,2588,1.8538061247282511,1872,Unchanged,10000,5
yejE,272,1356,2.3176786218860044,1084,Unchanged,10000,5
yejB,322,1590,2.3038941720571007,1268,Unchanged,10000,5
yejA,1017,2815,1.4688152431100918,1798,Unchanged,10000,5
pdeN,611,2480,2.021095835455508,1869,Unchanged,10000,5
mepS,8428,1858,-2.1814398124346535,-6570,Unchanged,10000,5
lpxT,494,771,0.6422198183303567,277,Unchanged,10000,5
yeiR,757,1704,1.1705601302401067,947,Unchanged,10000,5
yeiQ,90,2504,4.798165750602943,2414,Unchanged,10000,5
yeiP,1136,542,-1.0675980781508105,-594,Unchanged,10000,5
setB,91,1872,4.362570079384708,1781,Unchanged,10000,5
fruB,12073,3052,-1.9839573462841358,-9021,Unchanged,10000,5
fruK,8840,2580,-1.7766753039681773,-6260,Unchanged,10000,5
fruA,22641,5623,-2.009525728050357,-17018,Downregulated,10000,5
psuK,40,977,4.610286657081023,937,Unchanged,10000,5
psuG,83,1428,4.104740832682175,1345,Unchanged,10000,5
psuT,211,2147,3.3470072871515884,1936,Unchanged,10000,5
yeiL,35,501,3.839383776250242,466,Unchanged,10000,5
rihB,21,1173,5.803669875249748,1152,Unchanged,10000,5
nupX,52,1823,5.131659127898042,1771,Unchanged,10000,5
yeiI,661,1942,1.5548210239115006,1281,Unchanged,10000,5
nfo,985,1790,0.8617639578078801,805,Unchanged,10000,5
yeiH,1807,1907,0.07770833744815672,100,Unchanged,10000,5
yeiE,1258,1735,0.46380374058633406,477,Unchanged,10000,5
lysP,3826,2848,-0.4258877273797146,-978,Unchanged,10000,5
cirA,218,3231,3.8895807104884375,3013,Unchanged,10000,5
yeiG,3311,3785,0.19302628947609457,474,Unchanged,10000,5
folE,6927,1649,-2.0706392750578044,-5278,Unchanged,10000,5
yeiB,1356,2163,0.6736764868256349,807,Unchanged,10000,5
galS,218,1860,3.092902581218467,1642,Unchanged,10000,5
mglB,126,1676,3.733526510199435,1550,Unchanged,10000,5
mglA,30,1812,5.916476644437717,1782,Unchanged,10000,5
mglC,34,1684,5.630213581816057,1650,Unchanged,10000,5
preA,1569,2762,0.8158679672899533,1193,Unchanged,10000,5
preT,2219,3272,0.5602630807447375,1053,Unchanged,10000,5
yeiS,54,189,1.8073549220576042,135,Unchanged,10000,5
sanA,314,929,1.5649140374910258,615,Unchanged,10000,5
cdd,632,2438,1.9477016624431092,1806,Unchanged,10000,5
yohK,185,1505,3.0241663111307524,1320,Unchanged,10000,5
yohJ,86,802,3.2211936717528222,716,Unchanged,10000,5
dusC,165,2308,3.806105294399667,2143,Unchanged,10000,5
mdtQ,39,3047,6.2877715658242375,3008,Unchanged,10000,5
yohF,287,1591,2.47081119365536,1304,Unchanged,10000,5
yohD,419,1101,1.3937923198650173,682,Unchanged,10000,5
yohC,377,1073,1.5090136474878577,696,Unchanged,10000,5
pbpG,1595,1746,0.13049713497720836,151,Unchanged,10000,5
dld,4718,4521,-0.0615335009204825,-197,Unchanged,10000,5
bglX,3112,6246,1.0050905090343814,3134,Unchanged,10000,5
osmF,919,1761,0.9382581425421738,842,Unchanged,10000,5
yehY,448,2612,2.543584259488827,2164,Unchanged,10000,5
yehX,252,2102,3.060267030462262,1850,Unchanged,10000,5
yehW,135,1352,3.3240638392313535,1217,Unchanged,10000,5
mlrA,430,1274,1.5669567126668402,844,Unchanged,10000,5
btsS,453,3196,2.8186844528817416,2743,Unchanged,10000,5
btsR,363,1122,1.628031222613042,759,Unchanged,10000,5
yehS,271,770,1.5065655942283922,499,Unchanged,10000,5
yehR,16,435,4.764871590736091,419,Unchanged,10000,5
yehQ,123,3454,4.8115378621896845,3331,Unchanged,10000,5
yehP,32,1860,5.861086905995394,1828,Unchanged,10000,5
yehM,68,4365,6.004303097266463,4297,Unchanged,10000,5
yehL,22,1949,6.469086756620593,1927,Unchanged,10000,5
yehI,305,5956,4.287462606131851,5651,Unchanged,10000,5
metG,10395,6258,-0.7321161945048105,-4137,Unchanged,10000,5
mrp,6457,4014,-0.6858234103847323,-2443,Unchanged,10000,5
yehE,273,95,-1.5229015325889046,-178,Unchanged,10000,5
yehD,115,218,0.9226942738325511,103,Unchanged,10000,5
yehC,16,387,4.59618975614441,371,Unchanged,10000,5
yehB,89,2652,4.89713162914619,2563,Unchanged,10000,5
yehA,18,434,4.5916262310021665,416,Unchanged,10000,5
rcnB,1118,456,-1.2938144586784484,-662,Unchanged,10000,5
rcnA,78,1094,3.809994803930308,1016,Unchanged,10000,5
rcnR,115,276,1.2630344058337937,161,Unchanged,10000,5
thiM,194,1102,2.50599566638403,908,Unchanged,10000,5
thiD,232,1166,2.329371078072924,934,Unchanged,10000,5
yegX,154,1141,2.8892965355937803,987,Unchanged,10000,5
yegW,332,1003,1.595066459265256,671,Unchanged,10000,5
yegV,288,1793,2.6382347714260623,1505,Unchanged,10000,5
yegU,323,1996,2.627505650643336,1673,Unchanged,10000,5
yegT,140,2037,3.8629472480209217,1897,Unchanged,10000,5
fbaB,28402,3261,-3.1226061781960226,-25141,Downregulated,10000,5
gatY,63081,52673,-0.2601419000437396,-10408,Downregulated,10000,5
gatZ,94167,68585,-0.45732848476521315,-25582,Downregulated,10000,5
gatA,12288,8185,-0.5861957993596403,-4103,Unchanged,10000,5
gatB,6011,1944,-1.6285768011158377,-4067,Unchanged,10000,5
gatC,39885,22508,-0.825408409408629,-17377,Downregulated,10000,5
gatD,5237,6935,0.405155277761614,1698,Unchanged,10000,5
insF5,30,675,4.491853096329675,645,Unchanged,10000,5
insE5,80,103,0.3645724322958561,23,Unchanged,10000,5
yegS,830,1382,0.7355743741539715,552,Unchanged,10000,5
yegR,26,87,1.7425037777076362,61,Unchanged,10000,5
yegZ,5,57,3.5109619192773796,52,Unchanged,10000,5
ogrK,95,130,0.4525122046975067,35,Unchanged,10000,5
trhP,1783,3475,0.9627062748732371,1692,Unchanged,10000,5
yegP,396,276,-0.5208321633014404,-120,Unchanged,10000,5
baeR,709,1435,1.017193204323534,726,Unchanged,10000,5
baeS,206,2176,3.400962314067121,1970,Unchanged,10000,5
mdtD,195,2620,3.748020782675202,2425,Unchanged,10000,5
mdtC,498,6795,3.7702559035866727,6297,Unchanged,10000,5
mdtB,687,7160,3.3815775833335184,6473,Unchanged,10000,5
mdtA,358,2090,2.5454714497039888,1732,Unchanged,10000,5
yegL,54,1058,4.292236409950557,1004,Unchanged,10000,5
pphC,23,1372,5.898502810115799,1349,Unchanged,10000,5
yegJ,19,339,4.157213949692759,320,Unchanged,10000,5
yegI,167,3354,4.327962681090294,3187,Unchanged,10000,5
yegD,419,2672,2.6728978587747005,2253,Unchanged,10000,5
alkA,316,1378,2.1245794245271883,1062,Unchanged,10000,5
dgcE,1170,6681,2.5135555290381792,5511,Unchanged,10000,5
udk,1166,1154,-0.014924564555013892,-12,Unchanged,10000,5
dcd,3006,2147,-0.4855228180575914,-859,Unchanged,10000,5
asmA,3564,4666,0.38868897046227724,1102,Unchanged,10000,5
yegH,1224,3651,1.5766881107422328,2427,Unchanged,10000,5
wza,169,1416,3.0667261138008133,1247,Unchanged,10000,5
wzb,37,533,3.848538357130226,496,Unchanged,10000,5
wzc,342,3733,3.448267278417172,3391,Unchanged,10000,5
wcaA,129,1122,3.1206297051855385,993,Unchanged,10000,5
wcaB,60,557,3.2146429217315133,497,Unchanged,10000,5
wcaC,155,1827,3.559136513353251,1672,Unchanged,10000,5
wcaD,137,944,2.7846109664013143,807,Unchanged,10000,5
wcaE,64,682,3.4136279290241727,618,Unchanged,10000,5
wcaF,31,426,3.780513309838963,395,Unchanged,10000,5
gmd,291,1452,2.318950395087467,1161,Unchanged,10000,5
fcl,241,1314,2.446860224092368,1073,Unchanged,10000,5
gmm,66,437,2.727095350142145,371,Unchanged,10000,5
wcaI,137,1658,3.5971962085352236,1521,Unchanged,10000,5
cpsB,146,2095,3.842909969706697,1949,Unchanged,10000,5
cpsG,135,1835,3.764748750679744,1700,Unchanged,10000,5
wcaJ,108,1972,4.190556334214443,1864,Unchanged,10000,5
wzxC,103,1853,4.1691466388440475,1750,Unchanged,10000,5
wcaK,198,1800,3.1844245711374275,1602,Unchanged,10000,5
wcaL,283,1732,2.6135649718948426,1449,Unchanged,10000,5
wcaM,260,1368,2.3954847018574434,1108,Unchanged,10000,5
galF,12704,2315,-2.456198718995359,-10389,Downregulated,10000,5
rfbB,4733,1652,-1.5185412353189183,-3081,Unchanged,10000,5
rfbD,3083,1511,-1.028831228942346,-1572,Unchanged,10000,5
rfbA,3124,1145,-1.448046855157673,-1979,Unchanged,10000,5
rfbC,1192,395,-1.5934596773976963,-797,Unchanged,10000,5
rfbX,1662,601,-1.467483486059159,-1061,Unchanged,10000,5
glf,2686,1029,-1.3842163225334738,-1657,Unchanged,10000,5
wbbH,987,513,-0.9440912588493436,-474,Unchanged,10000,5
wbbI,2331,592,-1.9772799234999165,-1739,Unchanged,10000,5
wbbJ,1085,583,-0.8961272541313453,-502,Unchanged,10000,5
wbbK,1597,283,-2.4964903545793504,-1314,Unchanged,10000,5
insH7,2926,2885,-0.02035845060564203,-41,Unchanged,10000,5
gnd,40426,5825,-2.7949535065669906,-34601,Downregulated,10000,5
ugd,1130,905,-0.3203330753319823,-225,Unchanged,10000,5
wzzB,6004,2255,-1.412796543477945,-3749,Unchanged,10000,5
hisI,1914,1093,-0.808297428814121,-821,Unchanged,10000,5
hisF,1889,1433,-0.39858409212622414,-456,Unchanged,10000,5
hisA,1544,1471,-0.06987550601325024,-73,Unchanged,10000,5
hisH,1302,1105,-0.23668307888684156,-197,Unchanged,10000,5
hisB,3244,2322,-0.4824058473517066,-922,Unchanged,10000,5
hisC,2844,2568,-0.1472762624971122,-276,Unchanged,10000,5
hisD,3180,3383,0.0892764116222706,203,Unchanged,10000,5
hisG,2132,2193,0.04069837391441764,61,Unchanged,10000,5
hisL,1,1,0.0,0,Unchanged,10000,5
yefM,295,285,-0.049753035197099615,-10,Unchanged,10000,5
yeeZ,3853,2428,-0.6662137644038679,-1425,Unchanged,10000,5
yeeY,311,1361,2.129680581373392,1050,Unchanged,10000,5
plaP,1482,1908,0.36451572369967766,426,Unchanged,10000,5
yeeE,251,2267,3.175025121790014,2016,Unchanged,10000,5
yeeD,97,310,1.67621156308711,213,Unchanged,10000,5
sbcB,2188,2526,0.20724190099499581,338,Unchanged,10000,5
dacD,369,1468,1.9921592467828166,1099,Unchanged,10000,5
sbmC,870,514,-0.7592470415422125,-356,Unchanged,10000,5
yeeA,580,1031,0.829919527353174,451,Unchanged,10000,5
yeeX,6484,1324,-2.291980968710324,-5160,Unchanged,10000,5
yeeW,6,27,2.169925001442312,21,Unchanged,10000,5
cbtA,9,194,4.429987840744816,185,Unchanged,10000,5
cbeA,17,318,4.225420114034016,301,Unchanged,10000,5
yeeT,5,88,4.137503523749935,83,Unchanged,10000,5
yeeS,81,450,2.473931188332412,369,Unchanged,10000,5
yeeR,1122,2184,0.9609001803110596,1062,Unchanged,10000,5
flu,38462,25731,-0.5799262573462889,-12731,Downregulated,10000,5
yeeP,83,557,2.746494085993107,474,Unchanged,10000,5
insC3,233,153,-0.6067983019616285,-80,Unchanged,10000,5
insD3,456,438,-0.05810295456356828,-18,Unchanged,10000,5
insH6,511,1656,1.6963074765617039,1145,Unchanged,10000,5
cobU,194,535,1.4634822391013815,341,Unchanged,10000,5
cobS,373,1097,1.556315990147955,724,Unchanged,10000,5
cobT,829,1589,0.9386751178527688,760,Unchanged,10000,5
ldtA,1397,1039,-0.4271363665052513,-358,Unchanged,10000,5
nac,79,638,3.0136318655877665,559,Unchanged,10000,5
cbl,117,875,2.902774487136287,758,Unchanged,10000,5
yeeO,650,1648,1.3422046192674015,998,Unchanged,10000,5
yeeN,1875,761,-1.30092223676706,-1114,Unchanged,10000,5
amn,4097,2585,-0.6644036122780042,-1512,Unchanged,10000,5
shiA,1386,1416,0.030894007945783775,30,Unchanged,10000,5
yeeJ,1294,7180,2.472146226717906,5886,Unchanged,10000,5
mtfA,1449,900,-0.6870606883398924,-549,Unchanged,10000,5
yodB,70,270,1.9475325801058645,200,Unchanged,10000,5
zinT,51,190,1.8974302663594522,139,Unchanged,10000,5
msrQ,194,536,1.4661763482706447,342,Unchanged,10000,5
msrP,476,1049,1.1399811992693243,573,Unchanged,10000,5
hiuH,31,173,2.4804319172498497,142,Unchanged,10000,5
hprR,378,491,0.3773367900936203,113,Unchanged,10000,5
hprS,416,747,0.8445247146481449,331,Unchanged,10000,5
hchA,6245,911,-2.7771786126932687,-5334,Unchanged,10000,5
drpB,486,353,-0.4612881303346007,-133,Unchanged,10000,5
yedJ,1422,1072,-0.40761655916164274,-350,Unchanged,10000,5
dcm,2938,2402,-0.2905982448506457,-536,Unchanged,10000,5
vsr,225,410,0.865698908288409,185,Unchanged,10000,5
yedA,31,882,4.830438535170646,851,Unchanged,10000,5
yedI,806,1206,0.5813781633721175,400,Unchanged,10000,5
yodC,133,80,-0.7333543406138273,-53,Unchanged,10000,5
dgcQ,1065,2066,0.9559868237518588,1001,Unchanged,10000,5
yedP,900,874,-0.04229172171643864,-26,Unchanged,10000,5
dsrA,1,1,0.0,0,Unchanged,10000,5
yodD,312,101,-1.6271907361104536,-211,Unchanged,10000,5
dsrB,115,50,-1.2016338611696507,-65,Unchanged,10000,5
rcsA,605,214,-1.49932434576081,-391,Unchanged,10000,5
fliR,70,733,3.3883863711888456,663,Unchanged,10000,5
fliQ,39,187,2.261492241025388,148,Unchanged,10000,5
fliP,195,683,1.8084114545404797,488,Unchanged,10000,5
fliO,160,315,0.9772799234999164,155,Unchanged,10000,5
fliN,343,301,-0.1884450894131103,-42,Unchanged,10000,5
fliM,895,1085,0.277735455180223,190,Unchanged,10000,5
fliL,388,325,-0.25561693427131077,-63,Unchanged,10000,5
fliK,341,1315,1.9472191551554923,974,Unchanged,10000,5
fliJ,128,315,1.2992080183872787,187,Unchanged,10000,5
fliI,526,1813,1.7852442204518557,1287,Unchanged,10000,5
fliH,546,839,0.6197698595199709,293,Unchanged,10000,5
fliG,755,1299,0.78285288123544,544,Unchanged,10000,5
fliF,1100,2147,0.9648186674467513,1047,Unchanged,10000,5
fliE,356,213,-0.7410238107405596,-143,Unchanged,10000,5
intG,1,14,3.807354922057604,13,Unchanged,10000,5
yedL,77,406,2.398549376490275,329,Unchanged,10000,5
yedK,102,706,2.7910990312996846,604,Unchanged,10000,5
yedF,150,110,-0.4474589769712214,-40,Unchanged,10000,5
yedE,1585,1795,0.17950100368364416,210,Unchanged,10000,5
yedD,1123,564,-0.9935908600018076,-559,Unchanged,10000,5
amyA,977,1698,0.7974059915846532,721,Unchanged,10000,5
fliT,50,268,2.4222330006830477,218,Unchanged,10000,5
fliS,97,263,1.4390061471051747,166,Unchanged,10000,5
fliD,453,1915,2.079761436766084,1462,Unchanged,10000,5
fliC,4914,1763,-1.4788653830419831,-3151,Unchanged,10000,5
fliA,2101,761,-1.4651078031695006,-1340,Unchanged,10000,5
fliZ,827,527,-0.6500843675340601,-300,Unchanged,10000,5
tcyJ,4462,4044,-0.14190751634112583,-418,Unchanged,10000,5
dcyD,2511,2486,-0.01443573221901491,-25,Unchanged,10000,5
tcyL,929,1102,0.24637372218850462,173,Unchanged,10000,5
tcyN,1082,1431,0.4033231728998524,349,Unchanged,10000,5
sdiA,168,686,2.029747343394052,518,Unchanged,10000,5
yecF,153,71,-1.1076407231879697,-82,Unchanged,10000,5
uvrY,2317,1116,-1.0539210170356341,-1201,Unchanged,10000,5
uvrC,3224,3042,-0.08383159080347061,-182,Unchanged,10000,5
pgsA,1305,840,-0.6355885737911242,-465,Unchanged,10000,5
yecA,2045,1225,-0.7393190939391782,-820,Unchanged,10000,5
tyrP,643,1570,1.287873916451042,927,Unchanged,10000,5
yecH,461,271,-0.7664738990754665,-190,Unchanged,10000,5
ftnA,20910,1511,-3.7906174963121124,-19399,Downregulated,10000,5
yecR,63,203,1.6880559936852597,140,Unchanged,10000,5
ftnB,1587,552,-1.5235619560570128,-1035,Unchanged,10000,5
araF,121,1145,3.2422686457097116,1024,Unchanged,10000,5
araG,171,2094,3.6141932120449107,1923,Unchanged,10000,5
otsB,2591,1202,-1.108072119468909,-1389,Unchanged,10000,5
otsA,8145,2323,-1.8099255446040725,-5822,Unchanged,10000,5
uspC,284,318,0.1631358357796734,34,Unchanged,10000,5
insA5,26,90,1.7914133781885826,64,Unchanged,10000,5
insB5,32,769,4.586839787961827,737,Unchanged,10000,5
flhD,773,319,-1.276911990159978,-454,Unchanged,10000,5
flhC,1344,571,-1.2349704874159175,-773,Unchanged,10000,5
motA,183,1257,2.780069096136465,1074,Unchanged,10000,5
motB,154,1315,3.0940605434847632,1161,Unchanged,10000,5
cheA,517,2872,2.473819563508117,2355,Unchanged,10000,5
cheW,188,540,1.5222267453731935,352,Unchanged,10000,5
tar,475,2445,2.363835046621286,1970,Unchanged,10000,5
tap,282,2352,3.0601209924375707,2070,Unchanged,10000,5
cheR,124,1158,3.2232232276023614,1034,Unchanged,10000,5
cheB,99,1349,3.768318012868658,1250,Unchanged,10000,5
cheY,95,346,1.864772619305777,251,Unchanged,10000,5
cheZ,243,875,1.8483267031139103,632,Unchanged,10000,5
flhB,506,1618,1.6770023177356674,1112,Unchanged,10000,5
flhA,997,3210,1.6869078876114694,2213,Unchanged,10000,5
flhE,96,337,1.8116422804607022,241,Unchanged,10000,5
yecT,35,172,2.2969817377571315,137,Unchanged,10000,5
argS,4800,3297,-0.5418805188254936,-1503,Unchanged,10000,5
yecM,543,764,0.4926204402313871,221,Unchanged,10000,5
cutC,936,1099,0.23161095136582666,163,Unchanged,10000,5
torY,13,938,6.173004394374285,925,Unchanged,10000,5
torZ,328,3126,3.2525500583815807,2798,Unchanged,10000,5
cmoB,1181,1623,0.4586540351508142,442,Unchanged,10000,5
cmoA,1152,1150,-0.0025068556105748664,-2,Unchanged,10000,5
yecN,669,469,-0.5124182881260844,-200,Unchanged,10000,5
yecE,315,803,1.3500481591300355,488,Unchanged,10000,5
yecD,866,874,0.013266254773873592,8,Unchanged,10000,5
aspS,9753,8775,-0.1524469313322267,-978,Unchanged,10000,5
nudB,978,810,-0.27191255718024665,-168,Unchanged,10000,5
yebC,2981,2288,-0.38170932321277934,-693,Unchanged,10000,5
ruvC,1283,1176,-0.12563311025331814,-107,Unchanged,10000,5
yebB,37,434,3.5520978668155294,397,Unchanged,10000,5
ruvA,769,747,-0.04187535517258934,-22,Unchanged,10000,5
ruvB,2052,1825,-0.16913426695231218,-227,Unchanged,10000,5
znuB,644,963,0.5804751097288424,319,Unchanged,10000,5
znuC,759,939,0.30702527223830817,180,Unchanged,10000,5
znuA,1247,1272,0.028637205454685438,25,Unchanged,10000,5
mepM,4091,3182,-0.3625197015569986,-909,Unchanged,10000,5
lpxM,1591,1727,0.11833424719787643,136,Unchanged,10000,5
pykA,39109,14137,-1.4680246478466752,-24972,Downregulated,10000,5
yebK,829,1338,0.6906341091457104,509,Unchanged,10000,5
zwf,5426,2890,-0.908819554893825,-2536,Unchanged,10000,5
edd,3784,2938,-0.3650776927831154,-846,Unchanged,10000,5
eda,9402,2647,-1.828609485698338,-6755,Unchanged,10000,5
purT,3466,1840,-0.9135658882157943,-1626,Unchanged,10000,5
yebG,1595,615,-1.3748981084256295,-980,Unchanged,10000,5
yebF,1866,906,-1.0423660308055236,-960,Unchanged,10000,5
yebE,617,1215,0.9776139193437254,598,Unchanged,10000,5
ptrB,1446,2692,0.8966108576591993,1246,Unchanged,10000,5
exoX,1039,965,-0.10659480674876895,-74,Unchanged,10000,5
yobB,1053,749,-0.4914678125669659,-304,Unchanged,10000,5
holE,509,130,-1.9691540330472408,-379,Unchanged,10000,5
yobA,1006,736,-0.4508526337485142,-270,Unchanged,10000,5
yebZ,1348,2008,0.5749387727689135,660,Unchanged,10000,5
yebY,664,333,-0.9956610642756626,-331,Unchanged,10000,5
pphA,105,590,2.490325626583081,485,Unchanged,10000,5
yebW,76,48,-0.6629650127224294,-28,Unchanged,10000,5
yebV,517,89,-2.538287039348537,-428,Unchanged,10000,5
rsmF,596,1844,1.6294544199671765,1248,Unchanged,10000,5
letB,2046,3532,0.7876791979031373,1486,Unchanged,10000,5
letA,828,1540,0.8952276780829385,712,Unchanged,10000,5
msrC,4221,843,-2.3239802930156066,-3378,Unchanged,10000,5
proQ,9926,2443,-2.022558591029864,-7483,Unchanged,10000,5
prc,14880,4310,-1.7876147520189332,-10570,Downregulated,10000,5
htpX,5623,4150,-0.4382287104191545,-1473,Unchanged,10000,5
yebQ,59,1292,4.452747305332084,1233,Unchanged,10000,5
kdgR,2476,1831,-0.4353795234169275,-645,Unchanged,10000,5
mgrB,45,11,-2.0324214776923775,-34,Unchanged,10000,5
yebO,760,220,-1.7884958948062881,-540,Unchanged,10000,5
yobF,1076,53,-4.343541907993425,-1023,Unchanged,10000,5
cspC,8006,425,-4.235546869362475,-7581,Unchanged,10000,5
rlmA,545,971,0.8332150657549035,426,Unchanged,10000,5
mntP,177,656,1.8899464545350864,479,Unchanged,10000,5
yobD,853,446,-0.9355020313979854,-407,Unchanged,10000,5
manZ,23603,10209,-1.2091286842324276,-13394,Downregulated,10000,5
manY,23378,10298,-1.1827873365932655,-13080,Downregulated,10000,5
manX,24692,11537,-1.0977755719525577,-13155,Downregulated,10000,5
yoaE,1632,2503,0.6170172337168363,871,Unchanged,10000,5
pdeD,324,1715,2.40414285817555,1391,Unchanged,10000,5
sdaA,1818,2541,0.4830441758592477,723,Unchanged,10000,5
nudL,547,694,0.34339482978570424,147,Unchanged,10000,5
pabB,1206,1971,0.7086978691434009,765,Unchanged,10000,5
yoaH,124,85,-0.5448053742491735,-39,Unchanged,10000,5
yoaC,291,174,-0.7419318470595556,-117,Unchanged,10000,5
yoaB,2553,549,-2.21731548340192,-2004,Unchanged,10000,5
yoaA,2064,3174,0.6208591574119279,1110,Unchanged,10000,5
tsaB,661,1159,0.8101583894987802,498,Unchanged,10000,5
yeaY,919,821,-0.16268263951122966,-98,Unchanged,10000,5
fadD,671,2176,1.6972938850501558,1505,Unchanged,10000,5
rnd,994,1599,0.6858521819180459,605,Unchanged,10000,5
yeaX,155,953,2.6202079986357045,798,Unchanged,10000,5
yeaW,107,1439,3.7493838903391508,1332,Unchanged,10000,5
yeaV,86,1656,4.267222202797227,1570,Unchanged,10000,5
dmlA,87244,1543,-5.8212459497692866,-85701,Downregulated,10000,5
dmlR,1036,1117,0.10860518279676099,81,Unchanged,10000,5
leuE,629,481,-0.38702312310924736,-148,Unchanged,10000,5
yeaR,28,246,3.1351595832816357,218,Unchanged,10000,5
yoaG,2,16,3.0,14,Unchanged,10000,5
yeaQ,2365,186,-3.668465657118726,-2179,Unchanged,10000,5
dgcP,2402,1469,-0.7094017551493541,-933,Unchanged,10000,5
yoaF,80,152,0.925999418556223,72,Unchanged,10000,5
yeaO,358,340,-0.07442484112655467,-18,Unchanged,10000,5
nimT,144,1366,3.245816766847778,1222,Unchanged,10000,5
nimR,279,908,1.7024271754617275,629,Unchanged,10000,5
yeaL,294,508,0.7890123419358014,214,Unchanged,10000,5
yoaI,1,1,0.0,0,Unchanged,10000,5
yeaK,1322,1063,-0.31458057997658706,-259,Unchanged,10000,5
dgcJ,427,1152,1.431832741821822,725,Unchanged,10000,5
cdgI,122,762,2.6429098499304358,640,Unchanged,10000,5
yeaH,733,1323,0.851927958144865,590,Unchanged,10000,5
yeaG,2926,2511,-0.220667740866987,-415,Unchanged,10000,5
mipA,4677,1445,-1.6945139360308996,-3232,Unchanged,10000,5
yeaE,704,1153,0.7117451790144745,449,Unchanged,10000,5
yeaD,11466,1765,-2.69962209554007,-9701,Unchanged,10000,5
gapA,318154,45160,-2.8166078688035605,-272994,Downregulated,10000,5
msrB,802,753,-0.09095237178299216,-49,Unchanged,10000,5
yeaC,448,415,-0.11038739582331702,-33,Unchanged,10000,5
ydjL,137,1262,3.203464112022022,1125,Unchanged,10000,5
ydjK,106,1349,3.6697541783850687,1243,Unchanged,10000,5
ydjJ,99,1112,3.4895844526438977,1013,Unchanged,10000,5
ydjI,154,755,2.2935462935175397,601,Unchanged,10000,5
ydjH,101,849,3.0714092608012438,748,Unchanged,10000,5
ydjG,190,944,2.3127874410308937,754,Unchanged,10000,5
ydjF,463,574,0.3100385434154514,111,Unchanged,10000,5
ydjE,45,1157,4.6843200527778155,1112,Unchanged,10000,5
pncA,444,792,0.8349407537295036,348,Unchanged,10000,5
ansA,561,1260,1.167351057778486,699,Unchanged,10000,5
sppA,1986,2726,0.45691993927683555,740,Unchanged,10000,5
ydjA,1447,1795,0.31091892217868905,348,Unchanged,10000,5
selD,6696,4166,-0.6846366885096968,-2530,Unchanged,10000,5
topB,5499,5407,-0.024340930179042635,-92,Unchanged,10000,5
ynjI,130,717,2.4634614956734504,587,Unchanged,10000,5
gdhA,22177,12819,-0.7907804948627224,-9358,Unchanged,10000,5
ynjH,44,145,1.7204774713776372,101,Unchanged,10000,5
nudG,113,442,1.9677235969762439,329,Unchanged,10000,5
ynjF,329,823,1.3228048466863842,494,Unchanged,10000,5
ynjE,3862,2603,-0.5691728525465383,-1259,Unchanged,10000,5
ynjD,428,825,0.9467833227320311,397,Unchanged,10000,5
ynjC,1098,2504,1.1893565079274198,1406,Unchanged,10000,5
ynjB,2106,2311,0.13401182344191415,205,Unchanged,10000,5
ynjA,767,900,0.23069842371410365,133,Unchanged,10000,5
ydjZ,1499,1177,-0.3488860629094155,-322,Unchanged,10000,5
ydjY,2364,1050,-1.1708407076240475,-1314,Unchanged,10000,5
ydjX,1211,919,-0.39806209840529433,-292,Unchanged,10000,5
xthA,1677,1280,-0.38973887867698387,-397,Unchanged,10000,5
astC,47,2311,5.619712692789993,2264,Unchanged,10000,5
astA,31,1997,6.009422307057098,1966,Unchanged,10000,5
astD,104,2929,4.815752759738275,2825,Unchanged,10000,5
astB,112,2427,4.43760347109353,2315,Unchanged,10000,5
astE,34,1527,5.489021505546512,1493,Unchanged,10000,5
spy,1578,1880,0.25263545655154107,302,Unchanged,10000,5
ves,45,807,4.1645717669481055,762,Unchanged,10000,5
cho,1004,1495,0.5743862151346953,491,Unchanged,10000,5
nadE,6223,2659,-1.2267264690297064,-3564,Unchanged,10000,5
osmE,9861,1027,-3.2632977754832715,-8834,Unchanged,10000,5
chbB,57,168,1.5594274086140185,111,Unchanged,10000,5
chbC,67,1759,4.714450577014189,1692,Unchanged,10000,5
chbA,79,378,2.2584616760439697,299,Unchanged,10000,5
chbR,236,738,1.6448339566985548,502,Unchanged,10000,5
chbF,158,1477,3.224673362587686,1319,Unchanged,10000,5
chbG,370,1035,1.4840335918703755,665,Unchanged,10000,5
katE,10012,3934,-1.3476613334098018,-6078,Unchanged,10000,5
cedA,98,192,0.970252656605948,94,Unchanged,10000,5
ydjO,10,181,4.177917792195843,171,Unchanged,10000,5
tcyP,1608,4421,1.4591053277751376,2813,Unchanged,10000,5
ydjM,149,714,2.260611743566938,565,Unchanged,10000,5
hxpB,873,995,0.18871487180157107,122,Unchanged,10000,5
yniB,1201,781,-0.6208416975636547,-420,Unchanged,10000,5
yniA,3329,2044,-0.7036936742026417,-1285,Unchanged,10000,5
ydiZ,485,236,-1.0391978877126489,-249,Unchanged,10000,5
pfkB,5287,3339,-0.6630332333178263,-1948,Unchanged,10000,5
ydiY,68,803,3.561793336266975,735,Unchanged,10000,5
thrS,43564,13497,-1.6904976541053067,-30067,Downregulated,10000,5
infC,37449,8442,-2.1492704605293826,-29007,Downregulated,10000,5
rpmI,4477,1441,-1.6354619827287968,-3036,Unchanged,10000,5
rplT,29138,6390,-2.1890140195284826,-22748,Downregulated,10000,5
pheM,1,1,0.0,0,Unchanged,10000,5
pheS,4551,2685,-0.7612614980954147,-1866,Unchanged,10000,5
pheT,14837,8307,-0.8367999529957835,-6530,Unchanged,10000,5
ihfA,4496,856,-2.392959333819779,-3640,Unchanged,10000,5
btuC,858,1462,0.7688937584528917,604,Unchanged,10000,5
btuE,1235,640,-0.9483672315846776,-595,Unchanged,10000,5
btuD,992,1084,0.1279527309669964,92,Unchanged,10000,5
nlpC,1156,574,-1.010018755824991,-582,Unchanged,10000,5
rflP,650,520,-0.3219280948873623,-130,Unchanged,10000,5
ydiU,550,2041,1.8917726586206973,1491,Unchanged,10000,5
ydiE,1,74,6.20945336562895,73,Unchanged,10000,5
aroH,2082,1991,-0.0644768475789144,-91,Unchanged,10000,5
ppsR,933,1058,0.18139064126226692,125,Unchanged,10000,5
ppsA,2893,4128,0.5128766474936545,1235,Unchanged,10000,5
fadK,113,1821,4.010336244561651,1708,Unchanged,10000,5
ydiT,12,102,3.0874628412503395,90,Unchanged,10000,5
ydiS,118,1558,3.722836468699828,1440,Unchanged,10000,5
ydiR,136,1197,3.1377445956931624,1061,Unchanged,10000,5
ydiQ,54,838,3.955918931535883,784,Unchanged,10000,5
ydiP,448,659,0.5567797329504476,211,Unchanged,10000,5
ydiO,62,1285,4.373356333694366,1223,Unchanged,10000,5
ydiF,35,1628,5.53960196732128,1593,Unchanged,10000,5
aroD,969,1127,0.21791894475713997,158,Unchanged,10000,5
ydiB,46,788,4.098489863399363,742,Unchanged,10000,5
ydiN,33,1220,5.208271313091795,1187,Unchanged,10000,5
ydiM,17,982,5.852116373064353,965,Unchanged,10000,5
ydiL,13,279,4.423681593688095,266,Unchanged,10000,5
ydiK,2717,2239,-0.2791600373693775,-478,Unchanged,10000,5
ydiJ,20150,10845,-0.8937497857430559,-9305,Unchanged,10000,5
menI,1683,865,-0.960263138805862,-818,Unchanged,10000,5
ydiH,1107,400,-1.4685833170068274,-707,Unchanged,10000,5
sufA,250,384,0.6191782160590692,134,Unchanged,10000,5
sufB,1808,2407,0.4128414640593092,599,Unchanged,10000,5
sufC,839,953,0.18380540347011853,114,Unchanged,10000,5
sufD,1622,1911,0.23655395876018365,289,Unchanged,10000,5
sufS,1259,1702,0.4349527539669462,443,Unchanged,10000,5
sufE,296,350,0.24175774620337906,54,Unchanged,10000,5
ldtE,3764,1416,-1.4104453626455393,-2348,Unchanged,10000,5
lpp,50412,2420,-4.380688239045717,-47992,Downregulated,10000,5
pykF,35641,6452,-2.465719472344591,-29189,Downregulated,10000,5
fumD,568,150,-1.9209284290088013,-418,Unchanged,10000,5
ydhY,1114,502,-1.1499899633892599,-612,Unchanged,10000,5
ydhV,3625,2378,-0.6082322800440033,-1247,Unchanged,10000,5
ydhW,684,751,0.1348165826283738,67,Unchanged,10000,5
ydhX,496,720,0.5376567859427995,224,Unchanged,10000,5
ydhU,539,787,0.5460783627549809,248,Unchanged,10000,5
ydhT,346,1073,1.6328061331197974,727,Unchanged,10000,5
ydhS,1414,1831,0.37284967098793814,417,Unchanged,10000,5
ydhR,3473,845,-2.039159164212545,-2628,Unchanged,10000,5
ydhQ,7311,2816,-1.3764214178071996,-4495,Unchanged,10000,5
mdtK,1116,2488,1.1566494583014149,1372,Unchanged,10000,5
ribC,4026,1281,-1.6520766965796931,-2745,Unchanged,10000,5
cfa,31218,7370,-2.0826415887154166,-23848,Downregulated,10000,5
ydhC,342,1701,2.314314910777487,1359,Unchanged,10000,5
ydhB,575,1302,1.179095587333898,727,Unchanged,10000,5
purR,3336,1999,-0.7388408167000359,-1337,Unchanged,10000,5
ydhP,328,1712,2.383914981783063,1384,Unchanged,10000,5
sodB,19516,8797,-1.1495738712222052,-10719,Downregulated,10000,5
mepH,795,937,0.23709418748746908,142,Unchanged,10000,5
grxD,2100,614,-1.7740787671833054,-1486,Unchanged,10000,5
lhr,3450,10768,1.6420820480574232,7318,Unchanged,10000,5
rnt,733,1343,0.8735742012936304,610,Unchanged,10000,5
gloA,2760,1116,-1.3063312398363438,-1644,Unchanged,10000,5
nemA,1073,1992,0.8925675713115591,919,Unchanged,10000,5
nemR,260,775,1.5756846871331454,515,Unchanged,10000,5
ydhL,172,224,0.38109016735550627,52,Unchanged,10000,5
ydhF,1465,1609,0.135263661413836,144,Unchanged,10000,5
sodC,1438,758,-0.923793922268206,-680,Unchanged,10000,5
ydhK,254,2985,3.5548305293800015,2731,Unchanged,10000,5
ydhJ,151,984,2.704109766014161,833,Unchanged,10000,5
ydhI,59,160,1.439285045525521,101,Unchanged,10000,5
slyA,3696,895,-2.046005169264439,-2801,Unchanged,10000,5
slyB,15455,5913,-1.3861114719809438,-9542,Unchanged,10000,5
anmK,1482,1821,0.2971854746710044,339,Unchanged,10000,5
mliC,375,250,-0.5849625007211563,-125,Unchanged,10000,5
pdxH,3123,1131,-1.4653336400307528,-1992,Unchanged,10000,5
tyrS,12363,4420,-1.4839105947228617,-7943,Unchanged,10000,5
pdxY,2549,1275,-0.9994341262759816,-1274,Unchanged,10000,5
gstA,4497,1407,-1.676340555432483,-3090,Unchanged,10000,5
dtpA,22029,2339,-3.2354402390036,-19690,Downregulated,10000,5
nth,208,562,1.433986602079834,354,Unchanged,10000,5
rsxE,257,834,1.6982790242507855,577,Unchanged,10000,5
rsxG,225,714,1.6659990728120626,489,Unchanged,10000,5
rsxD,396,1312,1.728195384538474,916,Unchanged,10000,5
rsxC,1148,3059,1.4139374648825147,1911,Unchanged,10000,5
rsxB,313,709,1.1796229703068979,396,Unchanged,10000,5
rsxA,399,709,0.8293968810171704,310,Unchanged,10000,5
ydgK,557,513,-0.1187185017329777,-44,Unchanged,10000,5
cnu,105,66,-0.6698513983076693,-39,Unchanged,10000,5
ydgJ,2365,1709,-0.4686877865506181,-656,Unchanged,10000,5
add,2223,1743,-0.35093537890130505,-480,Unchanged,10000,5
malY,1567,1316,-0.25184569073733876,-251,Unchanged,10000,5
malX,318,1971,2.6318291057591305,1653,Unchanged,10000,5
malI,281,1324,2.2362610865862917,1043,Unchanged,10000,5
hdhA,7599,1287,-2.5617975242129556,-6312,Unchanged,10000,5
uidR,854,705,-0.27661281233433443,-149,Unchanged,10000,5
uidA,84,2028,4.59352451422458,1944,Unchanged,10000,5
uidB,26,1201,5.529580717564542,1175,Unchanged,10000,5
uidC,24,903,5.233619676759702,879,Unchanged,10000,5
ydgA,7832,2741,-1.51467843677792,-5091,Unchanged,10000,5
manA,6596,2470,-1.4170803569654271,-4126,Unchanged,10000,5
fumA,1055,1934,0.8743447958822937,879,Unchanged,10000,5
fumC,435,1574,1.8553482347713957,1139,Unchanged,10000,5
tus,407,953,1.2274474196436949,546,Unchanged,10000,5
rstB,1227,1378,0.16744063904138629,151,Unchanged,10000,5
rstA,1658,1034,-0.6812078211808157,-624,Unchanged,10000,5
ydgC,82,176,1.1018796140192137,94,Unchanged,10000,5
folM,333,554,0.7343637989779263,221,Unchanged,10000,5
ydgI,437,1565,1.8404574723193823,1128,Unchanged,10000,5
ydgH,4232,1815,-1.2213700792309126,-2417,Unchanged,10000,5
pntA,20019,7852,-1.3502378317680022,-12167,Downregulated,10000,5
pntB,18260,6722,-1.4417243175635825,-11538,Downregulated,10000,5
tqsA,398,1120,1.4926583964013178,722,Unchanged,10000,5
mdtJ,32,278,3.1189410727235076,246,Unchanged,10000,5
mdtI,18,183,3.34577483684173,165,Unchanged,10000,5
ydgD,569,738,0.3751921637538141,169,Unchanged,10000,5
asr,77,145,0.9131225493200331,68,Unchanged,10000,5
ynfM,783,1435,0.8739665242720095,652,Unchanged,10000,5
ynfL,308,1055,1.776240742899646,747,Unchanged,10000,5
mlc,2569,2592,0.012858827983807924,23,Unchanged,10000,5
ynfK,4051,2020,-1.0039227920472795,-2031,Unchanged,10000,5
clcB,272,1077,1.985339693293868,805,Unchanged,10000,5
dmsD,1985,595,-1.7381774338350142,-1390,Unchanged,10000,5
ynfH,6173,964,-2.6788667397930284,-5209,Unchanged,10000,5
ynfG,2804,429,-2.708436796511078,-2375,Unchanged,10000,5
ynfF,19327,2400,-3.0095114041497926,-16927,Downregulated,10000,5
ynfE,6240,2094,-1.5752845868188023,-4146,Unchanged,10000,5
ynfD,417,167,-1.3201992809706113,-250,Unchanged,10000,5
ynfC,511,625,0.2905328986118282,114,Unchanged,10000,5
speG,2243,577,-1.9587863964407897,-1666,Unchanged,10000,5
ynfB,1402,389,-1.8496442890244311,-1013,Unchanged,10000,5
ynfA,174,244,0.487793841714158,70,Unchanged,10000,5
rspA,134,1014,2.919752746545568,880,Unchanged,10000,5
rspB,87,709,3.026698321390788,622,Unchanged,10000,5
intQ,67,604,3.1723155488673065,537,Unchanged,10000,5
insD7,6,1627,8.083036034951371,1621,Unchanged,10000,5
ydfE,36,584,4.0198995574377046,548,Unchanged,10000,5
ydfD,1,23,4.523561956057013,22,Unchanged,10000,5
dicB,2,4,1.0,2,Unchanged,10000,5
dicF,1,1,0.0,0,Unchanged,10000,5
ydfC,5,56,3.4854268271702415,51,Unchanged,10000,5
ydfB,1,7,2.807354922057604,6,Unchanged,10000,5
ydfA,3,13,2.1154772174199357,10,Unchanged,10000,5
dicA,1209,278,-2.120657456525616,-931,Unchanged,10000,5
dicC,5,42,3.070389327891398,37,Unchanged,10000,5
ydfX,8,104,3.700439718141092,96,Unchanged,10000,5
ydfW,4,18,2.169925001442312,14,Unchanged,10000,5
flxA,112,141,0.3321964303411894,29,Unchanged,10000,5
ydfV,9,99,3.4594316186372973,90,Unchanged,10000,5
relB,516,287,-0.8463203287475664,-229,Unchanged,10000,5
relE,685,437,-0.6484707083472907,-248,Unchanged,10000,5
hokD,39,29,-0.42742122373467617,-10,Unchanged,10000,5
rem,29,98,1.756728848987636,69,Unchanged,10000,5
ydfU,26,876,5.074347341460081,850,Unchanged,10000,5
ydfT,65,486,2.9024446905773265,421,Unchanged,10000,5
cspF,17,66,1.956931278108114,49,Unchanged,10000,5
cspB,10,26,1.3785116232537298,16,Unchanged,10000,5
essQ,1,29,4.857980995127572,28,Unchanged,10000,5
ydfR,10,105,3.3923174227787602,95,Unchanged,10000,5
rrrQ,11,372,5.079727192470735,361,Unchanged,10000,5
rzpQ,14,292,4.382469636822413,278,Unchanged,10000,5
cspI,3,22,2.8744691179161412,19,Unchanged,10000,5
ynfN,1,10,3.321928094887362,9,Unchanged,10000,5
gnsB,61,6,-3.34577483684173,-55,Unchanged,10000,5
ydfO,32,10,-1.6780719051126376,-22,Unchanged,10000,5
nohA,28,429,3.9374789154419414,401,Unchanged,10000,5
stfQ,28,677,4.595657101517393,649,Unchanged,10000,5
tfaQ,19,372,4.291231297664446,353,Unchanged,10000,5
pinQ,37,337,3.1871514155529086,300,Unchanged,10000,5
ydfK,9,10,0.15200309344505006,1,Unchanged,10000,5
ydfI,132,1074,3.024384158626959,942,Unchanged,10000,5
ydfZ,11569,474,-4.609233296964281,-11095,Downregulated,10000,5
ydfH,1623,1352,-0.26356784826578716,-271,Unchanged,10000,5
ydfG,6165,2726,-1.1773153324849919,-3439,Unchanged,10000,5
dcp,6944,3189,-1.1226628501922185,-3755,Unchanged,10000,5
ydeJ,316,316,0.0,0,Unchanged,10000,5
ydeI,995,248,-2.004356405044136,-747,Unchanged,10000,5
dgcZ,1305,637,-1.0346845292009466,-668,Unchanged,10000,5
ydeE,258,884,1.7766753039681773,626,Unchanged,10000,5
eamA,480,823,0.7778580248131072,343,Unchanged,10000,5
marB,117,47,-1.3157758679057672,-70,Unchanged,10000,5
marA,345,273,-0.337695410745679,-72,Unchanged,10000,5
marR,345,380,0.13940305666541644,35,Unchanged,10000,5
marC,628,766,0.2865798330333302,138,Unchanged,10000,5
ydeA,837,1149,0.4570792700957695,312,Unchanged,10000,5
yneK,41,390,3.249778309131527,349,Unchanged,10000,5
yneJ,493,967,0.9719282430989297,474,Unchanged,10000,5
sad,844,1877,1.153113746123689,1033,Unchanged,10000,5
glsB,823,1337,0.7000351296717271,514,Unchanged,10000,5
yneG,117,276,1.2381597371947646,159,Unchanged,10000,5
dgcF,216,788,1.8671643172929078,572,Unchanged,10000,5
uxaB,245,1471,2.5859435922522596,1226,Unchanged,10000,5
yneE,302,639,1.0812673816219154,337,Unchanged,10000,5
tam,685,640,-0.09803208296052676,-45,Unchanged,10000,5
lsrG,37,132,1.8349407537295037,95,Unchanged,10000,5
lsrF,253,728,1.524801065504386,475,Unchanged,10000,5
lsrB,137,781,2.5111466551814527,644,Unchanged,10000,5
lsrD,104,785,2.916109125637897,681,Unchanged,10000,5
lsrC,109,969,3.152168530638155,860,Unchanged,10000,5
lsrA,213,1472,2.7888523358311748,1259,Unchanged,10000,5
lsrR,384,799,1.0570891922068204,415,Unchanged,10000,5
lsrK,456,1455,1.6739134236309046,999,Unchanged,10000,5
hipB,69,125,0.8572598278839181,56,Unchanged,10000,5
hipA,877,1411,0.686069240152531,534,Unchanged,10000,5
yneL,4,35,3.1292830169449664,31,Unchanged,10000,5
ydeT,116,866,2.9002422195991526,750,Unchanged,10000,5
ydeS,20,314,3.9726926540042644,294,Unchanged,10000,5
ydeR,21,273,3.700439718141092,252,Unchanged,10000,5
ydeQ,29,471,4.021602254485211,442,Unchanged,10000,5
ydeP,375,2104,2.488172203909059,1729,Unchanged,10000,5
safA,2,8,2.0,6,Unchanged,10000,5
ydeO,19,215,3.500265336145875,196,Unchanged,10000,5
ydeN,521,983,0.9159080440620724,462,Unchanged,10000,5
ydeM,76,431,2.503616545645513,355,Unchanged,10000,5
yddA,15,920,5.938599455335857,905,Unchanged,10000,5
yddB,139,1547,3.4763164087255283,1408,Unchanged,10000,5
pqqL,310,2170,2.807354922057604,1860,Unchanged,10000,5
gadB,196014,1537,-6.994695725052132,-194477,Downregulated,10000,5
gadC,146286,1329,-6.782306791089309,-144957,Downregulated,10000,5
digH,2243,1294,-0.7935920030937648,-949,Unchanged,10000,5
dosC,125,902,2.851199338593294,777,Unchanged,10000,5
dosP,196,2354,3.586188760923236,2158,Unchanged,10000,5
ddpX,9,439,5.608152128093046,430,Unchanged,10000,5
ddpA,124,1410,3.5072831368992805,1286,Unchanged,10000,5
ddpB,49,965,4.299675288040234,916,Unchanged,10000,5
ddpC,104,842,3.017236704925304,738,Unchanged,10000,5
ddpD,130,1089,3.0664204256884524,959,Unchanged,10000,5
ddpF,117,907,2.954594020945118,790,Unchanged,10000,5
osmC,15380,3259,-2.238554246110625,-12121,Downregulated,10000,5
bdm,228,119,-0.9380722508567982,-109,Unchanged,10000,5
sra,384,41,-3.2274104961030727,-343,Unchanged,10000,5
maeA,13004,5143,-1.3382734023378988,-7861,Unchanged,10000,5
adhP,787,1269,0.6892565283336195,482,Unchanged,10000,5
yddM,248,319,0.36321630337799427,71,Unchanged,10000,5
fdnI,220,621,1.4970897446958218,401,Unchanged,10000,5
fdnH,172,1049,2.6085342078751697,877,Unchanged,10000,5
fdnG,992,4205,2.0836937747556314,3213,Unchanged,10000,5
yddG,606,731,0.27055361247948656,125,Unchanged,10000,5
yddL,1,73,6.189824558880018,72,Unchanged,10000,5
yddK,2,67,5.066089190457772,65,Unchanged,10000,5
yddJ,2,38,4.247927513443585,36,Unchanged,10000,5
narU,284,1498,2.399074788954069,1214,Unchanged,10000,5
narZ,1449,5706,1.9774221520247903,4257,Unchanged,10000,5
narY,439,1852,2.076791253724878,1413,Unchanged,10000,5
narW,162,869,2.4233623639297757,707,Unchanged,10000,5
narV,184,848,2.204358498506186,664,Unchanged,10000,5
yddE,1129,1750,0.6323094359466903,621,Unchanged,10000,5
nhoA,87,1204,3.7906761809109737,1117,Unchanged,10000,5
yddH,151,650,2.105891168590738,499,Unchanged,10000,5
pptA,161,72,-1.1609918766723046,-89,Unchanged,10000,5
ydcC,27,882,5.029747343394052,855,Unchanged,10000,5
yncI,103,489,2.247190127769015,386,Unchanged,10000,5
ydcD,47,26,-0.8541491335365452,-21,Unchanged,10000,5
rhsE,164,2170,3.725927322713758,2006,Unchanged,10000,5
yncH,3,2,-0.5849625007211563,-1,Unchanged,10000,5
yncG,247,715,1.533432200081074,468,Unchanged,10000,5
ansP,470,2201,2.2274264833265573,1731,Unchanged,10000,5
yncE,157,1340,3.093396536453508,1183,Unchanged,10000,5
yncD,225,2948,3.7117396178780324,2723,Unchanged,10000,5
mcbR,117,563,2.266626392496825,446,Unchanged,10000,5
curA,1107,1406,0.34494137229098315,299,Unchanged,10000,5
mnaT,1256,998,-0.3317247435543665,-258,Unchanged,10000,5
ydcZ,302,369,0.28907226673531705,67,Unchanged,10000,5
ydcY,1480,368,-2.0078195044592992,-1112,Unchanged,10000,5
ortT,8,23,1.5235619560570128,15,Unchanged,10000,5
patD,401,1851,2.2066307534156535,1450,Unchanged,10000,5
ydcV,59,867,3.877245133859994,808,Unchanged,10000,5
ydcU,128,1114,3.1215335173400316,986,Unchanged,10000,5
ydcT,105,1204,3.5193741590935796,1099,Unchanged,10000,5
ydcS,238,1403,2.5594815303119556,1165,Unchanged,10000,5
ydcR,829,1904,1.199589471812193,1075,Unchanged,10000,5
hicB,319,255,-0.32305917690601155,-64,Unchanged,10000,5
yncJ,27,107,1.9865794842376783,80,Unchanged,10000,5
rlhA,2155,2709,0.330072524225554,554,Unchanged,10000,5
sutR,158,492,1.638733757162137,334,Unchanged,10000,5
ydcO,113,1274,3.4949705998411127,1161,Unchanged,10000,5
insQ,2129,1555,-0.45326136943432904,-574,Unchanged,10000,5
ydcL,407,456,0.16400502989849455,49,Unchanged,10000,5
tehB,1310,581,-1.1729567430202839,-729,Unchanged,10000,5
tehA,539,1460,1.4376111910148741,921,Unchanged,10000,5
ydcK,465,938,1.0123572065199826,473,Unchanged,10000,5
rimL,682,610,-0.16096249657392386,-72,Unchanged,10000,5
ydcH,605,135,-2.163975735111126,-470,Unchanged,10000,5
opgD,2569,1982,-0.37424992771432875,-587,Unchanged,10000,5
ydcJ,377,1726,2.194796035910291,1349,Unchanged,10000,5
ydcI,125,943,2.9153296760130094,818,Unchanged,10000,5
trg,288,1891,2.715008646507449,1603,Unchanged,10000,5
mokB,21,28,0.41503749927884376,7,Unchanged,10000,5
ydcA,97,42,-1.2075954194083673,-55,Unchanged,10000,5
cybB,725,607,-0.25628447864661474,-118,Unchanged,10000,5
aldA,664,2236,1.7516650414962653,1572,Unchanged,10000,5
ydcF,3467,1345,-1.3660816637588469,-2122,Unchanged,10000,5
hrpA,5991,8892,0.5697111148618612,2901,Unchanged,10000,5
azoR,730,684,-0.09390013888148166,-46,Unchanged,10000,5
ynbD,320,1442,2.17192735435346,1122,Unchanged,10000,5
ynbC,313,2018,2.6886916121737388,1705,Unchanged,10000,5
ynbB,10,790,6.303780748177103,780,Unchanged,10000,5
ynbA,9,490,5.766712937560258,481,Unchanged,10000,5
ydbD,127,1902,3.9046168440883977,1775,Unchanged,10000,5
pdxI,624,1354,1.1176098047127483,730,Unchanged,10000,5
insI2,24,14,-0.777607578663552,-10,Unchanged,10000,5
insC2,441,166,-1.4095954142105958,-275,Unchanged,10000,5
insD2,189,1633,3.1110666513406224,1444,Unchanged,10000,5
paaY,519,990,0.9316939866090912,471,Unchanged,10000,5
paaX,1037,1845,0.8312049221345328,808,Unchanged,10000,5
paaK,236,2047,3.116652337661569,1811,Unchanged,10000,5
paaJ,211,2121,3.3294297168233697,1910,Unchanged,10000,5
paaI,44,434,3.302119613807182,390,Unchanged,10000,5
paaH,179,2266,3.6621163685562594,2087,Unchanged,10000,5
paaG,39,1114,4.836131298477784,1075,Unchanged,10000,5
paaF,43,1170,4.766028059768669,1127,Unchanged,10000,5
paaE,92,1689,4.198391656744373,1597,Unchanged,10000,5
paaD,23,592,4.685891409571937,569,Unchanged,10000,5
paaC,12,1118,6.541741972122034,1106,Unchanged,10000,5
paaB,4,325,6.344295907915817,321,Unchanged,10000,5
paaA,8,1296,7.339850002884624,1288,Unchanged,10000,5
paaZ,61,3063,5.649992314036071,3002,Unchanged,10000,5
tynA,272,3119,3.5194049961238125,2847,Unchanged,10000,5
feaB,433,2687,2.633557391286441,2254,Unchanged,10000,5
feaR,78,1040,3.736965594166206,962,Unchanged,10000,5
ydbL,94,278,1.5643522210458702,184,Unchanged,10000,5
ynbE,8,31,1.9541963103868751,23,Unchanged,10000,5
ydbH,2187,4757,1.1210988049143613,2570,Unchanged,10000,5
ldhA,1,3,1.584962500721156,2,Unchanged,10000,5
hslJ,1511,696,-1.1183444493161008,-815,Unchanged,10000,5
ydbK,6758,7839,0.21407327487737546,1081,Unchanged,10000,5
ompN,37,1344,5.182864057149811,1307,Unchanged,10000,5
uspF,2875,736,-1.965784284662087,-2139,Unchanged,10000,5
ynaE,13,22,0.7589919004962051,9,Unchanged,10000,5
pinR,38,636,4.06495544184077,598,Unchanged,10000,5
tfaR,85,855,3.3303896736355583,770,Unchanged,10000,5
stfR,294,6096,4.373974842656958,5802,Unchanged,10000,5
insH5,215,367,0.7714434032537526,152,Unchanged,10000,5
ynaA,158,1057,2.74197891320558,899,Unchanged,10000,5
ydaY,19,410,4.43155258606186,391,Unchanged,10000,5
ynaK,15,181,3.592955291474687,166,Unchanged,10000,5
trkG,593,823,0.4728603258756221,230,Unchanged,10000,5
rzpR,17,452,4.732716121164849,435,Unchanged,10000,5
ydaW,51,575,3.4949928038602422,524,Unchanged,10000,5
ydaV,38,1217,5.001185939270143,1179,Unchanged,10000,5
ydaU,53,882,4.056714390994321,829,Unchanged,10000,5
ydaT,21,424,4.335603031784439,403,Unchanged,10000,5
ydaS,12,111,3.2094533656289497,99,Unchanged,10000,5
racR,1145,466,-1.296945738330026,-679,Unchanged,10000,5
ydaG,1,6,2.584962500721156,5,Unchanged,10000,5
sieB,124,171,0.4636562044990228,47,Unchanged,10000,5
kilR,1,27,4.754887502163468,26,Unchanged,10000,5
racC,2,70,5.129283016944966,68,Unchanged,10000,5
recE,127,3621,4.833487774704012,3494,Unchanged,10000,5
recT,147,841,2.5162896454187798,694,Unchanged,10000,5
ralR,2,28,3.807354922057604,26,Unchanged,10000,5
rcbA,3,15,2.321928094887362,12,Unchanged,10000,5
xisR,1,45,5.491853096329675,44,Unchanged,10000,5
intR,85,1006,3.5650236536678253,921,Unchanged,10000,5
ttcA,1511,1296,-0.2214379422802043,-215,Unchanged,10000,5
dbpA,1226,1940,0.6620976733837085,714,Unchanged,10000,5
zntB,1530,1780,0.2183455882737461,250,Unchanged,10000,5
dgcM,564,1238,1.134244246815471,674,Unchanged,10000,5
smrA,916,943,0.041910172578152605,27,Unchanged,10000,5
abgR,190,914,2.266194746727122,724,Unchanged,10000,5
abgA,55,1664,4.919080004616433,1609,Unchanged,10000,5
abgB,104,1982,4.252301529045396,1878,Unchanged,10000,5
abgT,116,1859,4.002330059791909,1743,Unchanged,10000,5
ogt,310,656,1.0814275993438462,346,Unchanged,10000,5
fnr,5164,3184,-0.6976486647635418,-1980,Unchanged,10000,5
uspE,9296,3253,-1.5148392463633968,-6043,Unchanged,10000,5
ynaJ,463,205,-1.1753882837547904,-258,Unchanged,10000,5
insH4,2431,3950,0.7003027599230988,1519,Unchanged,10000,5
ynaI,2268,1205,-0.9123874938249048,-1063,Unchanged,10000,5
mppA,1034,2278,1.1395315613931771,1244,Unchanged,10000,5
pgrR,531,962,0.8573250329658884,431,Unchanged,10000,5
ycjY,243,995,2.03374021182523,752,Unchanged,10000,5
mpaA,1099,1275,0.2143058607969892,176,Unchanged,10000,5
ycjG,965,1995,1.0477878989542653,1030,Unchanged,10000,5
tpx,5110,3004,-0.7664384783107119,-2106,Unchanged,10000,5
tyrR,3765,4109,0.1261374656083659,344,Unchanged,10000,5
ycjF,1053,2524,1.261206473956832,1471,Unchanged,10000,5
ycjX,1446,2784,0.9450916588976105,1338,Unchanged,10000,5
ycjW,963,1342,0.47877696835672423,379,Unchanged,10000,5
ompG,27,1412,5.708636871107712,1385,Unchanged,10000,5
ycjU,4,1343,8.391243589427443,1339,Unchanged,10000,5
ycjT,176,5304,4.9134334414752905,5128,Unchanged,10000,5
ycjS,120,2054,4.097329870709677,1934,Unchanged,10000,5
ycjR,60,973,4.019405399172593,913,Unchanged,10000,5
ycjQ,103,2082,4.337253826116199,1979,Unchanged,10000,5
ycjP,47,1764,5.230045993879883,1717,Unchanged,10000,5
ycjO,38,1420,5.223747700948459,1382,Unchanged,10000,5
ycjN,58,2498,5.4285767664803855,2440,Unchanged,10000,5
ycjM,92,2275,4.6280888739164086,2183,Unchanged,10000,5
pspE,2218,2399,0.11317379213172468,181,Unchanged,10000,5
pspD,430,785,0.868355994189529,355,Unchanged,10000,5
pspC,2288,2807,0.29494201173413503,519,Unchanged,10000,5
pspB,792,867,0.13053156314222542,75,Unchanged,10000,5
pspA,15001,18263,0.2838650941409044,3262,Unchanged,10000,5
pspF,596,2843,2.254029863215366,2247,Unchanged,10000,5
puuE,93,3444,5.210710616288813,3351,Unchanged,10000,5
puuB,76,2784,5.195015982405143,2708,Unchanged,10000,5
puuC,171,3570,4.383855844030564,3399,Unchanged,10000,5
puuR,311,849,1.448849973422436,538,Unchanged,10000,5
puuD,89,1508,4.082687282302267,1419,Unchanged,10000,5
puuA,149,2326,3.964466861011057,2177,Unchanged,10000,5
puuP,70,2208,4.979241439833203,2138,Unchanged,10000,5
ymjA,251,188,-0.41695470227313464,-63,Unchanged,10000,5
sapA,2278,3838,0.7525869644872685,1560,Unchanged,10000,5
sapB,839,1898,1.177737276581286,1059,Unchanged,10000,5
sapC,546,1818,1.7353793432742548,1272,Unchanged,10000,5
sapD,1390,2021,0.5399844387688656,631,Unchanged,10000,5
sapF,661,1193,0.8518718661875364,532,Unchanged,10000,5
ycjD,76,363,2.255898224552165,287,Unchanged,10000,5
fabI,17639,4454,-1.9855953099056673,-13185,Downregulated,10000,5
yciW,207,2074,3.3247132213139006,1867,Unchanged,10000,5
rnb,12315,5798,-1.0867893893249263,-6517,Unchanged,10000,5
pdeR,1106,2600,1.23316023768111,1494,Unchanged,10000,5
yciT,1665,1086,-0.6164980741542629,-579,Unchanged,10000,5
osmB,2245,259,-3.1156914419419555,-1986,Unchanged,10000,5
yciH,444,235,-0.9178989197851062,-209,Unchanged,10000,5
pyrF,3520,1514,-1.217210223538928,-2006,Unchanged,10000,5
lapB,2581,3383,0.3903730357000183,802,Unchanged,10000,5
lapA,1009,617,-0.7095837799569394,-392,Unchanged,10000,5
pgpB,770,1196,0.6352870386158413,426,Unchanged,10000,5
ribA,1494,1027,-0.5407439664710421,-467,Unchanged,10000,5
acnA,3775,7988,1.081357688344169,4213,Unchanged,10000,5
cysB,1645,1663,0.01570058466466533,18,Unchanged,10000,5
topA,17377,7770,-1.1611925301497397,-9607,Unchanged,10000,5
yciN,702,230,-1.6098371693601854,-472,Unchanged,10000,5
sohB,3009,2016,-0.5777884678334203,-993,Unchanged,10000,5
yciK,1581,1162,-0.44422729895384194,-419,Unchanged,10000,5
btuR,759,692,-0.13332784777874168,-67,Unchanged,10000,5
rluB,1853,1966,0.08540044031331483,113,Unchanged,10000,5
yciQ,402,2066,2.361572847686131,1664,Unchanged,10000,5
yciO,1248,972,-0.36058971525646744,-276,Unchanged,10000,5
yciV,1408,1390,-0.01856245102642752,-18,Unchanged,10000,5
trpL,1,1,0.0,0,Unchanged,10000,5
trpE,447,3005,2.74901825441523,2558,Unchanged,10000,5
trpD,486,2912,2.5829821365929155,2426,Unchanged,10000,5
trpC,695,2552,1.8765434461539996,1857,Unchanged,10000,5
trpB,1220,2652,1.1201996276623392,1432,Unchanged,10000,5
trpA,961,1512,0.6538498034473221,551,Unchanged,10000,5
yciG,49,48,-0.029747343394052068,-1,Unchanged,10000,5
yciF,394,377,-0.06363110618771194,-17,Unchanged,10000,5
yciE,421,242,-0.7988131857918015,-179,Unchanged,10000,5
ompW,148,832,2.4909863525121425,684,Unchanged,10000,5
yciC,1653,1078,-0.6167295465398084,-575,Unchanged,10000,5
yciB,1086,695,-0.6439392201934918,-391,Unchanged,10000,5
yciA,606,359,-0.7553339496498995,-247,Unchanged,10000,5
tonB,291,1147,1.9787743331075411,856,Unchanged,10000,5
yciI,2138,267,-3.001350206032937,-1871,Unchanged,10000,5
kch,1565,1134,-0.46474201687775174,-431,Unchanged,10000,5
clsA,2828,2905,0.038756043482492404,77,Unchanged,10000,5
yciU,565,324,-0.8022570544179252,-241,Unchanged,10000,5
oppF,19319,10416,-0.8912190649685247,-8903,Unchanged,10000,5
oppD,19341,11709,-0.724044520709988,-7632,Unchanged,10000,5
oppC,14520,9481,-0.614930314102267,-5039,Unchanged,10000,5
oppB,12135,8750,-0.47181918643144266,-3385,Unchanged,10000,5
oppA,137677,44347,-1.6343791492722417,-93330,Downregulated,10000,5
ychE,552,998,0.8543715485590915,446,Unchanged,10000,5
adhE,309420,108494,-1.5119511912780845,-200926,Downregulated,10000,5
tdk,659,403,-0.7094986264800844,-256,Unchanged,10000,5
hns,19492,1620,-3.5888164094203283,-17872,Downregulated,10000,5
galU,9254,2068,-2.161840913250361,-7186,Unchanged,10000,5
rssB,1397,1426,0.029641961034424947,29,Unchanged,10000,5
rssA,1569,1533,-0.03348765530932006,-36,Unchanged,10000,5
ychJ,1019,599,-0.7665261433770281,-420,Unchanged,10000,5
purU,5913,2151,-1.458882752341581,-3762,Unchanged,10000,5
tpr,1,3,1.584962500721156,2,Unchanged,10000,5
narI,4057,1259,-1.6881350194872562,-2798,Unchanged,10000,5
narJ,3377,1367,-1.3047289364014167,-2010,Unchanged,10000,5
narH,10284,3365,-1.6117231053359766,-6919,Unchanged,10000,5
narG,32374,9038,-1.840760167980422,-23336,Downregulated,10000,5
narK,2637,2262,-0.22129864187473972,-375,Unchanged,10000,5
narX,1510,2975,0.9783411188702269,1465,Unchanged,10000,5
narL,2927,1446,-1.0173551934576328,-1481,Unchanged,10000,5
ychO,668,2328,1.8011710504342318,1660,Unchanged,10000,5
ychN,1650,693,-1.2515387669959646,-957,Unchanged,10000,5
chaC,782,994,0.3460772442549339,212,Unchanged,10000,5
chaB,163,124,-0.39453184384420226,-39,Unchanged,10000,5
chaA,752,1871,1.3150049915631468,1119,Unchanged,10000,5
kdsA,5904,2643,-1.1595162964188261,-3261,Unchanged,10000,5
ychA,1692,1370,-0.3045536752720607,-322,Unchanged,10000,5
ychQ,97,337,1.796691938994731,240,Unchanged,10000,5
prmC,630,1378,1.1291521543170124,748,Unchanged,10000,5
prfA,1895,1827,-0.052721214430965446,-68,Unchanged,10000,5
hemA,3806,2947,-0.36902850115002167,-859,Unchanged,10000,5
lolB,2723,1389,-0.9711503830624035,-1334,Unchanged,10000,5
ispE,3312,1785,-0.8917785985828631,-1527,Unchanged,10000,5
prs,49915,6529,-2.9345394796826705,-43386,Downregulated,10000,5
dauA,3378,3270,-0.04687869241594091,-108,Unchanged,10000,5
ychH,1684,846,-0.9931625699464464,-838,Unchanged,10000,5
pth,1487,722,-1.0423339051652476,-765,Unchanged,10000,5
ychF,4157,2428,-0.7757743263686903,-1729,Unchanged,10000,5
ycgV,1025,3310,1.6912073073017717,2285,Unchanged,10000,5
dhaR,704,2359,1.7445280846021654,1655,Unchanged,10000,5
dhaK,9338,4852,-0.9445340381216788,-4486,Unchanged,10000,5
dhaL,4879,2234,-1.1269562974427123,-2645,Unchanged,10000,5
dhaM,10626,4924,-1.109695950988613,-5702,Unchanged,10000,5
treA,1261,2158,0.775126589159797,897,Unchanged,10000,5
ycgY,23,223,3.2773379438632917,200,Unchanged,10000,5
ymgE,116,156,0.4274212237346762,40,Unchanged,10000,5
ycgR,59,867,3.877245133859994,808,Unchanged,10000,5
emtA,1523,729,-1.0629252221603551,-794,Unchanged,10000,5
ldcA,1018,1445,0.505331931312346,427,Unchanged,10000,5
cvrA,1648,2647,0.6836419523121802,999,Unchanged,10000,5
dadX,727,1607,1.1443426597554995,880,Unchanged,10000,5
dadA,1547,2592,0.7445925214355891,1045,Unchanged,10000,5
ycgB,1043,1553,0.5743186718675356,510,Unchanged,10000,5
fadR,1069,995,-0.10349342228947936,-74,Unchanged,10000,5
nhaB,2823,2726,-0.05044356664448337,-97,Unchanged,10000,5
dsbB,1210,749,-0.6919694237032059,-461,Unchanged,10000,5
umuC,330,1658,2.328906077249935,1328,Unchanged,10000,5
umuD,259,292,0.1730162711934633,33,Unchanged,10000,5
hlyE,500,536,0.10030490579568548,36,Unchanged,10000,5
ycgN,568,458,-0.31054333140773804,-110,Unchanged,10000,5
ycgM,1868,841,-1.1513167494545176,-1027,Unchanged,10000,5
ycgL,1140,307,-1.8927232636819247,-833,Unchanged,10000,5
pliG,753,330,-1.1901838404261125,-423,Unchanged,10000,5
ycgJ,283,188,-0.5900693911542451,-95,Unchanged,10000,5
minC,5471,1875,-1.5449139601119741,-3596,Unchanged,10000,5
minD,10017,2326,-2.1065274973110535,-7691,Unchanged,10000,5
minE,1105,154,-2.8430441135838924,-951,Unchanged,10000,5
ymgG,2792,521,-2.421943663931144,-2271,Unchanged,10000,5
ymgD,4200,527,-2.9945144609162706,-3673,Unchanged,10000,5
pdeG,39,1012,4.697591355832062,973,Unchanged,10000,5
ymgC,1,16,4.0,15,Unchanged,10000,5
ariR,4,20,2.321928094887362,16,Unchanged,10000,5
ymgA,14,70,2.321928094887362,56,Unchanged,10000,5
ycgZ,12,93,2.9541963103868754,81,Unchanged,10000,5
bluF,89,724,3.0241124561168076,635,Unchanged,10000,5
bluR,790,774,-0.029519086920054966,-16,Unchanged,10000,5
ycgX,43,95,1.14359085362885,52,Unchanged,10000,5
iraM,20,12,-0.7369655941662062,-8,Unchanged,10000,5
mcrA,310,312,0.00927781358801065,2,Unchanged,10000,5
pinE,11,477,5.4384138373682145,466,Unchanged,10000,5
stfE,6,238,5.309855262586788,232,Unchanged,10000,5
tfaE,22,367,4.060204634205916,345,Unchanged,10000,5
tfaP,20,100,2.321928094887362,80,Unchanged,10000,5
ycfK,16,424,4.727920454563199,408,Unchanged,10000,5
ymfQ,13,575,5.466978427690646,562,Unchanged,10000,5
jayE,48,667,3.796580450463429,619,Unchanged,10000,5
beeE,27,319,3.562525111601401,292,Unchanged,10000,5
ymfR,2,55,4.78135971352466,53,Unchanged,10000,5
ymfM,33,267,3.0163018123291008,234,Unchanged,10000,5
ymfL,69,438,2.666262602823004,369,Unchanged,10000,5
ymfT,10,37,1.8875252707415875,27,Unchanged,10000,5
ymfK,716,489,-0.5501251223120228,-227,Unchanged,10000,5
ymfJ,44,184,2.0641303374197157,140,Unchanged,10000,5
ymfI,474,126,-1.9114633253983428,-348,Unchanged,10000,5
xisE,23,91,1.9842326841416833,68,Unchanged,10000,5
intE,215,887,2.0445974447116035,672,Unchanged,10000,5
lit,1333,669,-0.9945986644475123,-664,Unchanged,10000,5
ymfE,310,184,-0.7525624492172248,-126,Unchanged,10000,5
ymfD,123,188,0.6120743463383976,65,Unchanged,10000,5
icd,15230,10430,-0.5461767839675266,-4800,Unchanged,10000,5
rluE,640,966,0.5939512839484107,326,Unchanged,10000,5
nudJ,504,685,0.44268025434797265,181,Unchanged,10000,5
mnmA,4975,3828,-0.37810569583234804,-1147,Unchanged,10000,5
hflD,1842,1528,-0.2696285180555868,-314,Unchanged,10000,5
purB,11656,5235,-1.1548113402463418,-6421,Unchanged,10000,5
phoP,4041,1957,-1.0460685955566553,-2084,Unchanged,10000,5
phoQ,3668,3544,-0.049615035040036094,-124,Unchanged,10000,5
roxA,5382,3228,-0.737501812362637,-2154,Unchanged,10000,5
pepT,7856,2870,-1.452744192751643,-4986,Unchanged,10000,5
potA,1398,2112,0.5952454739830171,714,Unchanged,10000,5
potB,497,1040,1.0652657714661684,543,Unchanged,10000,5
potC,524,981,0.9046863246817884,457,Unchanged,10000,5
potD,3991,2167,-0.8810511254175981,-1824,Unchanged,10000,5
ymfA,25,331,3.726831217032493,306,Unchanged,10000,5
ycfZ,16,513,5.002815015607054,497,Unchanged,10000,5
cobB,2059,1628,-0.3388431303660072,-431,Unchanged,10000,5
nagK,1770,1892,0.09616272836903554,122,Unchanged,10000,5
lolE,1665,2640,0.6650157522871913,975,Unchanged,10000,5
lolD,730,1559,1.0946525589304053,829,Unchanged,10000,5
lolC,932,2228,1.2573473726857516,1296,Unchanged,10000,5
ycfT,92,1180,3.6810091881921907,1088,Unchanged,10000,5
mfd,9569,9917,0.0515355907211584,348,Unchanged,10000,5
ldtC,113,1452,3.683646775580563,1339,Unchanged,10000,5
bhsA,272,1060,1.962385708200222,788,Unchanged,10000,5
comR,320,957,1.5804470195986633,637,Unchanged,10000,5
ycfJ,2616,1481,-0.8207909002092348,-1135,Unchanged,10000,5
ndh,344,2117,2.621540799305491,1773,Unchanged,10000,5
ycfP,4143,1870,-1.147637550204208,-2273,Unchanged,10000,5
nagZ,2421,2115,-0.19494541599162438,-306,Unchanged,10000,5
thiK,1191,1306,0.13298148368231688,115,Unchanged,10000,5
lpoB,6500,1840,-1.8207339518588042,-4660,Unchanged,10000,5
ycfL,3788,660,-2.5208984012225693,-3128,Unchanged,10000,5
hinT,2215,717,-1.6272616747404758,-1498,Unchanged,10000,5
fhuE,179,3044,4.087936866239289,2865,Unchanged,10000,5
ptsG,40519,13391,-1.5973348683281345,-27128,Downregulated,10000,5
ycfH,1022,1136,0.15256763856706065,114,Unchanged,10000,5
holB,1198,2101,0.8104482538842603,903,Unchanged,10000,5
tmk,837,1353,0.6928623114261934,516,Unchanged,10000,5
mltG,863,1745,1.0157945719180597,882,Unchanged,10000,5
pabC,698,1272,0.865799729074703,574,Unchanged,10000,5
fabF,19103,5762,-1.7291576561718742,-13341,Downregulated,10000,5
acpP,10587,1385,-2.9343359545643297,-9202,Unchanged,10000,5
fabG,18276,3711,-2.3000704415109223,-14565,Downregulated,10000,5
fabD,11227,3515,-1.6753758780002472,-7712,Unchanged,10000,5
fabH,5416,3740,-0.5341894687999977,-1676,Unchanged,10000,5
plsX,4789,3040,-0.6556531119050533,-1749,Unchanged,10000,5
rpmF,1189,227,-2.3889845124547406,-962,Unchanged,10000,5
yceD,13505,3007,-2.1670968668223263,-10498,Downregulated,10000,5
yceF,1923,1187,-0.6960388276979906,-736,Unchanged,10000,5
rluC,2826,1957,-0.5301177097071355,-869,Unchanged,10000,5
yceQ,20,211,3.399171093819823,191,Unchanged,10000,5
rne,18565,14960,-0.31147513996710374,-3605,Unchanged,10000,5
flgL,901,1871,1.0542105474272454,970,Unchanged,10000,5
flgK,870,3114,1.8396816383429462,2244,Unchanged,10000,5
flgJ,445,1679,1.91572498908327,1234,Unchanged,10000,5
flgI,756,2196,1.538419914784126,1440,Unchanged,10000,5
flgH,689,1203,0.8040607544717852,514,Unchanged,10000,5
flgG,2137,1575,-0.4402350793851699,-562,Unchanged,10000,5
flgF,2175,1749,-0.31448511170180043,-426,Unchanged,10000,5
flgE,4559,2179,-1.065051212748858,-2380,Unchanged,10000,5
flgD,2647,1170,-1.1778496650246317,-1477,Unchanged,10000,5
flgC,1173,455,-1.36626456294245,-718,Unchanged,10000,5
flgB,1528,545,-1.4873164083714598,-983,Unchanged,10000,5
flgA,978,906,-0.11032341490599867,-72,Unchanged,10000,5
flgM,296,325,0.13484254228686715,29,Unchanged,10000,5
flgN,360,428,0.24961389007147222,68,Unchanged,10000,5
murJ,456,2851,2.644362309773211,2395,Unchanged,10000,5
yceM,1690,1981,0.2292056337199397,291,Unchanged,10000,5
yceH,1595,1226,-0.37959744496145026,-369,Unchanged,10000,5
rimJ,1083,1019,-0.08787919144251333,-64,Unchanged,10000,5
mdtH,180,1996,3.471042909007586,1816,Unchanged,10000,5
grxB,9658,3604,-1.422125452359117,-6054,Unchanged,10000,5
yceB,2884,1121,-1.3632848864353957,-1763,Unchanged,10000,5
pyrC,18327,1994,-3.2002333314032056,-16333,Downregulated,10000,5
dinI,1134,222,-2.3527890585921227,-912,Unchanged,10000,5
bssS,560,174,-1.6863395210962382,-386,Unchanged,10000,5
solA,2910,2255,-0.36789171965290285,-655,Unchanged,10000,5
yceO,4,5,0.32192809488736235,1,Unchanged,10000,5
yceJ,23,574,4.6413449706186745,551,Unchanged,10000,5
yceI,120,606,2.3362833878644325,486,Unchanged,10000,5
trhO,392,1377,1.812603000019756,985,Unchanged,10000,5
lpxL,1470,2069,0.49311749013628287,599,Unchanged,10000,5
mdtG,254,1616,2.6695267959796287,1362,Unchanged,10000,5
msyB,1443,353,-2.0313312112200177,-1090,Unchanged,10000,5
yceK,152,139,-0.12898644072007803,-13,Unchanged,10000,5
opgH,7957,6686,-0.25108124403954035,-1271,Unchanged,10000,5
opgG,10984,4937,-1.1536969804060038,-6047,Unchanged,10000,5
opgC,246,1016,2.046170181432926,770,Unchanged,10000,5
clsC,1044,2250,1.1078032895345151,1206,Unchanged,10000,5
ymdB,428,591,0.4655473337763855,163,Unchanged,10000,5
ymdA,66,241,1.868495216871508,175,Unchanged,10000,5
csgC,10,153,3.9354597478052895,143,Unchanged,10000,5
csgA,338,470,0.4756375102828154,132,Unchanged,10000,5
csgB,12,181,3.914883386362049,169,Unchanged,10000,5
csgD,125,394,1.6562675347942892,269,Unchanged,10000,5
csgE,18,157,3.1246957474493144,139,Unchanged,10000,5
csgF,16,249,3.960001932068081,233,Unchanged,10000,5
csgG,166,1174,2.8221772617631276,1008,Unchanged,10000,5
ycdZ,596,750,0.33157826492108156,154,Unchanged,10000,5
ycdY,1768,1062,-0.735334508587278,-706,Unchanged,10000,5
ycdX,3393,1942,-0.8050182292917843,-1451,Unchanged,10000,5
ghrA,3850,3169,-0.28083078608739237,-681,Unchanged,10000,5
ycdU,19,889,5.548112095386185,870,Unchanged,10000,5
ymdE,3,111,5.20945336562895,108,Unchanged,10000,5
insE4,99,112,0.17799830197799443,13,Unchanged,10000,5
insF4,24,606,4.658211482751795,582,Unchanged,10000,5
dgcT,939,1005,0.09799843841251649,66,Unchanged,10000,5
pgaA,2502,3834,0.6157685475023308,1332,Unchanged,10000,5
pgaB,1215,2453,1.0135909200644588,1238,Unchanged,10000,5
pgaC,838,1786,1.0917099314218714,948,Unchanged,10000,5
pgaD,207,334,0.690217334974727,127,Unchanged,10000,5
phoH,67,1740,4.6987824002783185,1673,Unchanged,10000,5
efeB,142,2756,4.278613053199609,2614,Unchanged,10000,5
efeO,80,2367,4.8869158958472525,2287,Unchanged,10000,5
putP,897,3399,1.9219304716224106,2502,Unchanged,10000,5
putA,510,10181,4.319238215713851,9671,Unchanged,10000,5
rutR,426,1339,1.6522306250984724,913,Unchanged,10000,5
rutA,14,2489,7.473995592923432,2475,Unchanged,10000,5
rutB,19,1458,6.261847490883352,1439,Unchanged,10000,5
rutC,8,493,5.945443836377912,485,Unchanged,10000,5
rutD,27,1888,6.1277555471983725,1861,Unchanged,10000,5
rutE,21,1117,5.733096047704555,1096,Unchanged,10000,5
rutF,18,865,5.586631321081775,847,Unchanged,10000,5
rutG,202,2970,3.8780357329363335,2768,Unchanged,10000,5
wrbA,8996,2543,-1.8227521990877107,-6453,Unchanged,10000,5
yccJ,2763,528,-2.3876257274540382,-2235,Unchanged,10000,5
agp,2559,3336,0.38253914140521716,777,Unchanged,10000,5
yccE,76,289,1.9269981690570934,213,Unchanged,10000,5
cbpA,11798,2480,-2.2501302885543626,-9318,Unchanged,10000,5
cbpM,2625,546,-2.265344566520995,-2079,Unchanged,10000,5
torD,6279,2503,-1.3268765212885334,-3776,Unchanged,10000,5
torA,54276,16650,-1.7047922245065805,-37626,Downregulated,10000,5
torC,17968,4504,-1.9961511003203716,-13464,Downregulated,10000,5
torR,540,1436,1.4110244367722204,896,Unchanged,10000,5
torT,516,2121,2.039301650107301,1605,Unchanged,10000,5
torS,859,6052,2.816681951078274,5193,Unchanged,10000,5
yccM,233,1706,2.87221578666401,1473,Unchanged,10000,5
ymcE,1,39,5.285402218862249,38,Unchanged,10000,5
cspG,21,106,2.335603031784439,85,Unchanged,10000,5
cspH,2,103,5.6865005271832185,101,Unchanged,10000,5
insB4,177,924,2.3841434913330604,747,Unchanged,10000,5
gfcA,51,291,2.5124500009367883,240,Unchanged,10000,5
gfcB,26,667,4.681103233043493,641,Unchanged,10000,5
gfcC,37,1072,4.856635824828823,1035,Unchanged,10000,5
gfcD,132,3691,4.805401902887155,3559,Unchanged,10000,5
gfcE,118,1885,3.9977057587941855,1767,Unchanged,10000,5
etp,62,444,2.840219555963231,382,Unchanged,10000,5
etk,886,4143,2.2252972164241887,3257,Unchanged,10000,5
appA,2363,2466,0.06155317042899224,103,Unchanged,10000,5
appB,3375,2654,-0.3467191314553622,-721,Unchanged,10000,5
appC,4239,3418,-0.31057156937895625,-821,Unchanged,10000,5
hyaF,2995,1647,-0.8627154479497933,-1348,Unchanged,10000,5
hyaE,1064,691,-0.622740535112931,-373,Unchanged,10000,5
hyaD,3274,1419,-1.2061797324136019,-1855,Unchanged,10000,5
hyaC,2700,1413,-0.934197941604254,-1287,Unchanged,10000,5
hyaB,5664,4366,-0.37550913509220635,-1298,Unchanged,10000,5
hyaA,4584,2836,-0.6927495115173888,-1748,Unchanged,10000,5
yccA,4779,2897,-0.7221490829760625,-1882,Unchanged,10000,5
tusE,572,379,-0.5938172986072977,-193,Unchanged,10000,5
yccX,84,235,1.4841995237862393,151,Unchanged,10000,5
rlmI,2482,2324,-0.09489304672582782,-158,Unchanged,10000,5
hspQ,1831,1012,-0.8554225011030269,-819,Unchanged,10000,5
yccU,1754,893,-0.9739166673235102,-861,Unchanged,10000,5
yccT,122,1112,3.1882037351606214,990,Unchanged,10000,5
mgsA,2306,1255,-0.8777051488136377,-1051,Unchanged,10000,5
helD,4108,5220,0.34561362513905175,1112,Unchanged,10000,5
yccF,698,628,-0.15246247731802526,-70,Unchanged,10000,5
yccS,1818,3991,1.1343980793171646,2173,Unchanged,10000,5
sxy,419,915,1.1268214994720533,496,Unchanged,10000,5
sulA,2741,985,-1.4765066984820365,-1756,Unchanged,10000,5
ompA,206754,45709,-2.1773650792051917,-161045,Downregulated,10000,5
matP,515,603,0.22758556982950404,88,Unchanged,10000,5
ycbZ,1931,3540,0.8744011960197096,1609,Unchanged,10000,5
fabA,2426,1815,-0.41861000223739725,-611,Unchanged,10000,5
rmf,19615,7006,-1.485294442162395,-12609,Downregulated,10000,5
pqiC,610,825,0.43558487668292956,215,Unchanged,10000,5
pqiB,1559,2700,0.7923384792404085,1141,Unchanged,10000,5
pqiA,542,1941,1.8404353613597921,1399,Unchanged,10000,5
uup,3146,4285,0.4457765335841755,1139,Unchanged,10000,5
rlmL,3709,4931,0.41084998499810926,1222,Unchanged,10000,5
ycbX,752,1959,1.3813128305899496,1207,Unchanged,10000,5
zapC,1360,927,-0.5529654075121709,-433,Unchanged,10000,5
pyrD,20107,1467,-3.7767570689213334,-18640,Downregulated,10000,5
ycbF,119,638,2.422594850456926,519,Unchanged,10000,5
ycbV,62,596,3.2649722100752863,534,Unchanged,10000,5
ycbU,35,429,3.615550820554579,394,Unchanged,10000,5
elfG,161,1108,2.782825287934571,947,Unchanged,10000,5
elfC,175,3411,4.2847679277810755,3236,Unchanged,10000,5
elfD,15,502,5.064652958342253,487,Unchanged,10000,5
elfA,176,372,1.0797271924707341,196,Unchanged,10000,5
ssuE,12,733,5.932706887412656,721,Unchanged,10000,5
ssuA,32,1397,5.448116305409463,1365,Unchanged,10000,5
ssuD,83,1896,4.513703817551335,1813,Unchanged,10000,5
ssuC,44,1243,4.820178962415188,1199,Unchanged,10000,5
ssuB,152,1146,2.9144638153133196,994,Unchanged,10000,5
pepN,6759,6278,-0.10650478537446889,-481,Unchanged,10000,5
pncB,13139,4036,-1.702857397782121,-9103,Unchanged,10000,5
asnS,17274,8045,-1.1024378686737821,-9229,Unchanged,10000,5
ompF,11716,2336,-2.3263679189993494,-9380,Unchanged,10000,5
aspC,14428,5594,-1.3669191693113787,-8834,Unchanged,10000,5
gloC,4344,1939,-1.1637112996975691,-2405,Unchanged,10000,5
mepK,4820,1575,-1.6136813178426828,-3245,Unchanged,10000,5
ldtD,2920,3868,0.4056194257094617,948,Unchanged,10000,5
mukB,11670,10981,-0.08779511969410014,-689,Unchanged,10000,5
mukE,1015,1166,0.200088061127958,151,Unchanged,10000,5
mukF,1656,2238,0.43450736347706875,582,Unchanged,10000,5
cmoM,1597,1617,0.017955366062429045,20,Unchanged,10000,5
elyC,359,876,1.2869470257781221,517,Unchanged,10000,5
ycbJ,1854,1882,0.021625384103005865,28,Unchanged,10000,5
kdsB,3176,1899,-0.7419710069934603,-1277,Unchanged,10000,5
ycaR,149,117,-0.34880380087875706,-32,Unchanged,10000,5
ycaQ,281,1606,2.5148298572963883,1325,Unchanged,10000,5
lpxK,596,1728,1.5357189817013068,1132,Unchanged,10000,5
msbA,2833,3545,0.32345502574878005,712,Unchanged,10000,5
ycaI,267,2883,3.4326591898073526,2616,Unchanged,10000,5
ihfB,4169,543,-2.9406772690040275,-3626,Unchanged,10000,5
rpsA,111197,26814,-2.0520595102282333,-84383,Downregulated,10000,5
cmk,2341,1341,-0.8038156972075388,-1000,Unchanged,10000,5
ycaL,158,728,2.2040138920215933,570,Unchanged,10000,5
aroA,7840,2877,-1.4462884332632837,-4963,Unchanged,10000,5
serC,40422,7489,-2.432295710382022,-32933,Downregulated,10000,5
ycaP,358,629,0.8131004296150328,271,Unchanged,10000,5
ycaO,1024,2488,1.2807707701306026,1464,Unchanged,10000,5
focA,3653,2876,-0.3450180779227205,-777,Unchanged,10000,5
pflA,2310,1267,-0.8664763271626105,-1043,Unchanged,10000,5
ycaK,94,385,2.0341257839046265,291,Unchanged,10000,5
ycaN,239,852,1.8338428122450898,613,Unchanged,10000,5
ycaM,49,1510,4.945622990097233,1461,Unchanged,10000,5
ycaD,1249,1714,0.45659363250454255,465,Unchanged,10000,5
ycaC,1162,602,-0.9487746766448268,-560,Unchanged,10000,5
dmsC,4717,1628,-1.53476890126335,-3089,Unchanged,10000,5
dmsB,2469,936,-1.3993464015593775,-1533,Unchanged,10000,5
dmsA,11621,4690,-1.3090743917468417,-6931,Unchanged,10000,5
serS,19894,6684,-1.5735497432391965,-13210,Downregulated,10000,5
rarA,1869,2732,0.5476909145449325,863,Unchanged,10000,5
lolA,1526,1013,-0.5911207880333923,-513,Unchanged,10000,5
ftsK,12158,10309,-0.23800152960157073,-1849,Unchanged,10000,5
lrp,6467,1136,-2.509133775543195,-5331,Unchanged,10000,5
trxB,5474,2431,-1.1710455413362275,-3043,Unchanged,10000,5
cydD,2062,4856,1.2357240888875736,2794,Unchanged,10000,5
cydC,2670,4215,0.6586928892545283,1545,Unchanged,10000,5
aat,858,1389,0.694997046481847,531,Unchanged,10000,5
infA,2058,307,-2.744932421523789,-1751,Unchanged,10000,5
clpA,29579,21566,-0.4558146645997842,-8013,Unchanged,10000,5
clpS,455,516,0.18150452033719547,61,Unchanged,10000,5
cspD,1176,315,-1.9004643264490857,-861,Unchanged,10000,5
macB,1094,5070,2.212373009098146,3976,Unchanged,10000,5
macA,728,2767,1.9263122884112582,2039,Unchanged,10000,5
ybjX,13740,3962,-1.794081218815976,-9778,Unchanged,10000,5
ybjD,921,3715,2.012089149334623,2794,Unchanged,10000,5
aqpZ,356,1476,2.0517435750939983,1120,Unchanged,10000,5
lysO,1426,1720,0.2704345831455723,294,Unchanged,10000,5
hcp,293,3690,3.6546482465255106,3397,Unchanged,10000,5
hcr,312,1329,2.090723170413926,1017,Unchanged,10000,5
poxB,4689,3931,-0.2543839152967266,-758,Unchanged,10000,5
ltaE,3682,2458,-0.5830047109772448,-1224,Unchanged,10000,5
ybjT,2111,2893,0.45463974458244355,782,Unchanged,10000,5
ybjS,1614,1890,0.22774565583065481,276,Unchanged,10000,5
amiD,1618,2348,0.5372208006800746,730,Unchanged,10000,5
ybjQ,562,618,0.13703670768344833,56,Unchanged,10000,5
ybjP,2106,1071,-0.9755469562754611,-1035,Unchanged,10000,5
artP,2060,2361,0.1967537041580618,301,Unchanged,10000,5
artI,3090,2655,-0.21889497710022102,-435,Unchanged,10000,5
artQ,1630,1697,0.05811460042422344,67,Unchanged,10000,5
artM,1040,1367,0.3944297145776055,327,Unchanged,10000,5
artJ,1695,3465,1.0315700790008697,1770,Unchanged,10000,5
rlmC,472,1874,1.9892621882973456,1402,Unchanged,10000,5
ybjO,201,559,1.4756527816642615,358,Unchanged,10000,5
potI,121,1291,3.415410048032596,1170,Unchanged,10000,5
potH,31,1317,5.408843319869639,1286,Unchanged,10000,5
potG,98,1611,4.03903093459136,1513,Unchanged,10000,5
potF,141,1450,3.362285832503503,1309,Unchanged,10000,5
ybjN,1262,543,-1.2166878071781875,-719,Unchanged,10000,5
rimK,1282,1613,0.3313501765369017,331,Unchanged,10000,5
nfsA,1198,1319,0.1388166564627591,121,Unchanged,10000,5
ybjC,343,322,-0.09114788805819528,-21,Unchanged,10000,5
grxA,159,112,-0.5055280332267513,-47,Unchanged,10000,5
ybjM,592,506,-0.22645979093463967,-86,Unchanged,10000,5
ybjL,2238,4070,0.8628187581772154,1832,Unchanged,10000,5
rcdA,210,735,1.8073549220576042,525,Unchanged,10000,5
ybjJ,517,2100,2.02215314223855,1583,Unchanged,10000,5
ybjI,819,1106,0.4334160285936985,287,Unchanged,10000,5
ybjH,149,235,0.6573484261028382,86,Unchanged,10000,5
mdfA,472,1748,1.8888464201387571,1276,Unchanged,10000,5
ybjG,2358,1221,-0.9495005179923595,-1137,Unchanged,10000,5
deoR,1256,1179,-0.09127274591186439,-77,Unchanged,10000,5
dacC,4569,2970,-0.6214155115203204,-1599,Unchanged,10000,5
gstB,3048,1360,-1.1642562513556203,-1688,Unchanged,10000,5
yliI,463,2480,2.4212560220140014,2017,Unchanged,10000,5
bssR,10383,6662,-0.6401960882122527,-3721,Unchanged,10000,5
rimO,1654,2378,0.5237894805743811,724,Unchanged,10000,5
dgcI,654,1152,0.8167781759442299,498,Unchanged,10000,5
pdeI,1556,2375,0.6100854531194805,819,Unchanged,10000,5
gsiD,251,1506,2.584962500721156,1255,Unchanged,10000,5
gsiC,385,1878,2.2862667120715106,1493,Unchanged,10000,5
gsiB,1239,3863,1.6405454900913297,2624,Unchanged,10000,5
gsiA,2083,6300,1.5966889892339944,4217,Unchanged,10000,5
iaaA,1443,4880,1.7578098479590505,3437,Unchanged,10000,5
moeA,2189,3195,0.5455439766534106,1006,Unchanged,10000,5
moeB,916,1774,0.9535865062041199,858,Unchanged,10000,5
fsaA,155,869,2.4870879615401624,714,Unchanged,10000,5
ybiY,30,1492,5.636141224646719,1462,Unchanged,10000,5
ybiW,265,4667,4.138431202513582,4402,Unchanged,10000,5
ybiV,444,1088,1.2930469749002333,644,Unchanged,10000,5
ybiU,96,2480,4.6911619045530815,2384,Unchanged,10000,5
ybiT,3661,5084,0.4737262567004134,1423,Unchanged,10000,5
ldtB,3104,1894,-0.7126922267187425,-1210,Unchanged,10000,5
ybiR,287,1990,2.7936457887553234,1703,Unchanged,10000,5
mntR,583,1156,0.9875736093001823,573,Unchanged,10000,5
yliL,2,188,6.554588851677638,186,Unchanged,10000,5
opgE,265,2432,3.198078963993024,2167,Unchanged,10000,5
ompX,48807,9662,-2.3366943190254443,-39145,Downregulated,10000,5
rhtA,180,1640,3.187627003175771,1460,Unchanged,10000,5
dps,14671,2135,-2.7806592359214415,-12536,Downregulated,10000,5
glnH,9754,1919,-2.3456392608404877,-7835,Unchanged,10000,5
glnP,3277,1272,-1.3652770022584044,-2005,Unchanged,10000,5
glnQ,3497,1503,-1.2182727867813519,-1994,Unchanged,10000,5
ybiO,672,4518,2.749151132614324,3846,Unchanged,10000,5
rlmF,1442,1794,0.3151087256784386,352,Unchanged,10000,5
mcbA,69,224,1.698830465279435,155,Unchanged,10000,5
fiu,70,4128,5.881944238478288,4058,Unchanged,10000,5
ybiX,67,1146,4.096302138299133,1079,Unchanged,10000,5
ybiI,51,281,2.4620009782494305,230,Unchanged,10000,5
ybiJ,100,250,1.3219280948873624,150,Unchanged,10000,5
hcxB,9217,4083,-1.1746676831554574,-5134,Unchanged,10000,5
ybiB,2844,2333,-0.2857351576352161,-511,Unchanged,10000,5
dinG,1871,6136,1.7134889242621494,4265,Unchanged,10000,5
ybiA,112,859,2.9391593990808595,747,Unchanged,10000,5
rhlE,751,3454,2.2013832700146523,2703,Unchanged,10000,5
cecR,562,1703,1.5994363994576164,1141,Unchanged,10000,5
ybhG,1149,2752,1.2601016720559846,1603,Unchanged,10000,5
ybhF,2044,5108,1.3213633287651025,3064,Unchanged,10000,5
ybhS,629,2785,2.146545405348105,2156,Unchanged,10000,5
ybhR,485,2499,2.365294249012214,2014,Unchanged,10000,5
ybhQ,351,663,0.9175378398080271,312,Unchanged,10000,5
ybhP,600,1332,1.1505596765753814,732,Unchanged,10000,5
clsB,877,2672,1.607271260029319,1795,Unchanged,10000,5
ybhN,286,1777,2.6353566292502886,1491,Unchanged,10000,5
ybhM,64,618,3.2714630279043746,554,Unchanged,10000,5
ybhL,3891,1918,-1.0205382599547248,-1973,Unchanged,10000,5
moaE,1752,887,-0.9819967653001095,-865,Unchanged,10000,5
moaD,260,212,-0.2944473584652553,-48,Unchanged,10000,5
moaC,2860,1422,-1.0080936820463364,-1438,Unchanged,10000,5
moaB,3256,1582,-1.0413510997934552,-1674,Unchanged,10000,5
moaA,3302,2657,-0.31354189242275143,-645,Unchanged,10000,5
ybhK,1102,1725,0.6464721379817361,623,Unchanged,10000,5
uvrB,5067,7051,0.4766960517334962,1984,Unchanged,10000,5
bioD,627,1115,0.8305063620056281,488,Unchanged,10000,5
bioC,584,1616,1.4683869238717775,1032,Unchanged,10000,5
bioF,1223,3169,1.373603255854847,1946,Unchanged,10000,5
bioB,1832,3375,0.8814679987286117,1543,Unchanged,10000,5
bioA,1022,4147,2.02067285096834,3125,Unchanged,10000,5
ybhB,1312,862,-0.6060079455289856,-450,Unchanged,10000,5
ybhC,4620,3395,-0.44448127717132574,-1225,Unchanged,10000,5
ybhJ,126,4432,5.136462242549272,4306,Unchanged,10000,5
ybhI,19,1969,6.6953198824579685,1950,Unchanged,10000,5
ybhH,9,1233,7.098032082960526,1224,Unchanged,10000,5
ybhD,21,919,5.4516036285102745,898,Unchanged,10000,5
pgl,5304,2024,-1.3898714854182777,-3280,Unchanged,10000,5
ybhA,1185,1124,-0.07624502356469538,-61,Unchanged,10000,5
modC,548,2934,2.420621072712863,2386,Unchanged,10000,5
modB,333,1743,2.387978487054423,1410,Unchanged,10000,5
modA,403,3138,2.96099360844013,2735,Unchanged,10000,5
acrZ,112,12,-3.222392421336448,-100,Unchanged,10000,5
modE,525,1642,1.6450647992243197,1117,Unchanged,10000,5
modF,666,3309,2.3128012092412766,2643,Unchanged,10000,5
galE,2865,2524,-0.18282322866171827,-341,Unchanged,10000,5
galT,2229,2268,0.025024023682476366,39,Unchanged,10000,5
galK,3675,3084,-0.2529414846960549,-591,Unchanged,10000,5
galM,9684,3637,-1.4128541535433197,-6047,Unchanged,10000,5
gpmA,6870,3083,-1.1559752095982874,-3787,Unchanged,10000,5
aroG,13069,6744,-0.9544723133417239,-6325,Unchanged,10000,5
ybgS,686,346,-0.9874365385360876,-340,Unchanged,10000,5
zitB,773,1333,0.7861364611641258,560,Unchanged,10000,5
pnuC,10328,1578,-2.710391795293732,-8750,Unchanged,10000,5
nadA,15773,2695,-2.5490999064830935,-13078,Downregulated,10000,5
cpoB,8513,2280,-1.9006338060429238,-6233,Unchanged,10000,5
pal,12885,2556,-2.3337327957999876,-10329,Downregulated,10000,5
tolB,13827,4672,-1.5653759941777878,-9155,Unchanged,10000,5
tolA,2665,2547,-0.06533657337234353,-118,Unchanged,10000,5
tolR,476,489,0.03887289164429008,13,Unchanged,10000,5
tolQ,1786,1210,-0.5617250329592661,-576,Unchanged,10000,5
ybgC,891,449,-0.9887099867807749,-442,Unchanged,10000,5
ybgE,1043,406,-1.3611875253345895,-637,Unchanged,10000,5
cydB,10697,6818,-0.6497857413838689,-3879,Unchanged,10000,5
cydA,15778,9944,-0.6660161411773403,-5834,Unchanged,10000,5
mngB,695,3651,2.3932067858240145,2956,Unchanged,10000,5
mngA,36,3044,6.4018276420612334,3008,Unchanged,10000,5
mngR,443,965,1.1232222436004242,522,Unchanged,10000,5
sucD,2502,2196,-0.1882037351606212,-306,Unchanged,10000,5
sucC,3330,3138,-0.08567682499052688,-192,Unchanged,10000,5
sucB,4106,3606,-0.18733423067626032,-500,Unchanged,10000,5
sucA,5375,7546,0.4894473454459246,2171,Unchanged,10000,5
sdhB,312,1019,1.7075361173035655,707,Unchanged,10000,5
sdhA,571,3693,2.693230611842771,3122,Unchanged,10000,5
sdhD,45,388,3.108059745857453,343,Unchanged,10000,5
sdhC,57,509,3.1586318319109536,452,Unchanged,10000,5
gltA,4843,10211,1.076151253402954,5368,Unchanged,10000,5
ybgD,12,709,5.88467931651836,697,Unchanged,10000,5
ybgQ,17,4222,7.956248022096816,4205,Unchanged,10000,5
ybgP,16,969,5.920352855415081,953,Unchanged,10000,5
ybgO,33,1253,5.246776579963407,1220,Unchanged,10000,5
abrB,589,2139,1.8605969433345837,1550,Unchanged,10000,5
nei,1068,1807,0.7586848591770456,739,Unchanged,10000,5
pxpA,1773,2091,0.23800052569089059,318,Unchanged,10000,5
pxpC,3778,3246,-0.2189597018403983,-532,Unchanged,10000,5
pxpB,2126,1999,-0.0888631247864771,-127,Unchanged,10000,5
ybgI,2940,2890,-0.024746662335685607,-50,Unchanged,10000,5
dtpD,1059,3729,1.8160862077813047,2670,Unchanged,10000,5
phr,887,2930,1.7238946550085463,2043,Unchanged,10000,5
ybgA,438,770,0.8139275759810903,332,Unchanged,10000,5
ybfD,63,563,3.1597111885803133,500,Unchanged,10000,5
ybfL,66,1104,4.064130337419716,1038,Unchanged,10000,5
ybfC,106,337,1.6686843266186593,231,Unchanged,10000,5
ybfO,136,2421,4.153924522748597,2285,Unchanged,10000,5
ybfB,20,18,-0.15200309344504995,-2,Unchanged,10000,5
rhsC,1471,10618,2.8516428948689008,9147,Unchanged,10000,5
ybfA,2277,251,-3.1813750221858506,-2026,Unchanged,10000,5
kdpA,42,4335,6.689498855330437,4293,Unchanged,10000,5
kdpB,220,6069,4.78588339175478,5849,Unchanged,10000,5
kdpC,133,1235,3.2150128909708506,1102,Unchanged,10000,5
kdpD,1830,8244,2.1715008563678513,6414,Unchanged,10000,5
kdpE,187,1476,2.9805825461727595,1289,Unchanged,10000,5
speF,70,4158,5.892391025913404,4088,Unchanged,10000,5
potE,315,2476,2.9745875808269857,2161,Unchanged,10000,5
ybfG,20,713,5.155830171556525,693,Unchanged,10000,5
ybfP,47,438,3.220198207923536,391,Unchanged,10000,5
pgm,13779,5872,-1.2305473160988876,-7907,Unchanged,10000,5
seqA,2579,1436,-0.8447560239661627,-1143,Unchanged,10000,5
ybfF,1322,1348,0.028098319674166743,26,Unchanged,10000,5
ybfE,227,286,0.3333228494874745,59,Unchanged,10000,5
fldA,3509,1495,-1.2309144633166993,-2014,Unchanged,10000,5
fur,3036,1227,-1.3070365417525613,-1809,Unchanged,10000,5
chiQ,33,320,3.277533975528909,287,Unchanged,10000,5
chiP,92,2127,4.531042361903659,2035,Unchanged,10000,5
glnS,4970,4363,-0.18792537807314874,-607,Unchanged,10000,5
nagE,1753,3834,1.1290243409086127,2081,Unchanged,10000,5
nagB,1465,985,-0.5727050349658716,-480,Unchanged,10000,5
nagA,2314,2567,0.1496944314679285,253,Unchanged,10000,5
nagC,2087,3113,0.5768749763093446,1026,Unchanged,10000,5
umpH,2473,1850,-0.4187369689862633,-623,Unchanged,10000,5
asnB,11711,4559,-1.3610749582311916,-7152,Unchanged,10000,5
ubiF,1014,2940,1.5357585027203864,1926,Unchanged,10000,5
miaB,5129,4111,-0.31918819941338006,-1018,Unchanged,10000,5
ybeZ,4419,3751,-0.2364446680955357,-668,Unchanged,10000,5
ybeY,1362,1208,-0.17310624868699223,-154,Unchanged,10000,5
ybeX,5542,3226,-0.7806602723257742,-2316,Unchanged,10000,5
lnt,1961,3240,0.724404277579838,1279,Unchanged,10000,5
insH3,5086,3668,-0.471537823095052,-1418,Unchanged,10000,5
gltI,2328,1803,-0.3686916614759422,-525,Unchanged,10000,5
gltJ,234,934,1.9969140201262574,700,Unchanged,10000,5
gltK,302,1044,1.7895012572448055,742,Unchanged,10000,5
gltL,326,1234,1.9203985249183404,908,Unchanged,10000,5
rihA,1101,1559,0.5018064591334157,458,Unchanged,10000,5
hscC,143,2390,4.062923566089721,2247,Unchanged,10000,5
djlC,182,1910,3.391562282724415,1728,Unchanged,10000,5
ybeU,39,685,4.134557958985641,646,Unchanged,10000,5
ybeT,1,392,8.614709844115207,391,Unchanged,10000,5
djlB,51,1784,5.128474557948809,1733,Unchanged,10000,5
ybeR,15,675,5.491853096329675,660,Unchanged,10000,5
ybeQ,62,1100,4.149091498025147,1038,Unchanged,10000,5
ybeL,2112,889,-1.2483545105286835,-1223,Unchanged,10000,5
leuS,17258,8851,-0.9633529152638997,-8407,Unchanged,10000,5
lptE,2392,1202,-0.9927804934869194,-1190,Unchanged,10000,5
holA,1720,1713,-0.0058834135054613625,-7,Unchanged,10000,5
nadD,594,764,0.3631097072349828,170,Unchanged,10000,5
cobC,294,735,1.3219280948873624,441,Unchanged,10000,5
rsfS,744,401,-0.8917003846531112,-343,Unchanged,10000,5
rlmH,927,984,0.0860889767137092,57,Unchanged,10000,5
mrdA,1735,3095,0.8350037466360037,1360,Unchanged,10000,5
mrdB,1123,1828,0.7029081426574686,705,Unchanged,10000,5
rlpA,3505,2300,-0.607780583066248,-1205,Unchanged,10000,5
dacA,5294,2078,-1.3491625405911867,-3216,Unchanged,10000,5
ybeD,867,346,-1.3252599555851103,-521,Unchanged,10000,5
lipB,1228,1057,-0.2163351839874963,-171,Unchanged,10000,5
ybeF,39,933,4.580331051989511,894,Unchanged,10000,5
lipA,2513,2007,-0.32437005451803846,-506,Unchanged,10000,5
tatE,377,151,-1.3200159739435855,-226,Unchanged,10000,5
crcB,508,397,-0.355689489629208,-111,Unchanged,10000,5
cspE,9436,734,-3.68432345039625,-8702,Unchanged,10000,5
pagP,592,510,-0.2150999287700918,-82,Unchanged,10000,5
dcuC,806,2157,1.4201744326324868,1351,Unchanged,10000,5
dpiA,1051,838,-0.3267405202628268,-213,Unchanged,10000,5
dpiB,1865,2775,0.5733121409822306,910,Unchanged,10000,5
citC,6544,1529,-2.097584341580944,-5015,Unchanged,10000,5
citD,3627,280,-3.6952780130253133,-3347,Unchanged,10000,5
citE,17565,1522,-3.5286633126061884,-16043,Downregulated,10000,5
citF,35674,3061,-3.5427980392116187,-32613,Downregulated,10000,5
citX,8881,920,-3.2710163668036967,-7961,Unchanged,10000,5
citG,2388,1148,-1.0566801945891173,-1240,Unchanged,10000,5
citT,14439,2193,-2.718993112012435,-12246,Downregulated,10000,5
rna,806,1711,1.085988015961446,905,Unchanged,10000,5
rnk,886,704,-0.33173126991772117,-182,Unchanged,10000,5
ybdR,1588,2099,0.40249125414919645,511,Unchanged,10000,5
uspG,5319,1062,-2.324371270815691,-4257,Unchanged,10000,5
ahpF,5126,6331,0.30459991693185695,1205,Unchanged,10000,5
ahpC,18400,7356,-1.3227123814197999,-11044,Downregulated,10000,5
dsbG,491,1101,1.1650195392496758,610,Unchanged,10000,5
ybdO,29,625,4.429731384421878,596,Unchanged,10000,5
ybdN,47,2228,5.566944665662394,2181,Unchanged,10000,5
ybdM,134,1080,3.0107264065930583,946,Unchanged,10000,5
ybdL,1558,2395,0.6203304225618733,837,Unchanged,10000,5
hcxA,1912,3369,0.8172379051410089,1457,Unchanged,10000,5
cstA,571,6499,3.508655097282057,5928,Unchanged,10000,5
entH,42,745,4.148779192570764,703,Unchanged,10000,5
entA,100,1547,3.951401291674311,1447,Unchanged,10000,5
entB,95,2072,4.446952679355606,1977,Unchanged,10000,5
entE,47,4299,6.515196543305664,4252,Unchanged,10000,5
entC,21,3096,7.20387233336565,3075,Unchanged,10000,5
fepB,66,2470,5.225901207113586,2404,Unchanged,10000,5
entS,14,3182,7.828363198273443,3168,Unchanged,10000,5
fepD,43,2669,5.955818835439868,2626,Unchanged,10000,5
fepG,48,2789,5.860569718307156,2741,Unchanged,10000,5
fepC,48,1976,5.363404730863522,1928,Unchanged,10000,5
fepE,14,1776,6.987060944292502,1762,Unchanged,10000,5
entF,399,9184,4.524661990453342,8785,Unchanged,10000,5
fes,15,2305,7.263660439708182,2290,Unchanged,10000,5
fepA,159,4194,4.721228190812237,4035,Unchanged,10000,5
entD,21,678,5.012824040357583,657,Unchanged,10000,5
insL2,1964,1840,-0.09408916337031785,-124,Unchanged,10000,5
ybdK,648,1957,1.5945780377421792,1309,Unchanged,10000,5
ybdJ,47,147,1.645083493158727,100,Unchanged,10000,5
ybdF,259,368,0.506753668370459,109,Unchanged,10000,5
nfsB,3393,1642,-1.047107302933172,-1751,Unchanged,10000,5
ybdG,4126,2928,-0.49482826760244225,-1198,Unchanged,10000,5
pheP,1564,2811,0.8458429410729909,1247,Unchanged,10000,5
cusA,287,6000,4.3858398587075555,5713,Unchanged,10000,5
cusB,79,1771,4.486567748574811,1692,Unchanged,10000,5
cusF,13,279,4.423681593688095,266,Unchanged,10000,5
cusC,25,2003,6.324090516037983,1978,Unchanged,10000,5
cusR,556,1128,1.020610279675286,572,Unchanged,10000,5
cusS,545,2203,2.015141360036594,1658,Unchanged,10000,5
nfrB,321,4022,3.647267879183049,3701,Unchanged,10000,5
nfrA,834,5608,2.7493670605659597,4774,Unchanged,10000,5
ybcH,181,1260,2.7993621313040737,1079,Unchanged,10000,5
envY,58,650,3.4863149127882447,592,Unchanged,10000,5
ompT,109949,15187,-2.855925665843311,-94762,Downregulated,10000,5
appY,1342,73,-4.200344397320166,-1269,Unchanged,10000,5
tfaX,2,53,4.727920454563199,51,Unchanged,10000,5
ybcY,27,384,3.8300749985576874,357,Unchanged,10000,5
tfaD,18,478,4.7309418065384365,460,Unchanged,10000,5
nohD,39,819,4.392317422778761,780,Unchanged,10000,5
ybcW,157,55,-1.5132610353669675,-102,Unchanged,10000,5
ybcV,12,13,0.11547721741993588,1,Unchanged,10000,5
borD,4813,257,-4.227096158770994,-4556,Unchanged,10000,5
rzpD,83,548,2.722992651613602,465,Unchanged,10000,5
rrrD,51,414,3.0210616155278296,363,Unchanged,10000,5
essD,7,45,2.6844981742720706,38,Unchanged,10000,5
insH2,5183,3326,-0.6399992250974303,-1857,Unchanged,10000,5
quuD,11,242,4.459431618637297,231,Unchanged,10000,5
rusA,8,352,5.459431618637297,344,Unchanged,10000,5
ybcO,4,226,5.820178962415188,222,Unchanged,10000,5
ninE,1,27,4.754887502163468,26,Unchanged,10000,5
ybcN,7,410,5.872125177447842,403,Unchanged,10000,5
ybcM,646,288,-1.1654653532516126,-358,Unchanged,10000,5
ybcL,132,378,1.5178483048626192,246,Unchanged,10000,5
ybcK,25,446,4.15704371014558,421,Unchanged,10000,5
emrE,116,87,-0.4150374992788438,-29,Unchanged,10000,5
renD,1519,5201,1.775667168094117,3682,Unchanged,10000,5
insF3,23,685,4.896398221790876,662,Unchanged,10000,5
insE3,132,128,-0.044394119358453395,-4,Unchanged,10000,5
exoD,4,276,6.108524456778169,272,Unchanged,10000,5
intD,767,1675,1.1268626127295636,908,Unchanged,10000,5
fimZ,18,192,3.415037499278844,174,Unchanged,10000,5
sfmF,4,395,6.625708843064465,391,Unchanged,10000,5
sfmH,23,939,5.351419391596762,916,Unchanged,10000,5
sfmD,114,3380,4.889917517004805,3266,Unchanged,10000,5
sfmC,4,543,7.084808387804362,539,Unchanged,10000,5
sfmA,28,390,3.7999753916920067,362,Unchanged,10000,5
folD,4243,2476,-0.7770733640764715,-1767,Unchanged,10000,5
ybcJ,447,229,-0.964927233086374,-218,Unchanged,10000,5
ybcI,74,938,3.6639907468864266,864,Unchanged,10000,5
cysS,3271,3113,-0.07142618261359868,-158,Unchanged,10000,5
ppiB,10047,2164,-2.2149923776010567,-7883,Unchanged,10000,5
lpxH,1036,1731,0.7405817216800848,695,Unchanged,10000,5
purE,2789,2029,-0.4589790692716531,-760,Unchanged,10000,5
purK,5606,4585,-0.2900500105500771,-1021,Unchanged,10000,5
ybcF,43,1744,5.341919570074828,1701,Unchanged,10000,5
ylbF,64,1818,4.828136484194107,1754,Unchanged,10000,5
fdrA,18,3604,7.645458294371227,3586,Unchanged,10000,5
allD,25,1896,6.244887059123535,1871,Unchanged,10000,5
allC,153,2715,4.149348639999072,2562,Unchanged,10000,5
allE,386,1246,1.6906313157559214,860,Unchanged,10000,5
glxK,132,2210,4.06543653492034,2078,Unchanged,10000,5
ybbY,37,2610,6.140380725828297,2573,Unchanged,10000,5
allB,87,3142,5.174523969445468,3055,Unchanged,10000,5
ybbW,10,2416,7.916476644437717,2406,Unchanged,10000,5
glxR,34,1684,5.630213581816057,1650,Unchanged,10000,5
hyi,25,857,5.099295204337775,832,Unchanged,10000,5
gcl,150,3592,4.581752944245266,3442,Unchanged,10000,5
allR,4566,2143,-1.091299009548154,-2423,Unchanged,10000,5
allA,92,849,3.2060587874960254,757,Unchanged,10000,5
allS,46,1785,5.278146402859449,1739,Unchanged,10000,5
selU,435,2561,2.5576199468613776,2126,Unchanged,10000,5
ylbG,161,616,1.9358696625802845,455,Unchanged,10000,5
ybbD,2,191,6.577428828035749,189,Unchanged,10000,5
ylbH,25,603,4.59215800212536,578,Unchanged,10000,5
ybbC,37,51,0.4629719763425457,14,Unchanged,10000,5
rhsD,795,9827,3.6277242903545646,9032,Unchanged,10000,5
ybbP,851,7405,3.1212686984902476,6554,Unchanged,10000,5
ybbA,447,2034,2.1859729426741823,1587,Unchanged,10000,5
tesA,654,1539,1.2346306908301277,885,Unchanged,10000,5
ybbO,1202,2456,1.030873664658994,1254,Unchanged,10000,5
cnoX,4477,3871,-0.20982601061123315,-606,Unchanged,10000,5
fetB,459,1370,1.577609834434081,911,Unchanged,10000,5
fetA,512,1093,1.0940776856719046,581,Unchanged,10000,5
qmcA,2072,2847,0.4584184900557117,775,Unchanged,10000,5
ybbJ,542,944,0.8004940080079697,402,Unchanged,10000,5
cueR,905,855,-0.08199337219730746,-50,Unchanged,10000,5
ybaT,4897,3296,-0.5711819535255476,-1601,Unchanged,10000,5
glsA,2707,2125,-0.3492320463025373,-582,Unchanged,10000,5
copA,8910,9491,0.09113467014986153,581,Unchanged,10000,5
ybaQ,782,588,-0.411352452470988,-194,Unchanged,10000,5
ybaP,910,2226,1.290515142255901,1316,Unchanged,10000,5
ybaK,821,1051,0.3563085421843737,230,Unchanged,10000,5
ushA,3058,4611,0.5924912590511229,1553,Unchanged,10000,5
fsr,250,1988,2.991317756900199,1738,Unchanged,10000,5
ybaL,2669,5400,1.016660101796227,2731,Unchanged,10000,5
gsk,2047,3102,0.5996875840126802,1055,Unchanged,10000,5
aes,122,2060,4.0776912845076945,1938,Unchanged,10000,5
hemH,478,2308,2.271560700664734,1830,Unchanged,10000,5
adk,9547,2153,-2.1486991398140236,-7394,Unchanged,10000,5
htpG,15235,12864,-0.24405018839491935,-2371,Unchanged,10000,5
recR,3471,2292,-0.5987443210717411,-1179,Unchanged,10000,5
ybaB,2425,1321,-0.8763542807150246,-1104,Unchanged,10000,5
dnaX,3164,6854,1.1151965920463824,3690,Unchanged,10000,5
apt,1522,1568,0.042957200611662895,46,Unchanged,10000,5
ybaN,54,681,3.6566234858486024,627,Unchanged,10000,5
priC,592,1368,1.2083991492569481,776,Unchanged,10000,5
ybaM,23,51,1.1488633859144828,28,Unchanged,10000,5
mscK,2849,9773,1.7783458699855794,6924,Unchanged,10000,5
acrR,308,768,1.3181759600262548,460,Unchanged,10000,5
acrA,3209,3909,0.28467579500748336,700,Unchanged,10000,5
acrB,11104,11074,-0.0039030460478649926,-30,Unchanged,10000,5
tomB,118,224,0.9247118726957629,106,Unchanged,10000,5
hha,160,201,0.32912359629156634,41,Unchanged,10000,5
maa,325,1088,1.7431669333345226,763,Unchanged,10000,5
ylaC,190,787,2.0503642171765386,597,Unchanged,10000,5
pdeB,384,2214,2.527477006060396,1830,Unchanged,10000,5
ybaA,67,429,2.678744647041773,362,Unchanged,10000,5
ffs,2,6,1.584962500721156,4,Unchanged,10000,5
ybaZ,192,492,1.3575520046180838,300,Unchanged,10000,5
ybaY,1105,817,-0.4356383861331104,-288,Unchanged,10000,5
tesB,784,1422,0.858995905504207,638,Unchanged,10000,5
amtB,390,2511,2.686715999521889,2121,Unchanged,10000,5
glnK,18,403,4.484711027085655,385,Unchanged,10000,5
mdlB,374,3164,3.080639424585155,2790,Unchanged,10000,5
mdlA,487,3202,2.7169796304339147,2715,Unchanged,10000,5
decR,226,560,1.3091040545297787,334,Unchanged,10000,5
cof,159,1119,2.815111365692039,960,Unchanged,10000,5
ybaE,248,2614,3.397847115408558,2366,Unchanged,10000,5
queC,529,1094,1.048273110678531,565,Unchanged,10000,5
fadM,61,288,2.239187663879426,227,Unchanged,10000,5
ybaV,164,414,1.3359349528812416,250,Unchanged,10000,5
ppiD,6756,4998,-0.434818426714682,-1758,Unchanged,10000,5
hupB,11231,888,-3.6607829031649928,-10343,Downregulated,10000,5
lon,16664,12308,-0.4371383957071021,-4356,Unchanged,10000,5
clpX,17133,7366,-1.2178244880777658,-9767,Unchanged,10000,5
clpP,7476,2654,-1.4940981983749648,-4822,Unchanged,10000,5
tig,23630,7237,-1.7071559525913556,-16393,Downregulated,10000,5
bolA,1498,280,-2.4195388915137848,-1218,Unchanged,10000,5
yajG,2246,1235,-0.8628468859285612,-1011,Unchanged,10000,5
ampG,1180,2203,0.9006826354516795,1023,Unchanged,10000,5
cyoA,90,1251,3.797012977836145,1161,Unchanged,10000,5
cyoB,324,2943,3.1832218240557704,2619,Unchanged,10000,5
cyoC,88,694,2.9793602339409637,606,Unchanged,10000,5
cyoD,81,308,1.9269365378102767,227,Unchanged,10000,5
cyoE,338,1303,1.9467419322859503,965,Unchanged,10000,5
yajR,608,2110,1.7950997701509621,1502,Unchanged,10000,5
yajQ,6016,2713,-1.1489155193957714,-3303,Unchanged,10000,5
panE,1748,1690,-0.04868193833105162,-58,Unchanged,10000,5
yajL,1432,1063,-0.4298898957331517,-369,Unchanged,10000,5
thiI,3164,2925,-0.11331297511466266,-239,Unchanged,10000,5
xseB,1026,373,-1.4597831953518163,-653,Unchanged,10000,5
ispA,3515,2312,-0.6043832914592188,-1203,Unchanged,10000,5
dxs,3729,4300,0.2055478627031816,571,Unchanged,10000,5
yajO,1791,1975,0.1410873159658665,184,Unchanged,10000,5
pgpA,1451,1277,-0.18428899436402066,-174,Unchanged,10000,5
thiL,1102,1679,0.6074780063658725,577,Unchanged,10000,5
nusB,2820,1084,-1.3793304059322844,-1736,Unchanged,10000,5
ribE,1881,906,-1.05391689347696,-975,Unchanged,10000,5
ribD,2395,2657,0.14977257186696405,262,Unchanged,10000,5
nrdR,1299,1060,-0.29333716599731957,-239,Unchanged,10000,5
yajI,404,570,0.4966066263003092,166,Unchanged,10000,5
tsx,8516,2793,-1.608360376172344,-5723,Unchanged,10000,5
yajD,677,317,-1.0946729934355894,-360,Unchanged,10000,5
secF,3967,2681,-0.5652771781627194,-1286,Unchanged,10000,5
secD,7855,5854,-0.42418852977280813,-2001,Unchanged,10000,5
yajC,2403,817,-1.556428664984183,-1586,Unchanged,10000,5
tgt,2831,2499,-0.17996084781904326,-332,Unchanged,10000,5
queA,838,2284,1.4465405016634911,1446,Unchanged,10000,5
acpH,310,697,1.1688904405941856,387,Unchanged,10000,5
malZ,1538,3263,1.0851434841300376,1725,Unchanged,10000,5
proY,1340,2392,0.8359843888529702,1052,Unchanged,10000,5
brnQ,6619,3029,-1.1277716926731132,-3590,Unchanged,10000,5
phoR,294,2701,3.199605579672603,2407,Unchanged,10000,5
phoB,410,1412,1.7840442737657343,1002,Unchanged,10000,5
sbcD,800,2094,1.3881895371560837,1294,Unchanged,10000,5
sbcC,1553,6714,2.112114707310249,5161,Unchanged,10000,5
araJ,324,2030,2.647414009187914,1706,Unchanged,10000,5
mak,828,1859,1.1668240974201562,1031,Unchanged,10000,5
rdgC,3510,2217,-0.662862260324616,-1293,Unchanged,10000,5
ykiA,42,218,2.375866901998166,176,Unchanged,10000,5
ppnP,1151,423,-1.4441582650122806,-728,Unchanged,10000,5
aroM,322,1160,1.8489922119003175,838,Unchanged,10000,5
yaiA,130,174,0.4205756828202737,44,Unchanged,10000,5
aroL,673,1756,1.3836144349250412,1083,Unchanged,10000,5
yaiI,301,773,1.3607049271651455,472,Unchanged,10000,5
proC,2679,1822,-0.5561716220403283,-857,Unchanged,10000,5
dgcC,77,1721,4.482244841345302,1644,Unchanged,10000,5
psiF,173,295,0.7699429166124789,122,Unchanged,10000,5
phoA,803,3799,2.242147819147708,2996,Unchanged,10000,5
iraP,1126,493,-1.191547275702318,-633,Unchanged,10000,5
ddlA,3671,2020,-0.8618178214603903,-1651,Unchanged,10000,5
yaiZ,47,160,1.767339243209725,113,Unchanged,10000,5
yaiY,485,422,-0.20074174836730485,-63,Unchanged,10000,5
yaiW,1193,2233,0.9043892081272454,1040,Unchanged,10000,5
sbmA,416,2326,2.4831956633321264,1910,Unchanged,10000,5
ampH,937,2269,1.2759356560131505,1332,Unchanged,10000,5
iprA,15,310,4.369233809665719,295,Unchanged,10000,5
insE2,79,80,0.01814734671025952,1,Unchanged,10000,5
insF2,23,556,4.595379116666495,533,Unchanged,10000,5
hemB,2960,2919,-0.020122965014044487,-41,Unchanged,10000,5
tauD,64,1482,4.533329732305834,1418,Unchanged,10000,5
tauC,34,1582,5.5400710432224525,1548,Unchanged,10000,5
tauB,40,1135,4.826548487290915,1095,Unchanged,10000,5
tauA,20,2129,6.734032139564932,2109,Unchanged,10000,5
yaiS,7,580,6.372554167957331,573,Unchanged,10000,5
yaiP,61,1842,4.91632000852845,1781,Unchanged,10000,5
insD1,465,1296,1.478763096889231,831,Unchanged,10000,5
insC1,425,206,-1.0448185038418458,-219,Unchanged,10000,5
yaiO,70,1135,4.019193565233311,1065,Unchanged,10000,5
frmR,32,571,4.157346935362843,539,Unchanged,10000,5
frmA,348,3853,3.4688229748108217,3505,Unchanged,10000,5
frmB,57,1424,4.642843416801656,1367,Unchanged,10000,5
yaiL,674,815,0.27405146793658136,141,Unchanged,10000,5
mhpT,143,2410,4.074946094338935,2267,Unchanged,10000,5
mhpE,61,2177,5.15738835462532,2116,Unchanged,10000,5
mhpF,51,1802,5.142957953842043,1751,Unchanged,10000,5
mhpD,39,1386,5.151309323274965,1347,Unchanged,10000,5
mhpC,33,1868,5.822884620351209,1835,Unchanged,10000,5
mhpB,12,1865,7.279997414421444,1853,Unchanged,10000,5
mhpA,22,3827,7.442566567031198,3805,Unchanged,10000,5
mhpR,50,1819,5.185073637876762,1769,Unchanged,10000,5
lacI,971,2684,1.4668414707809911,1713,Unchanged,10000,5
lacZ,38115,24033,-0.6653421271462036,-14082,Downregulated,10000,5
lacY,2799,2464,-0.18390923087801353,-335,Unchanged,10000,5
lacA,2089,1009,-1.0498863179607512,-1080,Unchanged,10000,5
cynX,109,3069,4.815368605689558,2960,Unchanged,10000,5
cynS,55,731,3.732367882427778,676,Unchanged,10000,5
cynT,44,1523,5.113268607849995,1479,Unchanged,10000,5
cynR,204,2122,3.378783598943269,1918,Unchanged,10000,5
codA,13627,3555,-1.9385465211399973,-10072,Downregulated,10000,5
codB,16339,3201,-2.351725106555469,-13138,Downregulated,10000,5
prpE,84,5617,6.06326666479985,5533,Unchanged,10000,5
prpD,41,4370,6.735865559769877,4329,Unchanged,10000,5
prpC,27,2690,6.638502955280518,2663,Unchanged,10000,5
prpB,11,2420,7.78135971352466,2409,Unchanged,10000,5
prpR,36,3530,6.61552746671623,3494,Unchanged,10000,5
yahO,750,152,-2.302819271939658,-598,Unchanged,10000,5
yahN,85,1264,3.8943898120394014,1179,Unchanged,10000,5
yahM,12,170,3.8244284354165456,158,Unchanged,10000,5
yahL,23,627,4.768759676745026,604,Unchanged,10000,5
yahK,1614,2520,0.6427831551094985,906,Unchanged,10000,5
yahJ,1002,3537,1.8196437105057104,2535,Unchanged,10000,5
yahI,47,2160,5.522226745373193,2113,Unchanged,10000,5
yahG,92,3747,5.3479583062721,3655,Unchanged,10000,5
yahF,68,3626,5.7367003684938185,3558,Unchanged,10000,5
yahE,35,1183,5.078951341394822,1148,Unchanged,10000,5
yahD,81,639,2.9798221180623696,558,Unchanged,10000,5
yahC,23,879,5.2561573990863915,856,Unchanged,10000,5
yahB,192,1467,2.9336906549522337,1275,Unchanged,10000,5
pdeL,2092,2088,-0.0027611396770568656,-4,Unchanged,10000,5
betT,318,4523,3.8301813253470556,4205,Unchanged,10000,5
betI,305,1482,2.280664299855585,1177,Unchanged,10000,5
betB,866,4573,2.400701989080239,3707,Unchanged,10000,5
betA,494,4160,3.074000581443777,3666,Unchanged,10000,5
ykgH,5,283,5.82273014794452,278,Unchanged,10000,5
ykgG,153,1321,3.110026908554176,1168,Unchanged,10000,5
ykgF,427,2914,2.770692902444022,2487,Unchanged,10000,5
ykgE,77,1192,3.95238197976726,1115,Unchanged,10000,5
rclR,71,1419,4.320911754555869,1348,Unchanged,10000,5
rclA,543,1676,1.62599804589499,1133,Unchanged,10000,5
rclB,6,40,2.736965594166206,34,Unchanged,10000,5
rclC,43,599,3.8001474380866878,556,Unchanged,10000,5
ykgA,164,648,1.982297998266541,484,Unchanged,10000,5
insF1,30,351,3.548436624696042,321,Unchanged,10000,5
insE1,70,89,0.34645041402143123,19,Unchanged,10000,5
eaeH,10,1059,6.726558779104974,1049,Unchanged,10000,5
ykgM,6,105,4.129283016944966,99,Unchanged,10000,5
ykgL,11,35,1.669851398307669,24,Unchanged,10000,5
ecpR,193,312,0.6929451815941678,119,Unchanged,10000,5
ecpA,1126,873,-0.36715326845078944,-253,Unchanged,10000,5
ecpB,193,1083,2.4883604903402468,890,Unchanged,10000,5
ecpC,469,4713,3.328985853499976,4244,Unchanged,10000,5
ecpD,431,2405,2.480277119568306,1974,Unchanged,10000,5
ecpE,195,1016,2.381354373022555,821,Unchanged,10000,5
ykgJ,80,326,2.0268000593437154,246,Unchanged,10000,5
yagU,7525,1179,-2.674127863554664,-6346,Unchanged,10000,5
paoA,153,1570,3.3591610010863375,1417,Unchanged,10000,5
paoB,175,2281,3.7042396194798086,2106,Unchanged,10000,5
paoC,476,5693,3.5801556210832026,5217,Unchanged,10000,5
paoD,214,2674,3.643316763692206,2460,Unchanged,10000,5
intF,2685,3552,0.4037094934773309,867,Unchanged,10000,5
yagN,1014,572,-0.8259706002249511,-442,Unchanged,10000,5
yagM,18,256,3.8300749985576874,238,Unchanged,10000,5
yagL,29,285,3.296837113924532,256,Unchanged,10000,5
yagK,133,768,2.5296800652199667,635,Unchanged,10000,5
yagJ,170,1756,3.3686861933976564,1586,Unchanged,10000,5
insA3,35,320,3.192645077942396,285,Unchanged,10000,5
insB3,86,1523,4.146435471785194,1437,Unchanged,10000,5
argF,1092,5038,2.2058782658143885,3946,Unchanged,10000,5
xynR,739,2431,1.7179036238825778,1692,Unchanged,10000,5
yagH,1344,5885,2.130509277147046,4541,Unchanged,10000,5
yagG,917,4804,2.3892425121105796,3887,Unchanged,10000,5
yagF,553,6133,3.4712415654059843,5580,Unchanged,10000,5
yagE,247,2714,3.457837773834177,2467,Unchanged,10000,5
yagA,24,3061,6.994824828805835,3037,Unchanged,10000,5
yagB,140,454,1.6972654703459484,314,Unchanged,10000,5
insA2,49,420,3.0995356735509145,371,Unchanged,10000,5
insB2,137,1026,2.9047829326465275,889,Unchanged,10000,5
afuB,13,723,5.797412118810025,710,Unchanged,10000,5
afuC,73,2857,5.290460762056354,2784,Unchanged,10000,5
mmuM,922,2421,1.3927644235695986,1499,Unchanged,10000,5
mmuP,690,3402,2.3017148739978537,2712,Unchanged,10000,5
insH1,1717,3867,1.171324725080673,2150,Unchanged,10000,5
ykfC,398,2407,2.596395805930848,2009,Unchanged,10000,5
insI1,38,36,-0.07800251200127321,-2,Unchanged,10000,5
perR,105,1528,3.8631833103696263,1423,Unchanged,10000,5
ykfA,98,1401,3.83753139631561,1303,Unchanged,10000,5
yafZ,13,1392,6.742503777707636,1379,Unchanged,10000,5
yafY,26,405,3.9613383796308947,379,Unchanged,10000,5
ykfB,199,666,1.7427537465276133,467,Unchanged,10000,5
ykfF,25,264,3.400537929583729,239,Unchanged,10000,5
yafX,193,841,2.123504952987064,648,Unchanged,10000,5
ykfG,30,753,4.649615459063409,723,Unchanged,10000,5
yafW,29,438,3.9168060644736014,409,Unchanged,10000,5
ykfI,13,288,4.46948528330122,275,Unchanged,10000,5
proA,4837,3447,-0.48877123907859327,-1390,Unchanged,10000,5
proB,4802,3678,-0.3847139238184788,-1124,Unchanged,10000,5
phoE,29,1090,5.232131424536717,1061,Unchanged,10000,5
crl,1340,5219,1.961540401275384,3879,Unchanged,10000,5
frsA,2630,2974,0.1773418478727541,344,Unchanged,10000,5
gpt,2604,538,-2.2750513706090114,-2066,Unchanged,10000,5
pepD,16229,5064,-1.6802247966312664,-11165,Downregulated,10000,5
prfH,13,644,5.630477159973525,631,Unchanged,10000,5
ykfJ,1,74,6.20945336562895,73,Unchanged,10000,5
yafP,55,337,2.6152450676571988,282,Unchanged,10000,5
yafO,81,303,1.9033239805883262,222,Unchanged,10000,5
yafN,129,210,0.7030182622428686,81,Unchanged,10000,5
dinB,1003,2105,1.0694986273415776,1102,Unchanged,10000,5
lafU,62,898,3.8563753243542718,836,Unchanged,10000,5
lfhA,70,2642,5.238131734301861,2572,Unchanged,10000,5
rayT,213,419,0.9760968134735133,206,Unchanged,10000,5
yafL,92,957,3.3788131584290126,865,Unchanged,10000,5
dinJ,620,294,-1.0764520604378731,-326,Unchanged,10000,5
yafQ,299,177,-0.7563961241151075,-122,Unchanged,10000,5
ldtF,1510,934,-0.6930540945027793,-576,Unchanged,10000,5
yafJ,1260,1166,-0.11185594518678231,-94,Unchanged,10000,5
gmhA,3326,1753,-0.923962172527731,-1573,Unchanged,10000,5
fadE,380,4336,3.512293433022924,3956,Unchanged,10000,5
ivy,29038,2907,-3.3203391141626644,-26131,Downregulated,10000,5
yafV,755,1097,0.5390149761907516,342,Unchanged,10000,5
yafU,2,115,5.845490050944375,113,Unchanged,10000,5
yafT,39,546,3.807354922057604,507,Unchanged,10000,5
dnaQ,1774,1192,-0.5736217738389024,-582,Unchanged,10000,5
rnhA,404,533,0.39978024000738116,129,Unchanged,10000,5
yafS,498,701,0.4932687019425422,203,Unchanged,10000,5
gloB,457,575,0.33136779077366796,118,Unchanged,10000,5
mltD,6965,2992,-1.2190131776009787,-3973,Unchanged,10000,5
yafE,268,588,1.133583154378592,320,Unchanged,10000,5
yafD,2492,1788,-0.4789573318406841,-704,Unchanged,10000,5
yafC,561,1334,1.2496859905757922,773,Unchanged,10000,5
dkgB,225,648,1.5260688116675876,423,Unchanged,10000,5
gmhB,710,586,-0.2769183599697965,-124,Unchanged,10000,5
metN,10879,2560,-2.0873302345090456,-8319,Unchanged,10000,5
metI,4930,1454,-1.7615603773456796,-3476,Unchanged,10000,5
metQ,21292,2202,-3.273425097361117,-19090,Downregulated,10000,5
rcsF,1432,673,-1.0893530826539393,-759,Unchanged,10000,5
trmO,1062,1145,0.10856383218015271,83,Unchanged,10000,5
proS,10167,4531,-1.1659926466917614,-5636,Unchanged,10000,5
yaeF,61,896,3.876617584494718,835,Unchanged,10000,5
nlpE,768,1121,0.5456080620842706,353,Unchanged,10000,5
arfB,333,619,0.8944172321430025,286,Unchanged,10000,5
yaeQ,566,989,0.8051684679272285,423,Unchanged,10000,5
rof,1094,336,-1.7030796000137962,-758,Unchanged,10000,5
tilS,1674,2348,0.4881328805597085,674,Unchanged,10000,5
yaeR,330,418,0.3410369178350669,88,Unchanged,10000,5
ldcC,1860,3413,0.8757377931034717,1553,Unchanged,10000,5
accA,5631,2604,-1.112661702386395,-3027,Unchanged,10000,5
dnaE,6065,7506,0.30753664487910326,1441,Unchanged,10000,5
rnhB,1058,1287,0.282672426106676,229,Unchanged,10000,5
lpxB,3900,3379,-0.20687777347317152,-521,Unchanged,10000,5
lpxA,5579,3083,-0.8556716619409007,-2496,Unchanged,10000,5
fabZ,3247,1462,-1.1511640733336508,-1785,Unchanged,10000,5
lpxD,22317,4821,-2.2107387686637288,-17496,Downregulated,10000,5
skp,13479,2175,-2.6316261616211416,-11304,Downregulated,10000,5
bamA,23333,8136,-1.5199802269520264,-15197,Downregulated,10000,5
rseP,7681,3889,-0.9818949148622766,-3792,Unchanged,10000,5
cdsA,3120,1808,-0.7871513513344228,-1312,Unchanged,10000,5
uppS,3244,1321,-1.2961433529704454,-1923,Unchanged,10000,5
dxr,1423,2224,0.644221126197025,801,Unchanged,10000,5
frr,9176,2046,-2.1650592462704963,-7130,Unchanged,10000,5
pyrH,6446,2314,-1.4780153239520553,-4132,Unchanged,10000,5
tsf,26993,6595,-2.033140762144993,-20398,Downregulated,10000,5
rpsB,49068,9015,-2.4443830719278177,-40053,Downregulated,10000,5
map,3894,1640,-1.2475570692148488,-2254,Unchanged,10000,5
glnD,3717,4862,0.3874112051669712,1145,Unchanged,10000,5
dapD,9718,3613,-1.4274621776848422,-6105,Unchanged,10000,5
yaeI,218,969,2.152168530638155,751,Unchanged,10000,5
yaeH,1102,437,-1.3344190390705593,-665,Unchanged,10000,5
cdaR,234,1737,2.8920173191269885,1503,Unchanged,10000,5
degP,8840,7139,-0.3083243676423581,-1701,Unchanged,10000,5
dgt,1210,2212,0.8703443380727502,1002,Unchanged,10000,5
mtn,2775,2447,-0.18147367004544102,-328,Unchanged,10000,5
btuF,455,1461,1.6830177277174398,1006,Unchanged,10000,5
yadS,192,945,2.299208018387279,753,Unchanged,10000,5
erpA,1638,749,-1.1288977331822576,-889,Unchanged,10000,5
clcA,1423,3073,1.1107121050664799,1650,Unchanged,10000,5
hemL,6309,4937,-0.35377670571183883,-1372,Unchanged,10000,5
fhuB,289,4831,4.063180454931398,4542,Unchanged,10000,5
fhuD,183,1865,3.349260076858558,1682,Unchanged,10000,5
fhuC,240,1911,2.993221467368938,1671,Unchanged,10000,5
fhuA,812,4226,2.3797411347497643,3414,Unchanged,10000,5
mrcB,3223,6379,0.9849260901198685,3156,Unchanged,10000,5
hrpB,2277,6513,1.516187935199678,4236,Unchanged,10000,5
thpR,338,842,1.3167969867842118,504,Unchanged,10000,5
sfsA,796,1123,0.4965175918569524,327,Unchanged,10000,5
dksA,5898,1898,-1.6357458300406276,-4000,Unchanged,10000,5
gluQ,257,1532,2.575576032731079,1275,Unchanged,10000,5
pcnB,7003,4320,-0.6969417750889682,-2683,Unchanged,10000,5
folK,364,621,0.7706548180217851,257,Unchanged,10000,5
yadN,7,534,6.25334100962995,527,Unchanged,10000,5
yadV,8,686,6.422064766172812,678,Unchanged,10000,5
htrE,90,2363,4.714550817644172,2273,Unchanged,10000,5
yadM,45,400,3.15200309344505,355,Unchanged,10000,5
yadL,68,365,2.4242898125170402,297,Unchanged,10000,5
yadK,19,312,4.037474705418663,293,Unchanged,10000,5
yadC,68,607,3.1580898650053424,539,Unchanged,10000,5
panB,7600,4583,-0.7297071328439977,-3017,Unchanged,10000,5
panC,9902,4616,-1.1010767253166782,-5286,Unchanged,10000,5
rpnC,118,1048,3.150779952175609,930,Unchanged,10000,5
panD,3277,590,-2.4735888132935564,-2687,Unchanged,10000,5
yadE,379,1857,2.2927040617643293,1478,Unchanged,10000,5
yadI,187,516,1.4643327955356173,329,Unchanged,10000,5
yadH,773,1126,0.5426665081553823,353,Unchanged,10000,5
yadG,974,1747,0.8428859308344173,773,Unchanged,10000,5
can,1783,1054,-0.7584318359877802,-729,Unchanged,10000,5
hpt,1728,1087,-0.6687512771361593,-641,Unchanged,10000,5
gcd,365,4715,3.6912894017950793,4350,Unchanged,10000,5
cueO,1526,2906,0.9292797407983108,1380,Unchanged,10000,5
yacC,374,449,0.26367717485351017,75,Unchanged,10000,5
speE,3965,2539,-0.6430604709438351,-1426,Unchanged,10000,5
speD,5051,1945,-1.3767988865576484,-3106,Unchanged,10000,5
yacL,367,499,0.44325975249404775,132,Unchanged,10000,5
acnB,11551,12248,0.08452843305444614,697,Unchanged,10000,5
yacH,108,3410,4.980668521748067,3302,Unchanged,10000,5
lpd,4924,9621,0.9663560926783457,4697,Unchanged,10000,5
aceF,3333,15117,2.1812786395806607,11784,Upregulated,10000,5
aceE,4427,20500,2.2112226311823053,16073,Upregulated,10000,5
pdhR,214,3051,3.833599478177509,2837,Unchanged,10000,5
aroP,1341,3309,1.303086054408065,1968,Unchanged,10000,5
ampE,966,1616,0.7423321039160216,650,Unchanged,10000,5
ampD,585,977,0.7399219374976185,392,Unchanged,10000,5
nadC,880,1755,0.9958956016672635,875,Unchanged,10000,5
ppdD,6,668,6.798741791752896,662,Unchanged,10000,5
hofB,207,2662,3.6848078984125667,2455,Unchanged,10000,5
hofC,144,2558,4.150875547439325,2414,Unchanged,10000,5
guaC,8293,2263,-1.8736575077294848,-6030,Unchanged,10000,5
coaE,500,1018,1.0257375614136082,518,Unchanged,10000,5
zapD,1011,1439,0.5092835948372834,428,Unchanged,10000,5
yacG,75,157,1.0658020583957462,82,Unchanged,10000,5
mutT,74,281,1.9249729545919763,207,Unchanged,10000,5
secA,8479,11743,0.46983499204021323,3264,Unchanged,10000,5
secM,1363,1227,-0.15165031314230443,-136,Unchanged,10000,5
lpxC,40225,24484,-0.716253147691607,-15741,Downregulated,10000,5
ftsZ,22718,8607,-1.4002534575093086,-14111,Downregulated,10000,5
ftsA,5696,4396,-0.37375776001716665,-1300,Unchanged,10000,5
ftsQ,3490,2794,-0.3208950156875514,-696,Unchanged,10000,5
ddlB,5291,3034,-0.8023193321603057,-2257,Unchanged,10000,5
murC,6363,4643,-0.45464984068504954,-1720,Unchanged,10000,5
murG,3622,2956,-0.2931402768040169,-666,Unchanged,10000,5
ftsW,3563,3704,0.05599161512693684,141,Unchanged,10000,5
murD,5300,4248,-0.31920859353377024,-1052,Unchanged,10000,5
mraY,3504,2775,-0.3365150034763427,-729,Unchanged,10000,5
murF,6004,4034,-0.573712893007727,-1970,Unchanged,10000,5
murE,7043,4850,-0.5382053354274857,-2193,Unchanged,10000,5
ftsI,3873,4417,0.18961533101180636,544,Unchanged,10000,5
ftsL,783,608,-0.3649409838474552,-175,Unchanged,10000,5
rsmH,5264,3646,-0.5298449276961072,-1618,Unchanged,10000,5
mraZ,2814,1921,-0.5507648095710056,-893,Unchanged,10000,5
cra,4031,3394,-0.24815121830841616,-637,Unchanged,10000,5
ilvH,1567,1606,0.03546671304473432,39,Unchanged,10000,5
ilvI,6468,6503,0.007785744966595214,35,Unchanged,10000,5
leuO,356,1323,1.8938639153122792,967,Unchanged,10000,5
leuL,1,1,0.0,0,Unchanged,10000,5
leuA,9070,4953,-0.8727999297814705,-4117,Unchanged,10000,5
leuB,9512,3489,-1.4469351175512815,-6023,Unchanged,10000,5
leuC,13063,5585,-1.225857073092109,-7478,Unchanged,10000,5
leuD,4945,1867,-1.4052485934202712,-3078,Unchanged,10000,5
setA,654,2432,1.894780687945503,1778,Unchanged,10000,5
sgrR,629,4527,2.8474233843685504,3898,Unchanged,10000,5
thiB,676,2262,1.7425037777076362,1586,Unchanged,10000,5
thiP,254,3743,3.8812946461277957,3489,Unchanged,10000,5
thiQ,147,1537,3.3862291048544066,1390,Unchanged,10000,5
yabI,336,1797,2.4190572707311815,1461,Unchanged,10000,5
araC,558,2223,1.9941709211978025,1665,Unchanged,10000,5
araB,96,4012,5.385143389891025,3916,Unchanged,10000,5
araA,169,3659,4.436354264056903,3490,Unchanged,10000,5
araD,34,1458,5.422312163076597,1424,Unchanged,10000,5
polB,1148,4883,2.0886451359617757,3735,Unchanged,10000,5
rapA,1702,6270,1.8812344060034387,4568,Unchanged,10000,5
rluA,323,1135,1.8130862274843524,812,Unchanged,10000,5
djlA,683,1745,1.353269552806924,1062,Unchanged,10000,5
lptD,15687,8100,-0.9535756629086479,-7587,Unchanged,10000,5
surA,9386,5589,-0.7479202853654693,-3797,Unchanged,10000,5
pdxA,2187,2558,0.22606304383354378,371,Unchanged,10000,5
rsmA,3304,2135,-0.6299776169115925,-1169,Unchanged,10000,5
apaG,1093,832,-0.3936379675308125,-261,Unchanged,10000,5
apaH,1602,1895,0.2423237006497438,293,Unchanged,10000,5
folA,663,764,0.2045637679231608,101,Unchanged,10000,5
kefC,818,4462,2.4475177653023916,3644,Unchanged,10000,5
kefF,220,912,2.0515303006400822,692,Unchanged,10000,5
yaaU,31,2853,6.524067721194845,2822,Unchanged,10000,5
fixX,5,294,5.877744249949002,289,Unchanged,10000,5
fixC,46,2992,6.023332503830623,2946,Unchanged,10000,5
fixB,59,2155,5.190829104614619,2096,Unchanged,10000,5
fixA,58,1677,4.853685978436774,1619,Unchanged,10000,5
caiT,36,2922,6.3428154613611865,2886,Unchanged,10000,5
caiA,466,2368,2.3452672209746694,1902,Unchanged,10000,5
caiB,244,2260,3.211369719739664,2016,Unchanged,10000,5
caiC,312,2861,3.196901563460935,2549,Unchanged,10000,5
caiD,56,1653,4.883516087234709,1597,Unchanged,10000,5
caiE,49,1168,4.575114714764809,1119,Unchanged,10000,5
caiF,2125,1004,-1.0817035719616543,-1121,Unchanged,10000,5
carB,87261,11084,-2.976858390979492,-76177,Downregulated,10000,5
carA,39642,3752,-3.4012980175830543,-35890,Downregulated,10000,5
dapB,2670,1893,-0.4961653308712111,-777,Unchanged,10000,5
rihC,369,2201,2.576466423831161,1832,Unchanged,10000,5
ispH,3204,3048,-0.0720112449153881,-156,Unchanged,10000,5
fkpB,1220,1102,-0.14675692387909103,-118,Unchanged,10000,5
lspA,2428,1585,-0.6152855812289125,-843,Unchanged,10000,5
ileS,26188,16243,-0.6890877684242107,-9945,Unchanged,10000,5
ribF,5326,3097,-0.7821810455359511,-2229,Unchanged,10000,5
yaaY,16,143,3.1598713367783895,127,Unchanged,10000,5
rpsT,3080,393,-2.9703291333236574,-2687,Unchanged,10000,5
insA1,18,180,3.321928094887362,162,Unchanged,10000,5
insB1,37,444,3.584962500721156,407,Unchanged,10000,5
nhaR,999,1918,0.9410461372257125,919,Unchanged,10000,5
nhaA,4014,5155,0.36093181089285364,1141,Unchanged,10000,5
mokC,20,112,2.4854268271702415,92,Unchanged,10000,5
insL1,1370,2634,0.9430794524086253,1264,Unchanged,10000,5
dnaJ,4436,7278,0.7142826856799565,2842,Unchanged,10000,5
dnaK,59018,42708,-0.4666486929157538,-16310,Downregulated,10000,5
yaaI,10,571,5.83541884047548,561,Unchanged,10000,5
yaaW,51,1140,4.482392767080609,1089,Unchanged,10000,5
satP,321,1268,1.981909543017104,947,Unchanged,10000,5
mog,716,1296,0.8560342256203683,580,Unchanged,10000,5
talB,30807,7264,-2.0844220911612354,-23543,Downregulated,10000,5
yaaJ,622,2970,2.255476445557526,2348,Unchanged,10000,5
yaaA,1210,1732,0.5174318825647681,522,Unchanged,10000,5
yaaX,114,320,1.4890380807226207,206,Unchanged,10000,5
thrC,8008,11992,0.5825584091118661,3984,Unchanged,10000,5
thrB,5969,11160,0.9027758682667467,5191,Unchanged,10000,5
thrA,18297,38832,1.0856388918640891,20535,Upregulated,10000,5
thrL,1,1,0.0,0,Unchanged,10000,5
sokX,1,1,0.0,0,Unchanged,100000,5
sokE,1,1,0.0,0,Unchanged,100000,5
fnrS,1,2,1.0,1,Unchanged,100000,5
mgrR,1,1,0.0,0,Unchanged,100000,5
yrdF,2,5,1.3219280948873624,3,Unchanged,100000,5
yneO,1069,5385,2.3326844917110794,4316,Unchanged,100000,5
aaaE,138,1397,3.339591848631294,1259,Unchanged,100000,5
oweE,13,123,3.2420747871981477,110,Unchanged,100000,5
sroH,2,16,3.0,14,Unchanged,100000,5
eyeA,1,1,0.0,0,Unchanged,100000,5
rzoQ,2,22,3.4594316186372973,20,Unchanged,100000,5
ykgS,29,83,1.5170584362193527,54,Unchanged,100000,5
shoB,1,1,0.0,0,Unchanged,100000,5
yshB,4,2,-1.0,-2,Unchanged,100000,5
yrbN,1,1,0.0,0,Unchanged,100000,5
yqfG,1,1,0.0,0,Unchanged,100000,5
yqeL,1,1,0.0,0,Unchanged,100000,5
yqcG,1,1,0.0,0,Unchanged,100000,5
ypdK,1,1,0.0,0,Unchanged,100000,5
yohP,1,1,0.0,0,Unchanged,100000,5
yoeI,1,1,0.0,0,Unchanged,100000,5
yobI,1,1,0.0,0,Unchanged,100000,5
yoaK,1,1,0.0,0,Unchanged,100000,5
yoaJ,1,1,0.0,0,Unchanged,100000,5
ynbG,1,1,0.0,0,Unchanged,100000,5
ymjD,1,1,0.0,0,Unchanged,100000,5
ymiB,1,1,0.0,0,Unchanged,100000,5
ykgR,1,1,0.0,0,Unchanged,100000,5
yjeV,1,1,0.0,0,Unchanged,100000,5
ilvX,1,1,0.0,0,Unchanged,100000,5
ibsB,1,1,0.0,0,Unchanged,100000,5
ibsA,1,1,0.0,0,Unchanged,100000,5
ibsE,1,1,0.0,0,Unchanged,100000,5
ibsC,1,1,0.0,0,Unchanged,100000,5
ibsD,1,1,0.0,0,Unchanged,100000,5
azuC,1,1,0.0,0,Unchanged,100000,5
sgrT,5,10,1.0,5,Unchanged,100000,5
yfcU,353,3690,3.385880727676578,3337,Unchanged,100000,5
yhiL,32,433,3.758223214726725,401,Unchanged,100000,5
yghX,317,1052,1.730579959152895,735,Unchanged,100000,5
yjhZ,2,70,5.129283016944966,68,Unchanged,100000,5
yjhY,311,271,-0.19862172877673107,-40,Unchanged,100000,5
ythA,1,1,0.0,0,Unchanged,100000,5
yjdQ,1,12,3.584962500721156,11,Unchanged,100000,5
yicT,1,8,3.0,7,Unchanged,100000,5
yibU,1,47,5.554588851677638,46,Unchanged,100000,5
yibW,3,83,4.7900769306257684,80,Unchanged,100000,5
yibS,3,105,5.129283016944966,102,Unchanged,100000,5
ysaD,1,79,6.303780748177103,78,Unchanged,100000,5
ysaC,1,1,0.0,0,Unchanged,100000,5
mokA,1,15,3.9068905956085187,14,Unchanged,100000,5
yrdE,18,203,3.495410915742864,185,Unchanged,100000,5
psaA,1,1,0.0,0,Unchanged,100000,5
ypjI,5,176,5.137503523749935,171,Unchanged,100000,5
pawZ,1,1,0.0,0,Unchanged,100000,5
yoeD,1,4,2.0,3,Unchanged,100000,5
yoeH,27,18,-0.5849625007211563,-9,Unchanged,100000,5
yoeG,160,321,1.0045013922349408,161,Unchanged,100000,5
yeeH,1,1,0.0,0,Unchanged,100000,5
ttcC,1,1,0.0,0,Unchanged,100000,5
uof,1,1,0.0,0,Unchanged,100000,5
ybfI,1,14,3.807354922057604,13,Unchanged,100000,5
aaaD,6,264,5.459431618637297,258,Unchanged,100000,5
xisD,77,169,1.1340928955872829,92,Unchanged,100000,5
ylbI,1,1,0.0,0,Unchanged,100000,5
ykgQ,1,1,0.0,0,Unchanged,100000,5
ykgP,1,1,0.0,0,Unchanged,100000,5
ykfK,2,92,5.523561956057013,90,Unchanged,100000,5
ykfL,8,186,4.539158811108031,178,Unchanged,100000,5
ykfN,1,1,0.0,0,Unchanged,100000,5
symR,1,1,0.0,0,Unchanged,100000,5
ryjB,1,1,0.0,0,Unchanged,100000,5
insO,334,3978,3.5741232683596915,3644,Unchanged,100000,5
ytcA,1,290,8.179909090014934,289,Unchanged,100000,5
yjbS,1,7,2.807354922057604,6,Unchanged,100000,5
yjbT,8,164,4.357552004618084,156,Unchanged,100000,5
tisB,1,1,0.0,0,Unchanged,100000,5
istR,1,21,4.392317422778761,20,Unchanged,100000,5
yibV,3,94,4.9696263509564815,91,Unchanged,100000,5
sokA,1,1,0.0,0,Unchanged,100000,5
dinQ,2,7,1.8073549220576042,5,Unchanged,100000,5
yrhD,1,2,1.0,1,Unchanged,100000,5
sibE,3,3,0.0,0,Unchanged,100000,5
ryfD,13,3,-2.115477217419936,-10,Unchanged,100000,5
ohsC,1,1,0.0,0,Unchanged,100000,5
ypfM,1,1,0.0,0,Unchanged,100000,5
yojO,1,13,3.700439718141092,12,Unchanged,100000,5
rseX,1,1,0.0,0,Unchanged,100000,5
cydH,1,1,0.0,0,Unchanged,100000,5
ydgU,1,1,0.0,0,Unchanged,100000,5
mgtS,1,1,0.0,0,Unchanged,100000,5
yncL,1,1,0.0,0,Unchanged,100000,5
rydC,1,1,0.0,0,Unchanged,100000,5
yciZ,212,57,-1.8950304403984575,-155,Unchanged,100000,5
yciY,161,39,-2.0455146592523685,-122,Unchanged,100000,5
ymgJ,6,8,0.41503749927884376,2,Unchanged,100000,5
ymgI,1,3,1.584962500721156,2,Unchanged,100000,5
appX,1,1,0.0,0,Unchanged,100000,5
ybfK,1,97,6.599912842187128,96,Unchanged,100000,5
ylcI,30,66,1.1375035237499351,36,Unchanged,100000,5
ylcH,1,3,1.584962500721156,2,Unchanged,100000,5
insN,1725,3383,0.9717068152410945,1658,Unchanged,100000,5
ykfM,6,7,0.22239242133644802,1,Unchanged,100000,5
chiX,1,1,0.0,0,Unchanged,100000,5
yoeA,384,2481,2.6917435191712746,2097,Unchanged,100000,5
ybeM,368,1091,1.5678734302665942,723,Unchanged,100000,5
yaiT,548,5158,3.234563974828687,4610,Unchanged,100000,5
yncK,14,232,4.050626073069968,218,Unchanged,100000,5
sgrS,52,86,0.7258250365610057,34,Unchanged,100000,5
insB7,37,824,4.477047161554268,787,Unchanged,100000,5
yjgX,499,1673,1.745325724701092,1174,Unchanged,100000,5
insZ,103,1383,3.7470849139672757,1280,Unchanged,100000,5
ylbE,82,3030,5.20755007374223,2948,Unchanged,100000,5
lomR,148,2885,4.284902237903895,2737,Unchanged,100000,5
yhcE,1924,8506,2.144372055855722,6582,Unchanged,100000,5
ytjA,336,72,-2.222392421336448,-264,Unchanged,100000,5
yjjZ,6,136,4.502500340529183,130,Unchanged,100000,5
topAI,23,98,2.0911478880581953,75,Unchanged,100000,5
sgcB,7,172,4.618909832644494,165,Unchanged,100000,5
insM,19,45,1.2439255828860891,26,Unchanged,100000,5
ghoT,2,6,1.584962500721156,4,Unchanged,100000,5
yifL,297,143,-1.0544477840223765,-154,Unchanged,100000,5
yidD,474,222,-1.0943273825481532,-252,Unchanged,100000,5
ysdC,69,1626,4.558587085296859,1557,Unchanged,100000,5
yicS,31,198,2.6751603096927346,167,Unchanged,100000,5
yibT,231,122,-0.9210117038531713,-109,Unchanged,100000,5
ysaB,34,230,2.7580272096940357,196,Unchanged,100000,5
yrhC,7,137,4.290677160902923,130,Unchanged,100000,5
yheV,29,32,0.14201900487242786,3,Unchanged,100000,5
arfA,59,39,-0.5972408304995929,-20,Unchanged,100000,5
ypjJ,1,78,6.285402218862249,77,Unchanged,100000,5
ypfN,80,151,0.9164766444377165,71,Unchanged,100000,5
ypeB,91,111,0.28662122615140984,20,Unchanged,100000,5
ypdJ,1,1,0.0,0,Unchanged,100000,5
arnE,34,305,3.1652025911999093,271,Unchanged,100000,5
ypaA,50,53,0.08406426478847455,3,Unchanged,100000,5
yohO,1,1,0.0,0,Unchanged,100000,5
yehK,1,94,6.554588851677638,93,Unchanged,100000,5
yoeB,153,170,0.15200309344505006,17,Unchanged,100000,5
yoeF,1,10,3.321928094887362,9,Unchanged,100000,5
yecJ,185,148,-0.3219280948873623,-37,Unchanged,100000,5
yobH,203,65,-1.6429681041567217,-138,Unchanged,100000,5
yniD,1,2,1.0,1,Unchanged,100000,5
ynfO,16,90,2.4918530963296748,74,Unchanged,100000,5
hicA,39,37,-0.07594885323329863,-2,Unchanged,100000,5
ydbJ,957,354,-1.4347695644030283,-603,Unchanged,100000,5
rzoR,4,5,0.32192809488736235,1,Unchanged,100000,5
ydaF,2,31,3.9541963103868754,29,Unchanged,100000,5
ydaE,3,9,1.584962500721156,6,Unchanged,100000,5
ymjC,2,3,0.5849625007211562,1,Unchanged,100000,5
ymjB,29,1743,5.909375858998113,1714,Unchanged,100000,5
yciX,30,29,-0.0489096004809464,-1,Unchanged,100000,5
ymiA,3,11,1.874469117916141,8,Unchanged,100000,5
ycgI,32,227,2.826548487290915,195,Unchanged,100000,5
ymgF,9,22,1.289506617194985,13,Unchanged,100000,5
icdC,3,27,3.169925001442312,24,Unchanged,100000,5
ymdF,130,61,-1.0916304754655681,-69,Unchanged,100000,5
gnsA,44,57,0.37345839552744436,13,Unchanged,100000,5
insA4,7,262,5.226068079479846,255,Unchanged,100000,5
cydX,8,4,-1.0,-4,Unchanged,100000,5
ybfQ,10,66,2.722466024471091,56,Unchanged,100000,5
kdpF,1,1,0.0,0,Unchanged,100000,5
ybdD,18,71,1.9798221180623699,53,Unchanged,100000,5
ybdZ,2,133,6.05528243550119,131,Unchanged,100000,5
rzoD,5,9,0.8479969065549501,4,Unchanged,100000,5
ylcG,1,6,2.584962500721156,5,Unchanged,100000,5
peaD,2,231,6.851749041416057,229,Unchanged,100000,5
ykgO,1,6,2.584962500721156,5,Unchanged,100000,5
insX,130,242,0.89649542424614,112,Unchanged,100000,5
ykfH,7,152,4.4405725913859815,145,Unchanged,100000,5
yafF,3,90,4.906890595608519,87,Unchanged,100000,5
yeiW,4,202,5.658211482751795,198,Unchanged,100000,5
torI,13,29,1.15754127698648,16,Unchanged,100000,5
yfaS,364,7694,4.401723474097919,7330,Unchanged,100000,5
yehH,240,5701,4.570108690524543,5461,Unchanged,100000,5
yeeL,51,389,2.931201003014696,338,Unchanged,100000,5
yedS,262,791,1.5941108829353414,529,Unchanged,100000,5
yedN,29,211,2.863118193579613,182,Unchanged,100000,5
arpB,68,987,3.8594434332060583,919,Unchanged,100000,5
gapC,14295,3808,-1.9084052362105168,-10487,Unchanged,100000,5
ydbA,5237,15549,1.5700092896565043,10312,Unchanged,100000,5
ycgH,586,1826,1.639714195561974,1240,Unchanged,100000,5
efeU,20,1857,6.536830005048058,1837,Unchanged,100000,5
ilvG,7954,14887,0.9043005867860018,6933,Unchanged,100000,5
yjdP,165,637,1.9488273480104847,472,Unchanged,100000,5
yjiV,1271,5318,2.0649197468527087,4047,Unchanged,100000,5
ytfR,175,2691,3.9427155638080884,2516,Unchanged,100000,5
cpxP,1372,2510,0.8714068826653221,1138,Unchanged,100000,5
tatD,906,1419,0.6472916340143162,513,Unchanged,100000,5
yigE,43,1044,4.601641241867787,1001,Unchanged,100000,5
wecF,834,1273,0.6101131304566944,439,Unchanged,100000,5
hdfR,1225,1064,-0.20328359838874335,-161,Unchanged,100000,5
dgoR,326,1708,2.389364105389413,1382,Unchanged,100000,5
dgoD,115,2334,4.343098794762973,2219,Unchanged,100000,5
dgoA,39,973,4.6408937759188635,934,Unchanged,100000,5
gntU,350,3078,3.1365664044958814,2728,Unchanged,100000,5
rtcA,332,2851,3.102212892591028,2519,Unchanged,100000,5
frlC,64,1370,4.419960177847889,1306,Unchanged,100000,5
smf,493,951,0.9478576944826519,458,Unchanged,100000,5
yhdP,3334,6050,0.8596810380629025,2716,Unchanged,100000,5
tdcG,127,1768,3.799217872619266,1641,Unchanged,100000,5
cyuA,278,2229,3.003239828536245,1951,Unchanged,100000,5
ygiQ,1439,3832,1.4130309689958824,2393,Unchanged,100000,5
glcE,78,2695,5.11066733877762,2617,Unchanged,100000,5
glcF,301,3146,3.3856832786559847,2845,Unchanged,100000,5
yghJ,7703,8990,0.2229006904246339,1287,Unchanged,100000,5
yggP,89,1558,4.129746087095271,1469,Unchanged,100000,5
ghxQ,238,1659,2.8012804076479196,1421,Unchanged,100000,5
ygcU,68,1934,4.829909238226501,1866,Unchanged,100000,5
ygaQ,17,946,5.798233532089056,929,Unchanged,100000,5
yfjD,652,1551,1.2502548168050134,899,Unchanged,100000,5
araH,277,1225,2.1448238678407443,948,Unchanged,100000,5
ryjA,1,16,4.0,15,Unchanged,100000,5
oxyS,1,1,0.0,0,Unchanged,100000,5
csrC,64712,3906,-4.0502694117477835,-60806,Unchanged,100000,5
glmZ,2821,925,-1.608681395181897,-1896,Unchanged,100000,5
hokA,1,3,1.584962500721156,2,Unchanged,100000,5
rdlD,1,1,0.0,0,Unchanged,100000,5
ldrD,1,1,0.0,0,Unchanged,100000,5
gadY,1,1,0.0,0,Unchanged,100000,5
ryhB,1,1,0.0,0,Unchanged,100000,5
arcZ,1,1,0.0,0,Unchanged,100000,5
sraG,1,19,4.247927513443585,18,Unchanged,100000,5
sibD,3,12,2.0,9,Unchanged,100000,5
sibC,1,7,2.807354922057604,6,Unchanged,100000,5
omrB,1,1,0.0,0,Unchanged,100000,5
omrA,1,1,0.0,0,Unchanged,100000,5
gcvB,1042,50,-4.381283372503783,-992,Unchanged,100000,5
micA,1,1,0.0,0,Unchanged,100000,5
glmY,101,54,-0.9033239805883261,-47,Unchanged,100000,5
ryfA,185,389,1.0722448844698798,204,Unchanged,100000,5
micF,1,1,0.0,0,Unchanged,100000,5
cyaR,1,1,0.0,0,Unchanged,100000,5
sibB,1,6,2.584962500721156,5,Unchanged,100000,5
sibA,2,10,2.321928094887362,8,Unchanged,100000,5
isrC,35,18,-0.9593580155026542,-17,Unchanged,100000,5
sdsR,1,1,0.0,0,Unchanged,100000,5
ryeA,331,240,-0.46379681119869925,-91,Unchanged,100000,5
rprA,1,1,0.0,0,Unchanged,100000,5
rydB,1,1,0.0,0,Unchanged,100000,5
sokB,1,1,0.0,0,Unchanged,100000,5
hokB,6,11,0.874469117916141,5,Unchanged,100000,5
micC,1,1,0.0,0,Unchanged,100000,5
mcaS,1,13,3.700439718141092,12,Unchanged,100000,5
rttR,15,132,3.137503523749935,117,Unchanged,100000,5
rdlC,1,1,0.0,0,Unchanged,100000,5
ldrC,1,1,0.0,0,Unchanged,100000,5
rdlB,1,1,0.0,0,Unchanged,100000,5
ldrB,1,3,1.584962500721156,2,Unchanged,100000,5
rdlA,1,1,0.0,0,Unchanged,100000,5
ldrA,2,1,-1.0,-1,Unchanged,100000,5
sraB,2,14,2.807354922057604,12,Unchanged,100000,5
rybB,1,1,0.0,0,Unchanged,100000,5
rybA,1,1,0.0,0,Unchanged,100000,5
hokE,3,18,2.584962500721156,15,Unchanged,100000,5
tff,75,8,-3.228818690495881,-67,Unchanged,100000,5
sokC,1,1,0.0,0,Unchanged,100000,5
hokC,1,10,3.321928094887362,9,Unchanged,100000,5
ecnB,30,24,-0.3219280948873623,-6,Unchanged,100000,5
ecnA,2,3,0.5849625007211562,1,Unchanged,100000,5
blr,16,3,-2.415037499278844,-13,Unchanged,100000,5
csrB,623178,260368,-1.2590921550619776,-362810,Downregulated,100000,5
thiS,6,71,3.564784618783526,65,Unchanged,100000,5
yaeP,974,316,-1.6239972139052394,-658,Unchanged,100000,5
yjtD,303,1091,1.8482614028506563,788,Unchanged,100000,5
yjjY,1,12,3.584962500721156,11,Unchanged,100000,5
arcA,18961,3232,-2.55253595053786,-15729,Unchanged,100000,5
creD,132,2359,4.159565583881009,2227,Unchanged,100000,5
creC,331,3081,3.2184955602321335,2750,Unchanged,100000,5
creB,419,1320,1.6555157805464642,901,Unchanged,100000,5
creA,590,815,0.4660851048692364,225,Unchanged,100000,5
rob,3855,2200,-0.8092273363903748,-1655,Unchanged,100000,5
ytjC,1339,1457,0.12184491674020201,118,Unchanged,100000,5
yjjX,410,1130,1.4626269577971038,720,Unchanged,100000,5
trpR,367,545,0.5704761668210759,178,Unchanged,100000,5
slt,3688,5047,0.4525874308690885,1359,Unchanged,100000,5
ettA,10993,4743,-1.2127133793175484,-6250,Unchanged,100000,5
nadR,1902,2532,0.4127601585677778,630,Unchanged,100000,5
radA,2676,3891,0.5400628643313947,1215,Unchanged,100000,5
serB,1260,2385,0.920565532505595,1125,Unchanged,100000,5
ytjB,442,1204,1.4457171173682706,762,Unchanged,100000,5
lplA,857,2361,1.4620309321161429,1504,Unchanged,100000,5
yjjJ,688,2642,1.9411499965447296,1954,Unchanged,100000,5
deoD,7557,3615,-1.0638179756169173,-3942,Unchanged,100000,5
deoB,10766,7437,-0.5336896532115522,-3329,Unchanged,100000,5
deoA,4885,6684,0.4523531712054403,1799,Unchanged,100000,5
deoC,2561,3892,0.6038044571836431,1331,Unchanged,100000,5
yjjI,5004,5258,0.0714323524522261,254,Unchanged,100000,5
yjjW,1294,2319,0.841665202653496,1025,Unchanged,100000,5
yjjV,529,1681,1.6679800971221417,1152,Unchanged,100000,5
yjjU,1517,2120,0.48284317920352815,603,Unchanged,100000,5
osmY,3816,1635,-1.2227705356200667,-2181,Unchanged,100000,5
prfC,3488,3339,-0.06298394671381069,-149,Unchanged,100000,5
yjjG,1035,1347,0.3801190830756155,312,Unchanged,100000,5
rimI,804,829,0.04417660031682193,25,Unchanged,100000,5
holD,946,872,-0.11751204856246883,-74,Unchanged,100000,5
rsmC,1525,2059,0.4331345872946432,534,Unchanged,100000,5
fhuF,67,1197,4.15911824648573,1130,Unchanged,100000,5
bglJ,25,477,4.2539892662307865,452,Unchanged,100000,5
yjjQ,17,629,5.20945336562895,612,Unchanged,100000,5
yjjP,456,1375,1.5923258891346426,919,Unchanged,100000,5
yjjB,206,646,1.6488898275107065,440,Unchanged,100000,5
dnaT,209,718,1.7804809017421686,509,Unchanged,100000,5
dnaC,465,1575,1.7600492072792475,1110,Unchanged,100000,5
yjjA,498,897,0.8489622428511803,399,Unchanged,100000,5
opgB,2212,5627,1.3470145778228502,3415,Unchanged,100000,5
lgoD,25,2008,6.327687364176048,1983,Unchanged,100000,5
lgoR,244,1756,2.847339791972472,1512,Unchanged,100000,5
lgoT,158,3325,4.395357877098811,3167,Unchanged,100000,5
tsr,315,4676,3.8918511961443776,4361,Unchanged,100000,5
btsT,618,7336,3.5693148956906797,6718,Unchanged,100000,5
yjiX,29,104,1.84245872301352,75,Unchanged,100000,5
yjiA,1004,2341,1.2213656651612408,1337,Unchanged,100000,5
mrr,878,1767,1.0090091950162585,889,Unchanged,100000,5
hsdR,5342,8841,0.7268295852100465,3499,Unchanged,100000,5
hsdM,1239,2944,1.2486014839164112,1705,Unchanged,100000,5
hsdS,698,1184,0.7623701394192975,486,Unchanged,100000,5
symE,93,322,1.7917580670065856,229,Unchanged,100000,5
mcrB,870,1119,0.36312273024030334,249,Unchanged,100000,5
mcrC,279,477,0.773724144176324,198,Unchanged,100000,5
yjiT,3658,2524,-0.5353431647661675,-1134,Unchanged,100000,5
yjiS,2,38,4.247927513443585,36,Unchanged,100000,5
yjiR,298,2529,3.0851828012010767,2231,Unchanged,100000,5
mdtM,575,2213,1.944369589969274,1638,Unchanged,100000,5
yjiN,588,2484,2.078777113384117,1896,Unchanged,100000,5
yjiM,4315,3389,-0.34850092258232307,-926,Unchanged,100000,5
yjiL,1152,1680,0.5443205162238102,528,Unchanged,100000,5
yjiK,240,1022,2.090288885329103,782,Unchanged,100000,5
yjiJ,100,2147,4.424250286084049,2047,Unchanged,100000,5
kptA,173,822,2.2483663560449583,649,Unchanged,100000,5
yjiH,20255,4357,-2.2168710666586313,-15898,Unchanged,100000,5
yjiG,11863,2271,-2.3850692838713368,-9592,Unchanged,100000,5
iadA,53248,9915,-2.425042661024882,-43333,Unchanged,100000,5
hypT,7998,3191,-1.3256306725308171,-4807,Unchanged,100000,5
iraD,753,575,-0.3890879088401906,-178,Unchanged,100000,5
yjiC,34,450,3.7263183499666974,416,Unchanged,100000,5
uxuR,769,1481,0.9455161373270212,712,Unchanged,100000,5
uxuB,221,3413,3.9489221397074337,3192,Unchanged,100000,5
uxuA,200,2027,3.341274183692174,1827,Unchanged,100000,5
gntP,123,2064,4.068712750084014,1941,Unchanged,100000,5
fimH,225,1241,2.4635062089133197,1016,Unchanged,100000,5
fimG,119,676,2.5060616729742407,557,Unchanged,100000,5
fimF,73,604,3.0485801804450614,531,Unchanged,100000,5
fimD,455,3930,3.1105908620599103,3475,Unchanged,100000,5
fimC,251,746,1.5714882663044658,495,Unchanged,100000,5
fimI,604,797,0.4000311746653929,193,Unchanged,100000,5
fimA,5131,1171,-2.131498949690201,-3960,Unchanged,100000,5
fimE,36,611,4.085103568376417,575,Unchanged,100000,5
fimB,453,521,0.20177232223227326,68,Unchanged,100000,5
nanC,13,540,5.376375878909739,527,Unchanged,100000,5
nanM,473,1073,1.1817379874171268,600,Unchanged,100000,5
nanS,134,1239,3.2088712816828293,1105,Unchanged,100000,5
yjhR,61,1303,4.416884031005248,1242,Unchanged,100000,5
yjhQ,164,818,2.3184050283236655,654,Unchanged,100000,5
yjhP,281,1574,2.4857935052865603,1293,Unchanged,100000,5
sgcX,106,1900,4.163863248655111,1794,Unchanged,100000,5
sgcC,109,2384,4.450984195685235,2275,Unchanged,100000,5
sgcQ,91,1421,3.964896199044084,1330,Unchanged,100000,5
sgcA,87,645,2.890211854461888,558,Unchanged,100000,5
sgcE,126,1200,3.2515387669959646,1074,Unchanged,100000,5
sgcR,141,1365,3.275133883408421,1224,Unchanged,100000,5
yjhI,52,650,3.643856189774725,598,Unchanged,100000,5
yjhH,117,1553,3.7304773948038967,1436,Unchanged,100000,5
yjhG,585,4332,2.8885247131375604,3747,Unchanged,100000,5
yjhF,68,2459,5.176393178345743,2391,Unchanged,100000,5
yjhU,1749,2834,0.6963094689963659,1085,Unchanged,100000,5
insA7,35,295,3.0752881273042374,260,Unchanged,100000,5
fecI,59,1258,4.414273157517448,1199,Unchanged,100000,5
fecR,50,2024,5.339137384919585,1974,Unchanged,100000,5
fecA,161,6076,5.2379892763874665,5915,Unchanged,100000,5
fecB,171,2314,3.758320634221592,2143,Unchanged,100000,5
fecC,87,2035,4.547869583304881,1948,Unchanged,100000,5
fecD,71,1658,4.545481171991068,1587,Unchanged,100000,5
fecE,143,1471,3.3627101944764406,1328,Unchanged,100000,5
yjhV,7,388,5.792557920129523,381,Unchanged,100000,5
insI3,26,13,-1.0,-13,Unchanged,100000,5
yjhE,4,173,5.434628227636725,169,Unchanged,100000,5
yjhD,16,125,2.965784284662087,109,Unchanged,100000,5
nanY,303,814,1.425711000793296,511,Unchanged,100000,5
nanX,73,541,2.889660224946798,468,Unchanged,100000,5
insG,539,2030,1.9131225493200332,1491,Unchanged,100000,5
yjgZ,2,370,7.531381460516312,368,Unchanged,100000,5
insD6,314,333,0.08475761817963527,19,Unchanged,100000,5
insC6,297,262,-0.18089611926331556,-35,Unchanged,100000,5
intB,473,1343,1.5055472160880472,870,Unchanged,100000,5
ahr,1429,1372,-0.0587254349230041,-57,Unchanged,100000,5
idnK,61,375,2.620009447820357,314,Unchanged,100000,5
idnD,92,1218,3.7267364618493195,1126,Unchanged,100000,5
idnO,86,678,2.978876708434246,592,Unchanged,100000,5
idnT,135,1472,3.4467463590061818,1337,Unchanged,100000,5
idnR,316,1169,1.8872784663545534,853,Unchanged,100000,5
yjgR,999,2404,1.2668803129187671,1405,Unchanged,100000,5
lptG,1926,2552,0.4060206259214101,626,Unchanged,100000,5
lptF,1531,2441,0.6729980122813661,910,Unchanged,100000,5
pepA,14790,6269,-1.238314817550709,-8521,Unchanged,100000,5
holC,1329,781,-0.7669466511341951,-548,Unchanged,100000,5
valS,23802,10327,-1.204661592068277,-13475,Unchanged,100000,5
yjgN,38,420,3.466318004222537,382,Unchanged,100000,5
yjgM,397,541,0.4464895866838575,144,Unchanged,100000,5
rraB,3370,1086,-1.6337244882648594,-2284,Unchanged,100000,5
argI,736,3290,2.160309912565591,2554,Unchanged,100000,5
yjgL,292,252,-0.21254463538010074,-40,Unchanged,100000,5
tabA,1081,416,-1.377711089593558,-665,Unchanged,100000,5
bdcR,178,385,1.112981204615866,207,Unchanged,100000,5
bdcA,106,792,2.9014361655164103,686,Unchanged,100000,5
yjgH,120,294,1.292781749227846,174,Unchanged,100000,5
pyrL,186,20,-3.217230716220669,-166,Unchanged,100000,5
pyrB,140918,1708,-6.366404119239856,-139210,Downregulated,100000,5
pyrI,71072,608,-6.869066164103395,-70464,Unchanged,100000,5
ridA,34381,897,-5.26035971204243,-33484,Unchanged,100000,5
mgtA,1319,4158,1.6564451936068254,2839,Unchanged,100000,5
treR,678,1218,0.8451569547699884,540,Unchanged,100000,5
treB,191,2014,3.398419139971036,1823,Unchanged,100000,5
treC,173,2259,3.7068403277563595,2086,Unchanged,100000,5
nrdD,2249,4026,0.8400635111435228,1777,Unchanged,100000,5
nrdG,148,440,1.5719063478957098,292,Unchanged,100000,5
cybC,227,432,0.9283390148725535,205,Unchanged,100000,5
tldE,3937,2957,-0.41296246903871686,-980,Unchanged,100000,5
yjgA,957,820,-0.22289501498057954,-137,Unchanged,100000,5
mpl,4487,3051,-0.5564690040976888,-1436,Unchanged,100000,5
fbp,5724,2020,-1.5026683790875106,-3704,Unchanged,100000,5
yjfF,105,1226,3.5454977460246586,1121,Unchanged,100000,5
ytfT,94,1494,3.9903755811115995,1400,Unchanged,100000,5
ytfQ,214,1326,2.631398073711441,1112,Unchanged,100000,5
ppa,8657,1608,-2.4285997529658547,-7049,Unchanged,100000,5
chpB,91,412,2.178705886984522,321,Unchanged,100000,5
chpS,81,184,1.183711953172388,103,Unchanged,100000,5
ytfP,1536,413,-1.894964529301711,-1123,Unchanged,100000,5
tamB,4177,7508,0.8459615066680816,3331,Unchanged,100000,5
tamA,2349,3583,0.6091213301985393,1234,Unchanged,100000,5
msrA,1422,1071,-0.4089629848691594,-351,Unchanged,100000,5
ytfL,468,2004,2.0983020736118037,1536,Unchanged,100000,5
ytfK,137,44,-1.6386004643232295,-93,Unchanged,100000,5
ytfJ,73,630,3.1093834595072614,557,Unchanged,100000,5
ytfI,28,283,3.337303320774278,255,Unchanged,100000,5
cysQ,975,1065,0.12737930647622742,90,Unchanged,100000,5
cpdB,1721,2884,0.7448240672006189,1163,Unchanged,100000,5
ytfH,43,368,3.0972972013549147,325,Unchanged,100000,5
qorB,346,1323,1.934969118641952,977,Unchanged,100000,5
ytfF,77,1433,4.2180363535672445,1356,Unchanged,100000,5
ytfE,87,834,3.2609600775959353,747,Unchanged,100000,5
cycA,2479,2784,0.16740093976200615,305,Unchanged,100000,5
fklB,5501,1399,-1.9752979404805746,-4102,Unchanged,100000,5
ytfB,1143,1018,-0.16708784213878292,-125,Unchanged,100000,5
ytfA,5,159,4.990954860396993,154,Unchanged,100000,5
yjfZ,28,551,4.298553586513553,523,Unchanged,100000,5
rplI,15234,2078,-2.87402724146445,-13156,Unchanged,100000,5
rpsR,2683,578,-2.2147056567598424,-2105,Unchanged,100000,5
priB,5540,925,-2.582360705532876,-4615,Unchanged,100000,5
rpsF,13785,2732,-2.3350698786074626,-11053,Unchanged,100000,5
yjfY,23,146,2.666262602823004,123,Unchanged,100000,5
ulaF,109,1035,3.247230727609761,926,Unchanged,100000,5
ulaE,192,1468,2.9346737521220567,1276,Unchanged,100000,5
ulaD,166,1103,2.732177644244458,937,Unchanged,100000,5
ulaC,45,499,3.471042909007586,454,Unchanged,100000,5
ulaB,14,287,4.357552004618084,273,Unchanged,100000,5
ulaA,43,2279,5.727920454563199,2236,Unchanged,100000,5
ulaG,75,1749,4.543495883425772,1674,Unchanged,100000,5
ulaR,443,1254,1.5011587442470207,811,Unchanged,100000,5
yjfP,243,1078,2.1493289591467244,835,Unchanged,100000,5
bsmA,77,285,1.8880315683572026,208,Unchanged,100000,5
yjfN,41,141,1.78199934778071,100,Unchanged,100000,5
aidB,5102,2629,-0.9565487569844264,-2473,Unchanged,100000,5
yjfC,41,1601,5.287205587898173,1560,Unchanged,100000,5
yjfM,17,759,5.480493234165127,742,Unchanged,100000,5
yjfL,6,290,5.594946589293778,284,Unchanged,100000,5
yjfK,13,675,5.698303973797101,662,Unchanged,100000,5
yjfJ,41,1164,4.8273233382902,1123,Unchanged,100000,5
yjfI,12,106,3.142957953842043,94,Unchanged,100000,5
rlmB,1045,1441,0.46356739320650253,396,Unchanged,100000,5
rnr,10457,8416,-0.31326240762558943,-2041,Unchanged,100000,5
nsrR,295,477,0.6932743117563079,182,Unchanged,100000,5
purA,23089,18152,-0.3470771762571141,-4937,Unchanged,100000,5
yjeT,5,104,4.37851162325373,99,Unchanged,100000,5
hflC,6891,3677,-0.9061841808957836,-3214,Unchanged,100000,5
hflK,9808,6222,-0.6565805841563997,-3586,Unchanged,100000,5
hflX,7991,5306,-0.5907513788716409,-2685,Unchanged,100000,5
hfq,4476,1251,-1.839128246810574,-3225,Unchanged,100000,5
miaA,10145,7422,-0.45088895894649533,-2723,Unchanged,100000,5
mutL,2299,5565,1.2753752215111418,3266,Unchanged,100000,5
amiB,1778,3773,1.0854567759803395,1995,Unchanged,100000,5
tsaE,552,824,0.5779760704050493,272,Unchanged,100000,5
nnr,2667,4200,0.6551715030025589,1533,Unchanged,100000,5
queG,779,2929,1.9107129598176977,2150,Unchanged,100000,5
orn,1620,1054,-0.6201189461347726,-566,Unchanged,100000,5
rsgA,2150,2617,0.28357726457121224,467,Unchanged,100000,5
psd,3235,3212,-0.010293819362555372,-23,Unchanged,100000,5
mscM,1887,6836,1.857057974075694,4949,Unchanged,100000,5
yjeO,23,256,3.476438043942987,233,Unchanged,100000,5
yjeN,28,239,3.0935118859231445,211,Unchanged,100000,5
yjeM,151,1858,3.6211300470575742,1707,Unchanged,100000,5
epmA,421,1287,1.6121199151543057,866,Unchanged,100000,5
frdA,38764,8131,-2.253212748243349,-30633,Unchanged,100000,5
frdB,10822,2048,-2.4016795259824515,-8774,Unchanged,100000,5
frdC,4966,751,-2.725199448662569,-4215,Unchanged,100000,5
frdD,5398,836,-2.690850129385969,-4562,Unchanged,100000,5
ampC,749,1332,0.8305564586125112,583,Unchanged,100000,5
blc,259,528,1.0275858316718995,269,Unchanged,100000,5
gdx,132,288,1.1255308820838588,156,Unchanged,100000,5
efp,7060,1073,-2.7180181074020204,-5987,Unchanged,100000,5
epmB,1192,1594,0.41926739352831016,402,Unchanged,100000,5
yjeJ,98,792,3.014646775964401,694,Unchanged,100000,5
yjeI,2567,945,-1.4416970614669833,-1622,Unchanged,100000,5
groL,60572,25188,-1.2659144754207468,-35384,Unchanged,100000,5
groS,4494,1107,-2.0213449023983547,-3387,Unchanged,100000,5
yjeH,732,1696,1.2122206162791567,964,Unchanged,100000,5
fxsA,574,839,0.5476200737641356,265,Unchanged,100000,5
aspA,7847,3180,-1.3031144346913133,-4667,Unchanged,100000,5
dcuA,11019,3961,-1.4760566955481942,-7058,Unchanged,100000,5
cutA,328,248,-0.4033556942312085,-80,Unchanged,100000,5
dsbD,2441,2656,0.12178285156577087,215,Unchanged,100000,5
yjdC,1807,825,-1.1311304817314214,-982,Unchanged,100000,5
cadC,251,870,1.7933280367853186,619,Unchanged,100000,5
cadB,32,1087,5.086136225027309,1055,Unchanged,100000,5
cadA,78,2308,4.887025289783234,2230,Unchanged,100000,5
dtpC,250,1637,2.7110543218120666,1387,Unchanged,100000,5
lysU,3428,2158,-0.6676722446244828,-1270,Unchanged,100000,5
ghoS,46,65,0.4988058569714417,19,Unchanged,100000,5
yjdJ,160,156,-0.03652587602511404,-4,Unchanged,100000,5
yjdI,58,102,0.8144443468439234,44,Unchanged,100000,5
dcuS,1229,2441,0.9899873794084922,1212,Unchanged,100000,5
dcuR,766,929,0.2783342044576957,163,Unchanged,100000,5
dcuB,9416,4483,-1.070649820987756,-4933,Unchanged,100000,5
fumB,16430,6852,-1.2617354237534377,-9578,Unchanged,100000,5
yjdF,122,849,2.798883405990152,727,Unchanged,100000,5
melB,163,1347,3.0468059812312256,1184,Unchanged,100000,5
melA,196,1969,3.3285375517863454,1773,Unchanged,100000,5
melR,202,1317,2.7048281475047196,1115,Unchanged,100000,5
adiA,168,3617,4.428260459877014,3449,Unchanged,100000,5
adiY,269,467,0.7958163771530377,198,Unchanged,100000,5
adiC,127,1957,3.945743353854638,1830,Unchanged,100000,5
eptA,83,2242,4.755531131458502,2159,Unchanged,100000,5
basR,363,1064,1.551456697505439,701,Unchanged,100000,5
basS,231,1723,2.8989579448088905,1492,Unchanged,100000,5
proP,7138,11464,0.6835187082131229,4326,Unchanged,100000,5
rdcB,118,2059,4.125085065270413,1941,Unchanged,100000,5
rdcA,329,5157,3.970372556463976,4828,Unchanged,100000,5
yjdM,620,485,-0.3542834681997476,-135,Unchanged,100000,5
yjdN,279,1028,1.8815032373646905,749,Unchanged,100000,5
phnC,5,1596,8.318316841334983,1591,Unchanged,100000,5
phnD,10,2957,8.207990433232961,2947,Unchanged,100000,5
phnF,12,1817,7.242380203512959,1805,Unchanged,100000,5
phnG,4,1004,7.971543553950772,1000,Unchanged,100000,5
phnH,2,1362,9.411510988012072,1360,Unchanged,100000,5
phnI,4,2328,9.184875342908283,2324,Unchanged,100000,5
phnJ,12,2435,7.664743556248548,2423,Unchanged,100000,5
phnK,15,1614,6.749534267669262,1599,Unchanged,100000,5
phnL,40,2108,5.719731056749852,2068,Unchanged,100000,5
phnM,29,3408,6.876728625098266,3379,Unchanged,100000,5
phnN,33,1465,5.472290829951157,1432,Unchanged,100000,5
phnO,153,1071,2.807354922057604,918,Unchanged,100000,5
phnP,181,1876,3.373598225432171,1695,Unchanged,100000,5
rpiB,45,889,4.304186512500095,844,Unchanged,100000,5
alsR,590,1545,1.3888199785425335,955,Unchanged,100000,5
alsB,88,1801,4.355150847268979,1713,Unchanged,100000,5
alsA,24,2769,6.850186837645774,2745,Unchanged,100000,5
alsC,25,2036,6.34766565630097,2011,Unchanged,100000,5
alsE,43,1228,4.835830090668082,1185,Unchanged,100000,5
alsK,110,1821,4.0491554934521785,1711,Unchanged,100000,5
yjcS,27,3694,7.09608064881897,3667,Unchanged,100000,5
mdtN,13,1986,7.255210189387282,1973,Unchanged,100000,5
mdtO,55,4169,6.24412594328373,4114,Unchanged,100000,5
mdtP,42,3298,6.295058260658707,3256,Unchanged,100000,5
fdhF,4319,4771,0.14359436977728296,452,Unchanged,100000,5
yjcO,696,1490,1.0981531195007956,794,Unchanged,100000,5
gltP,6078,5245,-0.21265390205766438,-833,Unchanged,100000,5
nrfG,73,1005,3.7831552271862736,932,Unchanged,100000,5
nrfF,53,582,3.4569548883450847,529,Unchanged,100000,5
nrfE,331,3870,3.547430444224555,3539,Unchanged,100000,5
nrfD,2101,2167,0.04462299142062747,66,Unchanged,100000,5
nrfC,1432,1468,0.035820475578956346,36,Unchanged,100000,5
nrfB,1324,871,-0.604158498208353,-453,Unchanged,100000,5
nrfA,7611,3380,-1.1710627736155488,-4231,Unchanged,100000,5
acs,65,4302,6.0484239963946065,4237,Unchanged,100000,5
yjcH,5,271,5.760220946466509,266,Unchanged,100000,5
actP,86,3293,5.25892204189325,3207,Unchanged,100000,5
yjcF,11,168,3.932885804141463,157,Unchanged,100000,5
yjcE,1302,4311,1.7272931140128571,3009,Unchanged,100000,5
ghxP,2213,3334,0.5912506531854052,1121,Unchanged,100000,5
soxR,143,614,2.10222350859179,471,Unchanged,100000,5
soxS,84,345,2.038135128886771,261,Unchanged,100000,5
pdeC,217,2160,3.3152643646063513,1943,Unchanged,100000,5
yjcB,58,378,2.7042614290935005,320,Unchanged,100000,5
ssb,1912,1466,-0.3831974198469366,-446,Unchanged,100000,5
uvrA,5169,8394,0.6994732609398051,3225,Unchanged,100000,5
yjbR,2674,610,-2.132118317643104,-2064,Unchanged,100000,5
yjbQ,4184,979,-2.0955020866432466,-3205,Unchanged,100000,5
aphA,502,1096,1.1264885290097546,594,Unchanged,100000,5
tyrB,1916,2412,0.33213234616390447,496,Unchanged,100000,5
alr,2452,2474,0.012886521285588268,22,Unchanged,100000,5
dnaB,4407,3311,-0.41252988588043665,-1096,Unchanged,100000,5
qorA,3702,2050,-0.8526809854777657,-1652,Unchanged,100000,5
pspG,511,477,-0.09933402493210979,-34,Unchanged,100000,5
dusA,1120,1642,0.5519553948328383,522,Unchanged,100000,5
yjbM,14,219,3.967432137543569,205,Unchanged,100000,5
yjbL,3,4,0.41503749927884376,1,Unchanged,100000,5
zur,717,777,0.11594147970580533,60,Unchanged,100000,5
yjbJ,1018,58,-4.1335408509481235,-960,Unchanged,100000,5
dinF,680,1930,1.504994196017741,1250,Unchanged,100000,5
lexA,4786,1260,-1.92539666315122,-3526,Unchanged,100000,5
dgkA,506,514,0.02263097449956785,8,Unchanged,100000,5
plsB,7820,5034,-0.6354633910337353,-2786,Unchanged,100000,5
ubiA,776,1208,0.6384918971379513,432,Unchanged,100000,5
ubiC,444,734,0.7252203864931068,290,Unchanged,100000,5
yjbI,18,224,3.6374299206152916,206,Unchanged,100000,5
malM,606,1216,1.0047535299706345,610,Unchanged,100000,5
lamB,1703,1893,0.15259597602516287,190,Unchanged,100000,5
malK,892,1622,0.8626582042969683,730,Unchanged,100000,5
malE,3388,2359,-0.5222584560927361,-1029,Unchanged,100000,5
malF,1100,2518,1.1947747593069946,1418,Unchanged,100000,5
malG,644,1494,1.2140475546746203,850,Unchanged,100000,5
xylE,1738,4744,1.4486759277316035,3006,Unchanged,100000,5
psiE,269,421,0.6462140605097719,152,Unchanged,100000,5
yjbH,366,3374,3.2045444200035234,3008,Unchanged,100000,5
yjbG,73,1306,4.161114622666413,1233,Unchanged,100000,5
yjbF,90,934,3.3754256433799874,844,Unchanged,100000,5
yjbE,250,121,-1.0469210473874926,-129,Unchanged,100000,5
pgi,21407,9183,-1.2210451783558893,-12224,Unchanged,100000,5
lysC,6664,3490,-0.9331613642685329,-3174,Unchanged,100000,5
yjbD,238,190,-0.3249621549769956,-48,Unchanged,100000,5
rluF,494,1309,1.4058821503605632,815,Unchanged,100000,5
pepE,2509,1372,-0.8708319892363603,-1137,Unchanged,100000,5
yjbB,443,2954,2.737291222209771,2511,Unchanged,100000,5
metH,13700,9762,-0.4889272363415674,-3938,Unchanged,100000,5
iclR,1078,1486,0.4630769377860907,408,Unchanged,100000,5
arpA,24,1138,5.567322341585426,1114,Unchanged,100000,5
aceK,4932,4807,-0.03703599626494348,-125,Unchanged,100000,5
aceA,39373,30142,-0.38543149521528347,-9231,Unchanged,100000,5
aceB,48476,32756,-0.5655114666724081,-15720,Unchanged,100000,5
metA,6858,1375,-2.31835628563625,-5483,Unchanged,100000,5
yjaB,112,468,2.0630097975258006,356,Unchanged,100000,5
yjaA,13,288,4.46948528330122,275,Unchanged,100000,5
purH,11038,4174,-1.4029762850318608,-6864,Unchanged,100000,5
purD,6179,2666,-1.2126965930140288,-3513,Unchanged,100000,5
zraR,567,2598,2.1959807905056525,2031,Unchanged,100000,5
zraS,213,2435,3.5149964367438664,2222,Unchanged,100000,5
zraP,319,591,0.8896017064126631,272,Unchanged,100000,5
yjaH,570,1236,1.1166449188522707,666,Unchanged,100000,5
hupA,5686,487,-3.5454204215951854,-5199,Unchanged,100000,5
yjaG,1224,1253,0.033782856629208644,29,Unchanged,100000,5
nfi,1213,1625,0.42186016768266893,412,Unchanged,100000,5
hemE,3464,2625,-0.40012150728587764,-839,Unchanged,100000,5
nudC,1125,1230,0.12873331412220274,105,Unchanged,100000,5
rsd,379,476,0.32876372513685176,97,Unchanged,100000,5
thiC,591,3711,2.6505779655199935,3120,Unchanged,100000,5
thiE,139,918,2.7234092706903006,779,Unchanged,100000,5
thiF,187,906,2.276472780158598,719,Unchanged,100000,5
thiG,156,1144,2.8744691179161412,988,Unchanged,100000,5
thiH,228,1708,2.9052022454557487,1480,Unchanged,100000,5
yjaZ,84,404,2.2658940599730344,320,Unchanged,100000,5
rpoC,116263,31573,-1.880628786716989,-84690,Unchanged,100000,5
rpoB,100349,30032,-1.7404537796026385,-70317,Unchanged,100000,5
rplL,47998,10674,-2.1688733758491825,-37324,Unchanged,100000,5
rplJ,38001,8268,-2.2004270898396565,-29733,Unchanged,100000,5
rplA,44628,10175,-2.132920359292172,-34453,Unchanged,100000,5
rplK,16587,2793,-2.5701654987930755,-13794,Unchanged,100000,5
nusG,7247,1625,-2.156944176181562,-5622,Unchanged,100000,5
secE,4402,956,-2.203076621910809,-3446,Unchanged,100000,5
tufB,124091,9085,-3.771768159629583,-115006,Downregulated,100000,5
coaA,1280,570,-1.1671099858352583,-710,Unchanged,100000,5
birA,972,1054,0.11684664803143371,82,Unchanged,100000,5
murB,1710,1051,-0.7022336558110819,-659,Unchanged,100000,5
murI,1263,1275,0.01364260795866807,12,Unchanged,100000,5
btuB,5171,2278,-1.1826755577752772,-2893,Unchanged,100000,5
trmA,2850,1745,-0.7077348828424518,-1105,Unchanged,100000,5
yijD,1185,541,-1.1311865599588062,-644,Unchanged,100000,5
fabR,1822,1364,-0.41767931477787823,-458,Unchanged,100000,5
sthA,1523,3118,1.0337049862104926,1595,Unchanged,100000,5
oxyR,3882,2868,-0.436755094011759,-1014,Unchanged,100000,5
argH,2694,6244,1.2127206865156057,3550,Unchanged,100000,5
argB,873,2858,1.7109523574663763,1985,Unchanged,100000,5
argC,1060,4182,1.9801287971390178,3122,Unchanged,100000,5
argE,1712,2751,0.6842734379150636,1039,Unchanged,100000,5
ppc,57960,21570,-1.4260314183964753,-36390,Unchanged,100000,5
eptC,2362,2543,0.10652249729294909,181,Unchanged,100000,5
yijO,313,1320,2.0763033673131974,1007,Unchanged,100000,5
frwD,15,370,4.624490864907794,355,Unchanged,100000,5
pflC,71,1403,4.3045521741152175,1332,Unchanged,100000,5
pflD,215,3525,4.0352146925840575,3310,Unchanged,100000,5
frwB,15,292,4.282933963271499,277,Unchanged,100000,5
frwC,24,1926,6.3264294871223035,1902,Unchanged,100000,5
ptsA,64,5236,6.354249381945241,5172,Unchanged,100000,5
fsaB,58,1113,4.262256882214388,1055,Unchanged,100000,5
gldA,4373,3057,-0.5165067961942377,-1316,Unchanged,100000,5
yijF,41,1245,4.924378022337359,1204,Unchanged,100000,5
yijE,232,2071,3.15813084309294,1839,Unchanged,100000,5
katG,12988,8272,-0.6508711989711533,-4716,Unchanged,100000,5
metF,9695,1797,-2.431650489484213,-7898,Unchanged,100000,5
metL,6845,6356,-0.10693141679674281,-489,Unchanged,100000,5
metB,3035,2976,-0.028321990035013005,-59,Unchanged,100000,5
metJ,1479,629,-1.2334901302197785,-850,Unchanged,100000,5
yiiX,291,1184,2.024578022720666,893,Unchanged,100000,5
rpmE,2756,248,-3.474163862317416,-2508,Unchanged,100000,5
priA,1969,5388,1.4522867395607493,3419,Unchanged,100000,5
cytR,1719,2338,0.4437053850535952,619,Unchanged,100000,5
ftsN,3531,2793,-0.33826124747965053,-738,Unchanged,100000,5
hslV,1400,1369,-0.03230438057442922,-31,Unchanged,100000,5
hslU,6710,4604,-0.5434249329553156,-2106,Unchanged,100000,5
menA,336,1485,2.143929792909368,1149,Unchanged,100000,5
rraA,3976,1609,-1.30515343083884,-2367,Unchanged,100000,5
zapB,2193,353,-2.6351657234024133,-1840,Unchanged,100000,5
glpF,859,2218,1.3685293290232465,1359,Unchanged,100000,5
glpK,3569,5846,0.71192992775703,2277,Unchanged,100000,5
glpX,1094,1723,0.6553099634323917,629,Unchanged,100000,5
fpr,1073,1284,0.2589951263657812,211,Unchanged,100000,5
uspD,2255,405,-2.4771336203707564,-1850,Unchanged,100000,5
yiiS,752,232,-1.6966078565500653,-520,Unchanged,100000,5
yiiR,154,406,1.3985493764902748,252,Unchanged,100000,5
yiiQ,930,718,-0.3732468721723423,-212,Unchanged,100000,5
tpiA,23875,4031,-2.566291044846756,-19844,Unchanged,100000,5
cdh,263,737,1.4866018198027673,474,Unchanged,100000,5
sbp,188,1385,2.8810814092589134,1197,Unchanged,100000,5
pfkA,23466,6406,-1.873076238679418,-17060,Unchanged,100000,5
fieF,1262,1614,0.3549286682952314,352,Unchanged,100000,5
cpxR,3536,1738,-1.0246901925770315,-1798,Unchanged,100000,5
cpxA,5040,3645,-0.4675049191729794,-1395,Unchanged,100000,5
yiiM,550,882,0.6813470371454985,332,Unchanged,100000,5
kdgT,125,1308,3.3873625408359955,1183,Unchanged,100000,5
sodA,141,699,2.3095972929766426,558,Unchanged,100000,5
rhaT,82,1367,4.059245522987976,1285,Unchanged,100000,5
rhaR,66,853,3.6920078119598365,787,Unchanged,100000,5
rhaS,56,951,4.085946608802959,895,Unchanged,100000,5
rhaB,29,1677,5.853685978436774,1648,Unchanged,100000,5
rhaA,52,1817,5.1269029860930235,1765,Unchanged,100000,5
rhaD,20,1098,5.778734244117836,1078,Unchanged,100000,5
rhaM,6,192,5.0,186,Unchanged,100000,5
frvA,4,396,6.6293566200796095,392,Unchanged,100000,5
frvB,43,1811,5.39630607624807,1768,Unchanged,100000,5
frvX,155,1366,3.139617363015853,1211,Unchanged,100000,5
frvR,66,1954,4.887820632609932,1888,Unchanged,100000,5
yiiG,38,1003,4.7221783771685955,965,Unchanged,100000,5
fdhD,786,1084,0.4637635390952651,298,Unchanged,100000,5
fdoG,2541,8206,1.6912827788391802,5665,Unchanged,100000,5
fdoH,474,1652,1.8012547225211863,1178,Unchanged,100000,5
fdoI,222,822,1.888578717331577,600,Unchanged,100000,5
fdhE,1278,1682,0.3962898693081497,404,Unchanged,100000,5
yiiF,26,65,1.3219280948873624,39,Unchanged,100000,5
yiiE,2,97,5.599912842187128,95,Unchanged,100000,5
fabY,2113,1982,-0.09233580474845246,-131,Unchanged,100000,5
dtd,706,729,0.046250631055756906,23,Unchanged,100000,5
yihY,840,1367,0.7025520099399374,527,Unchanged,100000,5
yihX,974,1073,0.13965639867417973,99,Unchanged,100000,5
csqR,594,1412,1.2492052524704145,818,Unchanged,100000,5
yihV,218,1613,2.887346398378716,1395,Unchanged,100000,5
yihU,85,1370,4.010569241710187,1285,Unchanged,100000,5
yihT,130,1527,3.5541165337683966,1397,Unchanged,100000,5
yihS,193,1833,3.2475340332718052,1640,Unchanged,100000,5
yihR,26,1212,5.542734265331859,1186,Unchanged,100000,5
yihQ,73,2759,5.240105182473256,2686,Unchanged,100000,5
yihP,59,1762,4.900355159558573,1703,Unchanged,100000,5
yihO,49,1320,4.751612370130608,1271,Unchanged,100000,5
ompL,23,310,3.7525624492172245,287,Unchanged,100000,5
yihN,30,1034,5.107129874706416,1004,Unchanged,100000,5
yihM,202,784,1.9564983613634135,582,Unchanged,100000,5
yihL,123,686,2.479550260833572,563,Unchanged,100000,5
bipA,15404,6513,-1.241910896460685,-8891,Unchanged,100000,5
glnA,37650,4026,-3.2252307875253132,-33624,Unchanged,100000,5
glnL,2170,1207,-0.8462693665768202,-963,Unchanged,100000,5
glnG,2812,1939,-0.5362837909657429,-873,Unchanged,100000,5
hemN,3168,2152,-0.5578942575229855,-1016,Unchanged,100000,5
yihI,1747,591,-1.563649572739227,-1156,Unchanged,100000,5
yihA,1405,982,-0.5167752007935955,-423,Unchanged,100000,5
spf,1,1,0.0,0,Unchanged,100000,5
polA,6942,4346,-0.6756631906473631,-2596,Unchanged,100000,5
yihG,94,663,2.81827620843495,569,Unchanged,100000,5
yihF,73,909,3.6383119253140896,836,Unchanged,100000,5
dsbA,3208,1199,-1.4198424830406966,-2009,Unchanged,100000,5
srkA,1460,1400,-0.060541541935050854,-60,Unchanged,100000,5
yihD,1200,263,-2.1898997012035784,-937,Unchanged,100000,5
mobA,482,536,0.15319985422781088,54,Unchanged,100000,5
mobB,199,411,1.046369963138034,212,Unchanged,100000,5
hemG,824,961,0.22189209359053216,137,Unchanged,100000,5
trkH,2179,2871,0.39788713409127496,692,Unchanged,100000,5
yigZ,910,988,0.11864449649861893,78,Unchanged,100000,5
pepQ,7192,4804,-0.5821568698088132,-2388,Unchanged,100000,5
fadB,83,4238,5.674128441025245,4155,Unchanged,100000,5
fadA,113,1989,4.137648598418556,1876,Unchanged,100000,5
fre,2208,2326,0.07511092469504942,118,Unchanged,100000,5
ubiD,3612,3922,0.11879164271129077,310,Unchanged,100000,5
rfaH,413,538,0.38146439113717884,125,Unchanged,100000,5
tatC,2151,1476,-0.5433148033626648,-675,Unchanged,100000,5
tatB,2415,1601,-0.5930498812068785,-814,Unchanged,100000,5
tatA,1202,482,-1.318331844481224,-720,Unchanged,100000,5
ubiB,2176,2923,0.4257712725557133,747,Unchanged,100000,5
ubiJ,1465,1552,0.08322789287751733,87,Unchanged,100000,5
ubiE,2522,1969,-0.3571051644266662,-553,Unchanged,100000,5
rmuC,764,2777,1.8618826337830974,2013,Unchanged,100000,5
udp,4338,3195,-0.44121412183791714,-1143,Unchanged,100000,5
ysgA,990,1785,0.85042364394949,795,Unchanged,100000,5
metE,151815,8934,-4.086864277642487,-142881,Downregulated,100000,5
metR,1649,1797,0.12399901007247463,148,Unchanged,100000,5
bioP,168,1461,3.120423040024738,1293,Unchanged,100000,5
yigL,1041,1303,0.3238670152687173,262,Unchanged,100000,5
pldB,1659,1719,0.05125565852219775,60,Unchanged,100000,5
rhtB,317,927,1.5480864984861236,610,Unchanged,100000,5
rhtC,1200,1291,0.1054545948113099,91,Unchanged,100000,5
recQ,2236,4352,0.9607583684071493,2116,Unchanged,100000,5
pldA,1157,1401,0.2760680913233281,244,Unchanged,100000,5
yigI,35,564,4.010268335453827,529,Unchanged,100000,5
rarD,35,1308,5.223863808553117,1273,Unchanged,100000,5
yigG,19,41,1.1096244911744981,22,Unchanged,100000,5
yigF,51,39,-0.38702312310924736,-12,Unchanged,100000,5
corA,1730,1625,-0.09033231972090777,-105,Unchanged,100000,5
uvrD,4390,4846,0.1425734650286259,456,Unchanged,100000,5
yigB,1270,1401,0.14162845877128982,131,Unchanged,100000,5
xerC,1449,1497,0.04701662650148736,48,Unchanged,100000,5
yigA,1139,1302,0.19296170145752364,163,Unchanged,100000,5
dapF,2502,1799,-0.4758866029143375,-703,Unchanged,100000,5
cyaY,526,360,-0.5470658929626278,-166,Unchanged,100000,5
cyaA,19913,8497,-1.228685117159587,-11416,Unchanged,100000,5
hemC,4656,3040,-0.6150197345773359,-1616,Unchanged,100000,5
hemD,2000,1464,-0.4500844463780446,-536,Unchanged,100000,5
hemX,3758,2514,-0.5799804169995477,-1244,Unchanged,100000,5
hemY,3585,2489,-0.5264068886082314,-1096,Unchanged,100000,5
aslA,190,1831,3.268560467466389,1641,Unchanged,100000,5
aslB,67,1339,4.320851054866538,1272,Unchanged,100000,5
yifK,1189,1944,0.7092795038601252,755,Unchanged,100000,5
rffM,364,754,1.0506260730699681,390,Unchanged,100000,5
wzyE,423,1677,1.9871531204443966,1254,Unchanged,100000,5
wzxE,861,1705,0.9856865965146908,844,Unchanged,100000,5
wecE,1198,1202,0.004808987922399752,4,Unchanged,100000,5
rffC,535,801,0.5822633511202008,266,Unchanged,100000,5
rffH,1371,1245,-0.1390828288237825,-126,Unchanged,100000,5
rffG,1148,1197,0.06030051026781422,49,Unchanged,100000,5
wecC,1649,1850,0.1659338719662074,201,Unchanged,100000,5
wecB,1558,1501,-0.05377125644098082,-57,Unchanged,100000,5
wzzE,1756,1541,-0.1884259830205729,-215,Unchanged,100000,5
rfe,2529,1782,-0.5050697001413166,-747,Unchanged,100000,5
rho,16327,6259,-1.3832556462639225,-10068,Unchanged,100000,5
trxA,4974,1611,-1.6264500135103377,-3363,Unchanged,100000,5
rhlB,9617,4307,-1.1589035953510602,-5310,Unchanged,100000,5
gpp,4838,3572,-0.437678688858702,-1266,Unchanged,100000,5
rep,2378,3712,0.6424479953819163,1334,Unchanged,100000,5
yifN,148,317,1.0988856645104577,169,Unchanged,100000,5
ppiC,458,285,-0.68438567904484,-173,Unchanged,100000,5
ilvC,6527,7258,0.15315201751530103,731,Unchanged,100000,5
ilvY,298,1789,2.5857691515897465,1491,Unchanged,100000,5
ilvA,2139,6251,1.5471505200137825,4112,Unchanged,100000,5
ilvD,2843,7254,1.3513626462927524,4411,Unchanged,100000,5
ilvE,2849,3534,0.31084641822776565,685,Unchanged,100000,5
ilvM,57,152,1.4150374992788437,95,Unchanged,100000,5
ilvL,5,1,-2.321928094887362,-4,Unchanged,100000,5
yifB,119,1868,3.9724609764017185,1749,Unchanged,100000,5
maoP,2495,247,-3.336456868639945,-2248,Unchanged,100000,5
yieP,1498,800,-0.9049657186840264,-698,Unchanged,100000,5
hsrA,532,1203,1.177138491674887,671,Unchanged,100000,5
rbsR,261,826,1.6620919748495608,565,Unchanged,100000,5
rbsK,955,894,-0.09522590173979334,-61,Unchanged,100000,5
rbsB,965,1040,0.10798268087301181,75,Unchanged,100000,5
rbsC,372,847,1.1870593482241671,475,Unchanged,100000,5
rbsA,354,1341,1.9214879718214766,987,Unchanged,100000,5
rbsD,178,276,0.6327910258117713,98,Unchanged,100000,5
kup,1100,2089,0.9253089686550864,989,Unchanged,100000,5
ravA,3473,2132,-0.7039749726229158,-1341,Unchanged,100000,5
viaA,1679,1845,0.13601858601072842,166,Unchanged,100000,5
asnA,9999,1668,-2.583664529386741,-8331,Unchanged,100000,5
asnC,246,265,0.10733404411132155,19,Unchanged,100000,5
mioC,1426,709,-1.008116449204372,-717,Unchanged,100000,5
mnmG,5984,3809,-0.6516978873242968,-2175,Unchanged,100000,5
rsmG,492,515,0.0659141167313407,23,Unchanged,100000,5
atpI,2245,1032,-1.121272474205255,-1213,Unchanged,100000,5
atpB,9110,2765,-1.7201715735673437,-6345,Unchanged,100000,5
atpE,5496,1686,-1.7047774678760177,-3810,Unchanged,100000,5
atpF,13857,5874,-1.2381997812453418,-7983,Unchanged,100000,5
atpH,7853,2508,-1.6467065489612145,-5345,Unchanged,100000,5
atpA,51387,15621,-1.7179166167467441,-35766,Unchanged,100000,5
atpG,16560,4776,-1.7938279311218825,-11784,Unchanged,100000,5
atpD,33969,10488,-1.6954791572393584,-23481,Unchanged,100000,5
atpC,6559,1406,-2.2218792806442558,-5153,Unchanged,100000,5
glmU,7570,2271,-1.7369655941662063,-5299,Unchanged,100000,5
glmS,12007,3506,-1.7759778313677734,-8501,Unchanged,100000,5
pstS,1038,2492,1.2634976246661211,1454,Unchanged,100000,5
pstC,536,1468,1.4535470623854403,932,Unchanged,100000,5
pstA,473,1526,1.6898428734951354,1053,Unchanged,100000,5
pstB,650,1187,0.8688083117260899,537,Unchanged,100000,5
phoU,715,840,0.23244608600037084,125,Unchanged,100000,5
bglG,5,424,6.405992359675837,419,Unchanged,100000,5
bglF,59,1846,4.967543788283933,1787,Unchanged,100000,5
bglB,45,1355,4.9122240399115595,1310,Unchanged,100000,5
bglH,41,1037,4.660648174195142,996,Unchanged,100000,5
yieL,57,1066,4.225101708594434,1009,Unchanged,100000,5
yieK,52,704,3.758991900496205,652,Unchanged,100000,5
cbrC,123,406,1.7228214118459364,283,Unchanged,100000,5
cbrB,41,199,2.279072615925565,158,Unchanged,100000,5
yieH,349,562,0.6873430940112738,213,Unchanged,100000,5
adeP,3864,2057,-0.9095533003108393,-1807,Unchanged,100000,5
yieF,2244,796,-1.495232340065144,-1448,Unchanged,100000,5
yieE,1616,1097,-0.5588636723486019,-519,Unchanged,100000,5
yidZ,274,1110,2.0183118782769416,836,Unchanged,100000,5
mdtL,89,1617,4.183370532507264,1528,Unchanged,100000,5
tnaB,83,1333,4.005421633742048,1250,Unchanged,100000,5
tnaA,470,1770,1.9130166984053603,1300,Unchanged,100000,5
tnaC,1,1,0.0,0,Unchanged,100000,5
mnmE,1854,3190,0.7829151800267009,1336,Unchanged,100000,5
yidC,10512,5470,-0.9424244426424108,-5042,Unchanged,100000,5
rnpA,2093,1162,-0.8489622428511804,-931,Unchanged,100000,5
rpmH,189,26,-2.8618027060799807,-163,Unchanged,100000,5
dnaA,5764,6098,0.08126581483500073,334,Unchanged,100000,5
dnaN,3270,3696,0.17667412103061272,426,Unchanged,100000,5
recF,909,2547,1.4864467600800875,1638,Unchanged,100000,5
gyrB,7976,8286,0.05501041058101118,310,Unchanged,100000,5
yidB,364,505,0.4723449374404608,141,Unchanged,100000,5
yidA,1879,1853,-0.020102185392789726,-26,Unchanged,100000,5
yidX,161,616,1.9358696625802845,455,Unchanged,100000,5
dgoK,141,1492,3.4034804678564443,1351,Unchanged,100000,5
dgoT,128,2796,4.449148645375437,2668,Unchanged,100000,5
cbrA,60,1845,4.94251450533924,1785,Unchanged,100000,5
yidR,743,2342,1.656306959962619,1599,Unchanged,100000,5
yidQ,507,566,0.15881630582854173,59,Unchanged,100000,5
ibpA,1901,1915,0.010585860163767334,14,Unchanged,100000,5
ibpB,1602,1879,0.2300909190113455,277,Unchanged,100000,5
yidE,1562,3542,1.181169758609935,1980,Unchanged,100000,5
yidP,33,1110,5.0719498418790145,1077,Unchanged,100000,5
glvC,49,3064,5.966490737809749,3015,Unchanged,100000,5
yidL,84,792,3.237039197300849,708,Unchanged,100000,5
yidK,33,3442,6.70463726268175,3409,Unchanged,100000,5
yidJ,85,2930,5.1072940131719085,2845,Unchanged,100000,5
yidI,157,881,2.4883774600287865,724,Unchanged,100000,5
yidH,104,569,2.4518451241654895,465,Unchanged,100000,5
yidG,69,634,3.199814573361238,565,Unchanged,100000,5
yidF,118,977,3.049571702606544,859,Unchanged,100000,5
emrD,362,2620,2.8555052093416076,2258,Unchanged,100000,5
ivbL,2,1,-1.0,-1,Unchanged,100000,5
ilvB,2579,4890,0.923022692050382,2311,Unchanged,100000,5
ilvN,261,440,0.7534537169547751,179,Unchanged,100000,5
uhpA,1530,1855,0.2778875339281514,325,Unchanged,100000,5
uhpB,725,3971,2.4534494606221715,3246,Unchanged,100000,5
uhpC,293,2916,3.3150181499046893,2623,Unchanged,100000,5
uhpT,121,2792,4.528219988935057,2671,Unchanged,100000,5
adeD,284,3768,3.729836130108101,3484,Unchanged,100000,5
adeQ,29,2189,6.238075244053374,2160,Unchanged,100000,5
yicN,133,757,2.508867054484542,624,Unchanged,100000,5
nepI,74,2570,5.1180992784522905,2496,Unchanged,100000,5
nlpA,741,1189,0.682203267439822,448,Unchanged,100000,5
yicL,776,1500,0.9508339431961156,724,Unchanged,100000,5
setC,33,1329,5.3317312699177215,1296,Unchanged,100000,5
yicJ,417,2121,2.3466253320858916,1704,Unchanged,100000,5
yicI,1128,3650,1.6941293962559485,2522,Unchanged,100000,5
yicH,2902,3471,0.25830384576190163,569,Unchanged,100000,5
xanP,2237,4150,0.8915460800625307,1913,Unchanged,100000,5
gltS,1632,2468,0.5967013371779223,836,Unchanged,100000,5
recG,2589,3699,0.514740335223884,1110,Unchanged,100000,5
trmH,1288,1093,-0.23683919244271237,-195,Unchanged,100000,5
spoT,8066,4697,-0.7801138121480885,-3369,Unchanged,100000,5
rpoZ,1832,499,-1.8763077827596835,-1333,Unchanged,100000,5
gmk,1941,875,-1.1494451959939727,-1066,Unchanged,100000,5
ligB,164,2345,3.837820202784655,2181,Unchanged,100000,5
yicG,59,579,3.294776488627395,520,Unchanged,100000,5
dinD,187,612,1.7104933828050153,425,Unchanged,100000,5
yicC,2695,1634,-0.7218772894941843,-1061,Unchanged,100000,5
rph,1482,1167,-0.3447408865984856,-315,Unchanged,100000,5
pyrE,218,712,1.7075491061894714,494,Unchanged,100000,5
slmA,1552,783,-0.9870443448960871,-769,Unchanged,100000,5
dut,2074,802,-1.3707417523583054,-1272,Unchanged,100000,5
dfp,1410,2259,0.6799891081069284,849,Unchanged,100000,5
yicR,125,535,2.097610796626422,410,Unchanged,100000,5
rpmB,4413,578,-2.9326183494753075,-3835,Unchanged,100000,5
rpmG,394,33,-3.5776577000979226,-361,Unchanged,100000,5
mutM,346,964,1.4782611085932371,618,Unchanged,100000,5
coaD,486,455,-0.09508976851972227,-31,Unchanged,100000,5
waaA,1954,1881,-0.0549306184451902,-73,Unchanged,100000,5
waaQ,1321,1036,-0.3506064635602737,-285,Unchanged,100000,5
waaG,1122,1171,0.06166839989242229,49,Unchanged,100000,5
waaP,522,600,0.2009126939259963,78,Unchanged,100000,5
waaS,596,124,-2.2649722100752863,-472,Unchanged,100000,5
waaB,819,655,-0.3223685452161959,-164,Unchanged,100000,5
waaO,758,478,-0.6651872301903431,-280,Unchanged,100000,5
waaJ,573,241,-1.2495019925269433,-332,Unchanged,100000,5
waaY,324,199,-0.703225382340976,-125,Unchanged,100000,5
waaZ,462,191,-1.2743202133803089,-271,Unchanged,100000,5
waaU,601,230,-1.3857311297668102,-371,Unchanged,100000,5
waaL,965,267,-1.8536892004678887,-698,Unchanged,100000,5
waaC,1000,1429,0.5150059164337295,429,Unchanged,100000,5
waaF,2318,1918,-0.273277845988341,-400,Unchanged,100000,5
rfaD,5066,2415,-1.0688238879893655,-2651,Unchanged,100000,5
htrL,436,534,0.29251160691062766,98,Unchanged,100000,5
kbl,2767,2368,-0.2246535629810049,-399,Unchanged,100000,5
tdh,2485,1837,-0.43589422533829897,-648,Unchanged,100000,5
waaH,48,1252,4.705056346211462,1204,Unchanged,100000,5
yibQ,874,1777,1.02373849652808,903,Unchanged,100000,5
envC,2596,2798,0.10810557916561489,202,Unchanged,100000,5
gpmM,25148,9653,-1.3813943842068739,-15495,Unchanged,100000,5
yibN,1884,721,-1.3857278003719606,-1163,Unchanged,100000,5
grxC,501,377,-0.4102460799265441,-124,Unchanged,100000,5
secB,4683,1272,-1.8803343674147095,-3411,Unchanged,100000,5
gpsA,6796,3582,-0.9239205151982594,-3214,Unchanged,100000,5
cysE,2197,2354,0.09957945061516768,157,Unchanged,100000,5
trmL,404,793,0.9729655729521837,389,Unchanged,100000,5
lldD,149,2275,3.9324823095112595,2126,Unchanged,100000,5
lldR,36,1328,5.205114429904612,1292,Unchanged,100000,5
lldP,71,2903,5.35358173712198,2832,Unchanged,100000,5
yibL,587,565,-0.05510963580750217,-22,Unchanged,100000,5
mtlR,485,1057,1.123918724308193,572,Unchanged,100000,5
mtlD,2605,3431,0.39734575339178413,826,Unchanged,100000,5
mtlA,2167,4386,1.0172066585799198,2219,Unchanged,100000,5
yibI,10,368,5.20163386116965,358,Unchanged,100000,5
yibH,98,2041,4.380350622917511,1943,Unchanged,100000,5
yibG,16,49,1.6147098441152081,33,Unchanged,100000,5
yibJ,130,1063,3.03155806850265,933,Unchanged,100000,5
yibA,450,424,-0.08586073665383794,-26,Unchanged,100000,5
rhsA,366,10019,4.774751061072336,9653,Unchanged,100000,5
yibF,208,1199,2.5271762252731316,991,Unchanged,100000,5
selA,1966,3509,0.835796626061586,1543,Unchanged,100000,5
selB,3610,4915,0.4451925794534096,1305,Unchanged,100000,5
yiaY,28,1916,6.096526923678576,1888,Unchanged,100000,5
aldB,438,3256,2.8940979246650738,2818,Unchanged,100000,5
yiaW,9,268,4.89616418901546,259,Unchanged,100000,5
yiaV,35,2012,5.845131572860561,1977,Unchanged,100000,5
yiaU,248,1570,2.6623525333921143,1322,Unchanged,100000,5
yiaT,41,1021,4.638215146259718,980,Unchanged,100000,5
sgbE,76,1240,4.028196891830652,1164,Unchanged,100000,5
sgbU,34,1839,5.7572429231615985,1805,Unchanged,100000,5
sgbH,30,1274,5.408258966647782,1244,Unchanged,100000,5
lyxK,57,3738,6.035160839580416,3681,Unchanged,100000,5
yiaO,19,1897,6.64157644996789,1878,Unchanged,100000,5
yiaN,5,1823,8.510170751151772,1818,Unchanged,100000,5
yiaM,4,369,6.527477006060396,365,Unchanged,100000,5
yiaL,4,501,6.968666793195208,497,Unchanged,100000,5
yiaK,31,1747,5.816467582529884,1716,Unchanged,100000,5
plaR,1332,1498,0.1694435413874888,166,Unchanged,100000,5
ysaA,128,592,2.2094533656289497,464,Unchanged,100000,5
avtA,4799,3973,-0.27250501962809504,-826,Unchanged,100000,5
malS,638,3422,2.423211430724544,2784,Unchanged,100000,5
bax,3282,3500,0.09277968320597837,218,Unchanged,100000,5
xylR,869,1948,1.1645655952679421,1079,Unchanged,100000,5
xylH,947,2923,1.6260134983376677,1976,Unchanged,100000,5
xylG,1210,3135,1.3734583955274444,1925,Unchanged,100000,5
xylF,2117,3345,0.659984941521234,1228,Unchanged,100000,5
xylA,13390,26193,0.9680253467260126,12803,Unchanged,100000,5
xylB,2209,6519,1.5612572565471643,4310,Unchanged,100000,5
yiaB,29,203,2.807354922057604,174,Unchanged,100000,5
yiaA,38,225,2.5658536777734517,187,Unchanged,100000,5
wecH,152,1242,3.0305219447768956,1090,Unchanged,100000,5
glyQ,3658,2820,-0.37535991246256056,-838,Unchanged,100000,5
glyS,11607,7367,-0.6558459868776659,-4240,Unchanged,100000,5
insK,34,542,3.994686200103532,508,Unchanged,100000,5
insJ,54,442,3.033015057227963,388,Unchanged,100000,5
cspA,215,104,-1.0477531314483681,-111,Unchanged,100000,5
yiaG,504,202,-1.3190684407481217,-302,Unchanged,100000,5
yiaF,4325,1494,-1.5335199846222123,-2831,Unchanged,100000,5
ghrB,4650,2724,-0.7715040128706849,-1926,Unchanged,100000,5
yiaD,712,957,0.4266416835196278,245,Unchanged,100000,5
bisC,2467,4695,0.9283674422410138,2228,Unchanged,100000,5
yiaC,184,610,1.7291034763932356,426,Unchanged,100000,5
tag,423,891,1.074767768401972,468,Unchanged,100000,5
yhjY,306,945,1.6267826764157833,639,Unchanged,100000,5
yhjX,239,2161,3.1766165488787586,1922,Unchanged,100000,5
eptB,570,3013,2.4021668485423593,2443,Unchanged,100000,5
dppA,43323,15745,-1.4602393916424727,-27578,Unchanged,100000,5
dppB,4233,3361,-0.33278994601041856,-872,Unchanged,100000,5
dppC,3717,2966,-0.32562009040712725,-751,Unchanged,100000,5
dppD,4792,3524,-0.44341398386837216,-1268,Unchanged,100000,5
dppF,5587,3683,-0.6011924230542905,-1904,Unchanged,100000,5
yhjV,149,2135,3.8408518340456914,1986,Unchanged,100000,5
bcsG,551,3352,2.604897925128194,2801,Unchanged,100000,5
bcsF,22,87,1.983511877211431,65,Unchanged,100000,5
bcsE,1412,3250,1.2026996295319987,1838,Unchanged,100000,5
yhjR,8,50,2.643856189774725,42,Unchanged,100000,5
bcsQ,98,1274,3.700439718141092,1176,Unchanged,100000,5
bcsA,220,6265,4.831739080684563,6045,Unchanged,100000,5
bcsB,286,5746,4.328470940754134,5460,Unchanged,100000,5
bcsZ,122,2522,4.369615222765334,2400,Unchanged,100000,5
bcsC,901,9157,3.3452760114038442,8256,Unchanged,100000,5
pdeK,1176,4903,2.0597767014493207,3727,Unchanged,100000,5
dctA,854,3817,2.1601312115950675,2963,Unchanged,100000,5
yhjJ,1582,3047,0.9456399002136937,1465,Unchanged,100000,5
kdgK,2716,2589,-0.06908851434462052,-127,Unchanged,100000,5
pdeH,154,1466,3.2508828474389104,1312,Unchanged,100000,5
yhjG,561,4057,2.85434062659748,3496,Unchanged,100000,5
yhjE,679,3384,2.3172460888752178,2705,Unchanged,100000,5
yhjD,1063,1813,0.7702373282130534,750,Unchanged,100000,5
rcdB,615,1504,1.2901462514510351,889,Unchanged,100000,5
yhjB,72,636,3.142957953842043,564,Unchanged,100000,5
treF,1655,3234,0.9664884617790815,1579,Unchanged,100000,5
ccp,626,2106,1.7502708740930986,1480,Unchanged,100000,5
gadA,84374,2314,-5.188337728783573,-82060,Unchanged,100000,5
gadX,7380,635,-3.5387923192882305,-6745,Unchanged,100000,5
gadW,1920,597,-1.6853034743437136,-1323,Unchanged,100000,5
mdtF,23634,5264,-2.1666324285999576,-18370,Unchanged,100000,5
mdtE,10863,1846,-2.5569481245515595,-9017,Unchanged,100000,5
gadE,8655,52,-7.378878386112909,-8603,Unchanged,100000,5
hdeD,19860,681,-4.866067014403665,-19179,Unchanged,100000,5
hdeA,47430,300,-7.304693557471008,-47130,Unchanged,100000,5
hdeB,21226,176,-6.914113284587107,-21050,Unchanged,100000,5
yhiD,1758,442,-1.9918167957519726,-1316,Unchanged,100000,5
dctR,778,294,-1.4039540001498274,-484,Unchanged,100000,5
slp,18758,480,-5.288327798153594,-18278,Unchanged,100000,5
insH11,2861,6302,1.1392902566943568,3441,Unchanged,100000,5
yhiS,30,1163,5.276744785864699,1133,Unchanged,100000,5
arsC,73,546,2.9029325820398353,473,Unchanged,100000,5
arsB,114,2219,4.28280393803227,2105,Unchanged,100000,5
arsR,52,495,3.25084499682588,443,Unchanged,100000,5
gor,3774,2762,-0.4503811033423945,-1012,Unchanged,100000,5
rlmJ,707,1402,0.9877042292012244,695,Unchanged,100000,5
prlC,5483,5545,0.01622198675227321,62,Unchanged,100000,5
rsmJ,413,1425,1.786748232520021,1012,Unchanged,100000,5
dtpB,380,2238,2.5581387126454462,1858,Unchanged,100000,5
uspA,13688,2505,-2.4500291564068424,-11183,Unchanged,100000,5
uspB,357,352,-0.020348645391802367,-5,Unchanged,100000,5
pitA,5346,3507,-0.6082224069902658,-1839,Unchanged,100000,5
yhiN,643,2561,1.993816610269521,1918,Unchanged,100000,5
yhiM,3659,1478,-1.3078031461929363,-2181,Unchanged,100000,5
yhiJ,177,922,2.3810173903463405,745,Unchanged,100000,5
yhiI,3338,4509,0.433823555274922,1171,Unchanged,100000,5
rbbA,5282,9113,0.7868417659846224,3831,Unchanged,100000,5
yhhJ,1056,3283,1.6364049152145272,2227,Unchanged,100000,5
yhhI,45,1287,4.837943241891027,1242,Unchanged,100000,5
yhhH,12,43,1.8413022539809418,31,Unchanged,100000,5
rhsB,323,9201,4.832184597294251,8878,Unchanged,100000,5
nikR,249,865,1.7965543904560062,616,Unchanged,100000,5
nikE,172,2038,3.566673581463716,1866,Unchanged,100000,5
nikD,159,1933,3.6037429669268803,1774,Unchanged,100000,5
nikC,118,2243,4.248570855724431,2125,Unchanged,100000,5
nikB,152,2281,3.907523217868552,2129,Unchanged,100000,5
nikA,585,4397,2.9100110027418804,3812,Unchanged,100000,5
acpT,303,1152,1.9267510179693614,849,Unchanged,100000,5
yhhT,245,2363,3.269765974971276,2118,Unchanged,100000,5
yhhS,753,3765,2.321928094887362,3012,Unchanged,100000,5
dcrB,2236,1765,-0.3412520046846474,-471,Unchanged,100000,5
yhhQ,321,1525,2.248164040215308,1204,Unchanged,100000,5
tusA,421,386,-0.12521938579831574,-35,Unchanged,100000,5
zntA,3321,8642,1.3797475080870254,5321,Unchanged,100000,5
yhhN,1888,1916,0.021238796374339088,28,Unchanged,100000,5
yhhM,339,570,0.7496766459157601,231,Unchanged,100000,5
yhhL,50,302,2.594548549550354,252,Unchanged,100000,5
rsmD,412,1156,1.4884251553174606,744,Unchanged,100000,5
ftsY,2698,5500,1.0275412703511169,2802,Unchanged,100000,5
ftsE,1354,2543,0.9093037231151095,1189,Unchanged,100000,5
ftsX,2279,3607,0.6623984985222731,1328,Unchanged,100000,5
rpoH,8677,7277,-0.2538525184568444,-1400,Unchanged,100000,5
livJ,931,5040,2.436570660828485,4109,Unchanged,100000,5
panZ,261,666,1.3514723705013778,405,Unchanged,100000,5
livK,1281,3323,1.375215817350385,2042,Unchanged,100000,5
livH,460,2082,2.178264302355042,1622,Unchanged,100000,5
livM,750,3537,2.2375637183176758,2787,Unchanged,100000,5
livG,384,1971,2.3597495603223297,1587,Unchanged,100000,5
livF,367,1917,2.3849983688249377,1550,Unchanged,100000,5
ugpB,66,3358,5.668992395578576,3292,Unchanged,100000,5
ugpA,14,1800,7.006426269159433,1786,Unchanged,100000,5
ugpE,16,1914,6.902375114486025,1898,Unchanged,100000,5
ugpC,224,3157,3.816983623255381,2933,Unchanged,100000,5
ugpQ,405,1696,2.0661423567912123,1291,Unchanged,100000,5
yhhA,691,681,-0.02103091237618736,-10,Unchanged,100000,5
ggt,726,4134,2.5094969354296968,3408,Unchanged,100000,5
yrhB,29,196,2.756728848987636,167,Unchanged,100000,5
insB6,27,582,4.429987840744816,555,Unchanged,100000,5
insA6,19,138,2.8605969433345835,119,Unchanged,100000,5
yrhA,64,1403,4.454299293619899,1339,Unchanged,100000,5
yhhZ,7,378,5.754887502163468,371,Unchanged,100000,5
yhhY,429,721,0.7490216117412769,292,Unchanged,100000,5
yhhX,2696,2337,-0.20616276239903314,-359,Unchanged,100000,5
yhhW,680,1364,1.0042369928864707,684,Unchanged,100000,5
gntR,1344,2156,0.6818240399737453,812,Unchanged,100000,5
gntK,215,998,2.2147031557478,783,Unchanged,100000,5
yhgN,306,1086,1.8274205451117096,780,Unchanged,100000,5
asd,23151,4703,-2.299421274271237,-18448,Unchanged,100000,5
glgB,28851,8488,-1.7651247633993101,-20363,Unchanged,100000,5
glgX,13428,6106,-1.13694494749077,-7322,Unchanged,100000,5
glgC,8727,4002,-1.1247646299157215,-4725,Unchanged,100000,5
glgA,10568,4664,-1.1800626780463312,-5904,Unchanged,100000,5
glgP,16457,6670,-1.3029426996386781,-9787,Unchanged,100000,5
yzgL,47,115,1.2909011992667379,68,Unchanged,100000,5
glpD,30707,17890,-0.7794141839751701,-12817,Unchanged,100000,5
glpE,324,612,0.9175378398080271,288,Unchanged,100000,5
glpG,1232,2371,0.9444934067871066,1139,Unchanged,100000,5
glpR,657,2284,1.7975973750405132,1627,Unchanged,100000,5
rtcR,143,4617,5.0128686802709765,4474,Unchanged,100000,5
rtcB,370,3291,3.152928850608037,2921,Unchanged,100000,5
malT,10083,14588,0.5328571563069545,4505,Unchanged,100000,5
malP,5521,6437,0.22145886771777157,916,Unchanged,100000,5
malQ,4684,5326,0.18531135270939908,642,Unchanged,100000,5
gntT,1015,3421,1.7529383766953612,2406,Unchanged,100000,5
nfuA,2759,1924,-0.520036657583231,-835,Unchanged,100000,5
yhgH,629,1596,1.3433287293430567,967,Unchanged,100000,5
bioH,668,1764,1.4009305530834684,1096,Unchanged,100000,5
rpnA,177,1433,3.0172173441791483,1256,Unchanged,100000,5
feoC,56,215,1.9408379275318561,159,Unchanged,100000,5
feoB,2414,5919,1.2939277806896936,3505,Unchanged,100000,5
feoA,72,142,0.9798221180623697,70,Unchanged,100000,5
yhgF,6540,7440,0.18601198560994894,900,Unchanged,100000,5
greB,449,909,1.01756484945296,460,Unchanged,100000,5
ompR,1923,2016,0.06813687616001932,93,Unchanged,100000,5
envZ,1475,3630,1.299254593746547,2155,Unchanged,100000,5
pck,8165,6843,-0.25482393841576373,-1322,Unchanged,100000,5
yhgE,711,2977,2.065937756618621,2266,Unchanged,100000,5
hslO,1596,2535,0.667525095668357,939,Unchanged,100000,5
hslR,435,945,1.1192989283723445,510,Unchanged,100000,5
yrfG,707,1153,0.705610392842373,446,Unchanged,100000,5
igaA,1772,5675,1.6792417885106214,3903,Unchanged,100000,5
nudE,580,1060,0.8699394594356271,480,Unchanged,100000,5
mrcA,1704,6041,1.8258620510107209,4337,Unchanged,100000,5
hofM,105,1517,3.852759852580911,1412,Unchanged,100000,5
hofN,39,875,4.487736987857443,836,Unchanged,100000,5
hofO,34,698,4.359620384959313,664,Unchanged,100000,5
hofP,36,553,3.9412106687923947,517,Unchanged,100000,5
hofQ,161,2253,3.806714720120811,2092,Unchanged,100000,5
aroK,3467,1619,-1.0985848509002676,-1848,Unchanged,100000,5
aroB,5938,3294,-0.8501365382603008,-2644,Unchanged,100000,5
damX,6548,4044,-0.6952713245711387,-2504,Unchanged,100000,5
dam,905,1159,0.3568908690359041,254,Unchanged,100000,5
rpe,2973,1410,-1.0762243006214884,-1563,Unchanged,100000,5
gph,2327,1466,-0.6665861072715368,-861,Unchanged,100000,5
trpS,5478,2391,-1.1960351359937502,-3087,Unchanged,100000,5
yhfZ,213,1677,2.976957353338508,1464,Unchanged,100000,5
yhfY,42,335,2.9956998625663744,293,Unchanged,100000,5
yhfX,59,2288,5.277228287416548,2229,Unchanged,100000,5
yhfW,50,2553,5.674121632632394,2503,Unchanged,100000,5
php,52,1707,5.036807624886646,1655,Unchanged,100000,5
yhfU,23,377,4.034858757211651,354,Unchanged,100000,5
yhfT,140,3035,4.438197784198078,2895,Unchanged,100000,5
yhfS,110,2446,4.474848975002727,2336,Unchanged,100000,5
frlR,517,1397,1.4340958350945283,880,Unchanged,100000,5
frlD,136,1943,3.8366073443350053,1807,Unchanged,100000,5
frlB,61,1723,4.819969648662062,1662,Unchanged,100000,5
frlA,19,2478,7.027032958697016,2459,Unchanged,100000,5
yhfL,5,10,1.0,5,Unchanged,100000,5
cysG,1554,2510,0.6917008604304243,956,Unchanged,100000,5
nirC,657,1034,0.6542709099926051,377,Unchanged,100000,5
nirD,656,394,-0.7355001851617075,-262,Unchanged,100000,5
nirB,10239,5867,-0.8033799231486566,-4372,Unchanged,100000,5
tsgA,224,1621,2.8553134534599374,1397,Unchanged,100000,5
ppiA,1448,1023,-0.5012554573378766,-425,Unchanged,100000,5
yhfG,38,34,-0.1604646721932461,-4,Unchanged,100000,5
fic,842,660,-0.3513542088205804,-182,Unchanged,100000,5
pabA,146,719,2.300023401559281,573,Unchanged,100000,5
argD,1848,6525,1.8200131449285517,4677,Unchanged,100000,5
yhfK,1403,2709,0.9492453845821154,1306,Unchanged,100000,5
crp,6168,1746,-1.8207492062855943,-4422,Unchanged,100000,5
yhfA,1356,527,-1.3634823114991292,-829,Unchanged,100000,5
prkB,1319,1280,-0.043300754364182376,-39,Unchanged,100000,5
yheU,93,68,-0.45169596985769195,-25,Unchanged,100000,5
yheT,1403,1497,0.0935592124385177,94,Unchanged,100000,5
yheS,3561,3585,0.009690683226204215,24,Unchanged,100000,5
kefG,71,510,2.844606317354176,439,Unchanged,100000,5
kefB,229,2317,3.338838540767878,2088,Unchanged,100000,5
slyD,10267,2496,-2.040324850873917,-7771,Unchanged,100000,5
slyX,499,96,-2.3779335046161045,-403,Unchanged,100000,5
fkpA,5129,1554,-1.7226910675696074,-3575,Unchanged,100000,5
yheO,2832,1316,-1.1056617763477559,-1516,Unchanged,100000,5
tusD,1063,721,-0.5600704322902822,-342,Unchanged,100000,5
tusC,439,369,-0.250600123474962,-70,Unchanged,100000,5
tusB,318,223,-0.5119830553640508,-95,Unchanged,100000,5
rpsL,12880,2267,-2.5062762972611936,-10613,Unchanged,100000,5
rpsG,40203,8973,-2.16364084490506,-31230,Unchanged,100000,5
fusA,259693,76012,-1.772508027192603,-183681,Downregulated,100000,5
tufA,160805,46439,-1.79190345454288,-114366,Downregulated,100000,5
chiA,831,2716,1.7085630974743873,1885,Unchanged,100000,5
bfd,22,34,0.6280312226130421,12,Unchanged,100000,5
bfr,3471,318,-3.4482526945442906,-3153,Unchanged,100000,5
gspO,53,459,3.1144298888506086,406,Unchanged,100000,5
gspM,31,274,3.1438357725736514,243,Unchanged,100000,5
gspL,78,964,3.6274871173677132,886,Unchanged,100000,5
gspK,37,703,4.247927513443585,666,Unchanged,100000,5
gspJ,16,389,4.603626344986192,373,Unchanged,100000,5
gspI,9,213,4.564784618783526,204,Unchanged,100000,5
gspH,16,345,4.430452551665532,329,Unchanged,100000,5
gspG,8,222,4.794415866350106,214,Unchanged,100000,5
gspF,51,1045,4.356861884996749,994,Unchanged,100000,5
gspE,44,1138,4.692853223669284,1094,Unchanged,100000,5
gspD,161,1577,3.2920500666758934,1416,Unchanged,100000,5
gspC,25,343,3.7782085763980877,318,Unchanged,100000,5
gspA,50,1087,4.442280035252584,1037,Unchanged,100000,5
gspB,54,179,1.728928275100788,125,Unchanged,100000,5
rpsJ,10057,3779,-1.4121235901216238,-6278,Unchanged,100000,5
rplC,42078,15345,-1.455297488040335,-26733,Unchanged,100000,5
rplD,31887,10386,-1.618328241472831,-21501,Unchanged,100000,5
rplW,8356,3575,-1.224869250513994,-4781,Unchanged,100000,5
rplB,39272,12341,-1.6700417699882626,-26931,Unchanged,100000,5
rpsS,11292,3428,-1.7198620193371932,-7864,Unchanged,100000,5
rplV,5558,1516,-1.8742960810294704,-4042,Unchanged,100000,5
rpsC,44308,14383,-1.6232025832147647,-29925,Unchanged,100000,5
rplP,22826,6892,-1.7276834589420342,-15934,Unchanged,100000,5
rpmC,3854,1490,-1.3710442409461971,-2364,Unchanged,100000,5
rpsQ,9771,1997,-2.2906718876730867,-7774,Unchanged,100000,5
rplN,31865,7634,-2.061461569083948,-24231,Unchanged,100000,5
rplX,12642,2961,-2.0940683243609084,-9681,Unchanged,100000,5
rplE,55153,19803,-1.4777203582025369,-35350,Unchanged,100000,5
rpsN,16351,6471,-1.337318288921691,-9880,Unchanged,100000,5
rpsH,20946,9110,-1.2011518035844966,-11836,Unchanged,100000,5
rplF,39469,15343,-1.3631393680768504,-24126,Unchanged,100000,5
rplR,16562,6565,-1.3350099846171433,-9997,Unchanged,100000,5
rpsE,31390,10710,-1.5513465488318592,-20680,Unchanged,100000,5
rpmD,1969,803,-1.2939912183842393,-1166,Unchanged,100000,5
rplO,38072,15326,-1.3127491487962615,-22746,Unchanged,100000,5
secY,81723,25549,-1.677475340973498,-56174,Unchanged,100000,5
rpmJ,14,8,-0.8073549220576042,-6,Unchanged,100000,5
rpsM,22470,6025,-1.8989669780625833,-16445,Unchanged,100000,5
rpsK,20635,6328,-1.705271933421605,-14307,Unchanged,100000,5
rpsD,39080,11165,-1.8074472161459116,-27915,Unchanged,100000,5
rpoA,81897,23791,-1.783394691518744,-58106,Unchanged,100000,5
rplQ,10483,1884,-2.476180772934456,-8599,Unchanged,100000,5
yhdN,514,336,-0.6133071264151178,-178,Unchanged,100000,5
zntR,422,374,-0.1742047288195484,-48,Unchanged,100000,5
mscL,1527,334,-2.192780054322799,-1193,Unchanged,100000,5
trkA,1754,1350,-0.3776893405065398,-404,Unchanged,100000,5
rsmB,1846,1650,-0.16193652851259613,-196,Unchanged,100000,5
fmt,2838,1732,-0.7124356593338266,-1106,Unchanged,100000,5
def,1586,634,-1.322838025564571,-952,Unchanged,100000,5
smg,2402,915,-1.3923925025342294,-1487,Unchanged,100000,5
yrdD,1185,647,-0.8730494417931141,-538,Unchanged,100000,5
tsaC,588,550,-0.09638453642434239,-38,Unchanged,100000,5
aroE,882,771,-0.19404779564248634,-111,Unchanged,100000,5
yrdB,113,102,-0.1477536204436922,-11,Unchanged,100000,5
yrdA,1919,639,-1.586466875248386,-1280,Unchanged,100000,5
yhdZ,82,517,2.6564684656968507,435,Unchanged,100000,5
yhdY,42,886,4.398845465776258,844,Unchanged,100000,5
yhdX,40,807,4.334496768390418,767,Unchanged,100000,5
yhdW,87,801,3.202714936559982,714,Unchanged,100000,5
yhdV,77,61,-0.33604920313201503,-16,Unchanged,100000,5
acrF,280,3050,3.4453105103926442,2770,Unchanged,100000,5
acrE,8,1076,7.071462362556624,1068,Unchanged,100000,5
envR,6,359,5.902877533101895,353,Unchanged,100000,5
yhdU,6,13,1.1154772174199359,7,Unchanged,100000,5
yhdJ,87,856,3.2985234905524186,769,Unchanged,100000,5
fis,2042,284,-2.8460200313731194,-1758,Unchanged,100000,5
dusB,5968,1842,-1.6959744741639022,-4126,Unchanged,100000,5
prmA,614,1175,0.9363501960821826,561,Unchanged,100000,5
panF,300,1753,2.5467915902636573,1453,Unchanged,100000,5
yhdT,35,112,1.6780719051126378,77,Unchanged,100000,5
accC,15629,4037,-1.9528699805079672,-11592,Unchanged,100000,5
accB,4322,1068,-2.0167874251719535,-3254,Unchanged,100000,5
yhdH,1520,1361,-0.1594042568269532,-159,Unchanged,100000,5
csrD,2543,2901,0.19001883350789106,358,Unchanged,100000,5
mreB,10632,4009,-1.4070986871254039,-6623,Unchanged,100000,5
mreC,2373,1876,-0.33905227267857135,-497,Unchanged,100000,5
mreD,621,560,-0.14916644127551495,-61,Unchanged,100000,5
yhdE,929,892,-0.05863488646234817,-37,Unchanged,100000,5
rng,2994,2528,-0.2440777578813138,-466,Unchanged,100000,5
tldD,3850,2725,-0.4986022159179751,-1125,Unchanged,100000,5
aaeR,571,1150,1.0100712104688947,579,Unchanged,100000,5
aaeX,7,59,3.0752881273042374,52,Unchanged,100000,5
aaeA,88,979,3.4757334309663976,891,Unchanged,100000,5
aaeB,184,2827,3.9414942117741627,2643,Unchanged,100000,5
yhcO,68,108,0.667424660913129,40,Unchanged,100000,5
yhcN,39,171,2.1324502960236495,132,Unchanged,100000,5
argR,2895,1486,-0.9621292323380028,-1409,Unchanged,100000,5
mdh,52912,3353,-3.9800705623973305,-49559,Unchanged,100000,5
degS,984,1573,0.6767884500764468,589,Unchanged,100000,5
degQ,1658,2030,0.2920357205767883,372,Unchanged,100000,5
yhcB,3230,1259,-1.3592558818622706,-1971,Unchanged,100000,5
zapE,1290,1824,0.4997346638541252,534,Unchanged,100000,5
rplM,14631,2459,-2.5728847381609414,-12172,Unchanged,100000,5
rpsI,24032,3493,-2.7824181701194073,-20539,Unchanged,100000,5
sspA,7161,3029,-1.2413194890075603,-4132,Unchanged,100000,5
sspB,3922,1919,-1.0312348239967688,-2003,Unchanged,100000,5
dcuD,47,1991,5.404688654042865,1944,Unchanged,100000,5
nanR,1477,1729,0.2272680428774925,252,Unchanged,100000,5
nanA,112,1531,3.7729036454421836,1419,Unchanged,100000,5
nanT,149,3044,4.3525841230413835,2895,Unchanged,100000,5
nanE,107,1248,3.5439352324611013,1141,Unchanged,100000,5
nanK,343,1588,2.2109304309701456,1245,Unchanged,100000,5
yhcH,175,441,1.3334237337251917,266,Unchanged,100000,5
yhcG,71,1640,4.529732980000764,1569,Unchanged,100000,5
yhcF,131,553,2.0777126686972567,422,Unchanged,100000,5
insH10,4199,3723,-0.17358017198350417,-476,Unchanged,100000,5
yhcD,160,2481,3.9547779250050685,2321,Unchanged,100000,5
yhcA,21,409,4.2836396101629886,388,Unchanged,100000,5
gltF,128,612,2.2573878426926517,484,Unchanged,100000,5
gltD,13762,7198,-0.9350221414734571,-6564,Unchanged,100000,5
gltB,43846,23742,-0.885003762782498,-20104,Unchanged,100000,5
yhcC,678,1574,1.2150783623711425,896,Unchanged,100000,5
arcB,2328,4031,0.7920467249427957,1703,Unchanged,100000,5
elbB,1816,1414,-0.36098208248151614,-402,Unchanged,100000,5
mtgA,490,1060,1.113210610447991,570,Unchanged,100000,5
yrbL,13706,5128,-1.418339425042558,-8578,Unchanged,100000,5
npr,157,161,0.03629612922298996,4,Unchanged,100000,5
rapZ,4030,2115,-0.9301221754080176,-1915,Unchanged,100000,5
ptsN,2341,1144,-1.0330378823336233,-1197,Unchanged,100000,5
hpf,2711,892,-1.6037094979174071,-1819,Unchanged,100000,5
rpoN,7574,5098,-0.5711240478622175,-2476,Unchanged,100000,5
lptB,2771,1705,-0.7006349715698823,-1066,Unchanged,100000,5
lptA,2797,1472,-0.9261025824191789,-1325,Unchanged,100000,5
lptC,1520,1064,-0.5145731728297583,-456,Unchanged,100000,5
kdsC,1998,1443,-0.46948528330122025,-555,Unchanged,100000,5
kdsD,2932,2230,-0.39484139332614476,-702,Unchanged,100000,5
yrbG,1016,1370,0.43127549107572327,354,Unchanged,100000,5
mlaF,2567,2111,-0.2821567172282624,-456,Unchanged,100000,5
mlaE,2524,2167,-0.22001275688887545,-357,Unchanged,100000,5
mlaD,1460,1055,-0.4687253701728321,-405,Unchanged,100000,5
mlaC,3345,1922,-0.7993978747550728,-1423,Unchanged,100000,5
mlaB,737,497,-0.5684187675327834,-240,Unchanged,100000,5
ibaG,791,237,-1.7387906355745328,-554,Unchanged,100000,5
murA,4837,2509,-0.94700006703669,-2328,Unchanged,100000,5
sfsB,58,246,2.0845335102116676,188,Unchanged,100000,5
ispB,3351,1721,-0.9613445891642675,-1630,Unchanged,100000,5
rplU,8615,2069,-2.057917151252301,-6546,Unchanged,100000,5
rpmA,5837,1321,-2.1435966016354113,-4516,Unchanged,100000,5
yhbE,700,1310,0.9041399845924838,610,Unchanged,100000,5
obgE,1606,3346,1.0589655525210382,1740,Unchanged,100000,5
dacB,1392,1814,0.3820152446797941,422,Unchanged,100000,5
greA,624,583,-0.0980501456617519,-41,Unchanged,100000,5
yhbY,719,377,-0.9314272471706336,-342,Unchanged,100000,5
rlmE,3352,2370,-0.5001350899137301,-982,Unchanged,100000,5
ftsH,20778,14521,-0.5169159842939776,-6257,Unchanged,100000,5
folP,2274,1280,-0.8290884440048853,-994,Unchanged,100000,5
glmM,6991,3076,-1.1844433316791783,-3915,Unchanged,100000,5
secG,4618,641,-2.848871911155374,-3977,Unchanged,100000,5
yhbX,129,1075,3.0588936890535687,946,Unchanged,100000,5
argG,3641,5672,0.6395227917950013,2031,Unchanged,100000,5
rimP,2598,1236,-1.0717226875435064,-1362,Unchanged,100000,5
nusA,11192,7760,-0.5283393100902632,-3432,Unchanged,100000,5
infB,31405,17363,-0.8549780294361183,-14042,Unchanged,100000,5
rbfA,1438,1041,-0.46609360713988074,-397,Unchanged,100000,5
truB,2889,2497,-0.21037438263640323,-392,Unchanged,100000,5
rpsO,5789,553,-3.387962770994172,-5236,Unchanged,100000,5
pnp,29966,11315,-1.4050899345052204,-18651,Unchanged,100000,5
nlpI,9908,3930,-1.334064556100394,-5978,Unchanged,100000,5
deaD,5729,8287,0.5325665844045654,2558,Unchanged,100000,5
mtr,727,2577,1.8256652679400254,1850,Unchanged,100000,5
yhbW,269,1946,2.8548336322244876,1677,Unchanged,100000,5
ubiV,1423,1744,0.2934643782504439,321,Unchanged,100000,5
ubiU,1769,2243,0.34249557239581396,474,Unchanged,100000,5
ubiT,3518,1679,-1.0671532525349308,-1839,Unchanged,100000,5
yhbS,2449,1725,-0.5055964120110843,-724,Unchanged,100000,5
yhbQ,85,508,2.579293750634464,423,Unchanged,100000,5
yhbP,213,737,1.7908111888692315,524,Unchanged,100000,5
yhbO,578,736,0.34863627355633403,158,Unchanged,100000,5
yraR,222,1063,2.259510015180999,841,Unchanged,100000,5
yraQ,471,2233,2.2451842862096902,1762,Unchanged,100000,5
yraP,1666,1291,-0.36789940005835703,-375,Unchanged,100000,5
diaA,1427,1028,-0.4731450702818853,-399,Unchanged,100000,5
yraN,346,640,0.8872998672506377,294,Unchanged,100000,5
lpoA,3959,5243,0.40525647848625845,1284,Unchanged,100000,5
rsmI,692,1425,1.0421179763027415,733,Unchanged,100000,5
yraK,109,1207,3.469025635978095,1098,Unchanged,100000,5
yraJ,163,3021,4.212082314496864,2858,Unchanged,100000,5
yraI,12,449,5.225609134019991,437,Unchanged,100000,5
yraH,59,597,3.3389440719029637,538,Unchanged,100000,5
agaI,21,875,5.380821783940931,854,Unchanged,100000,5
agaD,18,995,5.788627713988699,977,Unchanged,100000,5
agaC,9,770,6.4187896341399515,761,Unchanged,100000,5
agaB,10,321,5.004501392234941,311,Unchanged,100000,5
kbaY,11,1421,7.013259220605483,1410,Unchanged,100000,5
agaS,19,1984,6.70626879694329,1965,Unchanged,100000,5
agaA,67,841,3.6498727997973717,774,Unchanged,100000,5
agaW,26,328,3.6571122864769916,302,Unchanged,100000,5
agaV,32,553,4.111135670234707,521,Unchanged,100000,5
kbaZ,38,2119,5.801240358928585,2081,Unchanged,100000,5
agaR,1420,1559,0.13472999830574028,139,Unchanged,100000,5
yhaV,555,633,0.18971772819087288,78,Unchanged,100000,5
prlF,314,392,0.32008909522358114,78,Unchanged,100000,5
garD,643,2624,2.0288770772901366,1981,Unchanged,100000,5
garP,21,2163,6.6865005271832185,2142,Unchanged,100000,5
garL,42,927,4.464108105846771,885,Unchanged,100000,5
garR,216,1252,2.53513134476915,1036,Unchanged,100000,5
garK,299,1832,2.615202113898839,1533,Unchanged,100000,5
rnpB,949408,275071,-1.7872241582140715,-674337,Downregulated,100000,5
yhaC,11,117,3.4109331009461075,106,Unchanged,100000,5
yhaB,7,86,3.6189098326444937,79,Unchanged,100000,5
tdcR,2,15,2.9068905956085187,13,Unchanged,100000,5
tdcA,40,605,3.9188632372745946,565,Unchanged,100000,5
tdcB,36,1199,5.057690941971911,1163,Unchanged,100000,5
tdcC,202,1948,3.2695664793305474,1746,Unchanged,100000,5
tdcD,57,1434,4.6529392945371635,1377,Unchanged,100000,5
tdcE,222,3579,4.010924962066278,3357,Unchanged,100000,5
tdcF,30,425,3.8244284354165456,395,Unchanged,100000,5
cyuP,131,1930,3.8809621306179922,1799,Unchanged,100000,5
yhaL,111,66,-0.7500217469916525,-45,Unchanged,100000,5
yhaK,139,1084,2.963207968630364,945,Unchanged,100000,5
yhaJ,943,1548,0.7150757954693138,605,Unchanged,100000,5
yhaI,16,271,4.082149041353872,255,Unchanged,100000,5
yhaH,548,468,-0.22766736337712226,-80,Unchanged,100000,5
yqjG,576,1330,1.2072855289462394,754,Unchanged,100000,5
yqjF,83,468,2.49532528823648,385,Unchanged,100000,5
yqjK,5091,625,-3.02602097071437,-4466,Unchanged,100000,5
yqjE,7344,706,-3.3788259701426275,-6638,Unchanged,100000,5
yqjD,3018,458,-2.7201733024297394,-2560,Unchanged,100000,5
yqjC,2697,650,-2.0528438983197868,-2047,Unchanged,100000,5
mzrA,327,492,0.5893676798411575,165,Unchanged,100000,5
yqjA,831,1014,0.287137270232996,183,Unchanged,100000,5
exuR,1427,1820,0.35095311561029513,393,Unchanged,100000,5
exuT,368,2439,2.7285120867391712,2071,Unchanged,100000,5
uxaC,489,2861,2.5486131273709494,2372,Unchanged,100000,5
uxaA,383,2925,2.933020327433172,2542,Unchanged,100000,5
ygjV,107,638,2.5759456273637227,531,Unchanged,100000,5
sstT,12868,4460,-1.5286722258450713,-8408,Unchanged,100000,5
alx,105,1615,3.9430729319151645,1510,Unchanged,100000,5
ygjR,700,1752,1.3235759477688445,1052,Unchanged,100000,5
ygjQ,17,893,5.715053523870884,876,Unchanged,100000,5
ygjP,190,618,1.7016074195734268,428,Unchanged,100000,5
rlmG,328,2153,2.71458059954915,1825,Unchanged,100000,5
higB,38,164,2.109624491174498,126,Unchanged,100000,5
higA,160,706,2.1415962783838176,546,Unchanged,100000,5
fadH,130,3960,4.928916901938518,3830,Unchanged,100000,5
ygjK,111,4518,5.347052689042978,4407,Unchanged,100000,5
ygjJ,7,1654,7.884388597113671,1647,Unchanged,100000,5
ygjI,12,2141,7.479106579664354,2129,Unchanged,100000,5
ebgC,9,445,5.627736524411448,436,Unchanged,100000,5
ebgA,111,5640,5.66706358093605,5529,Unchanged,100000,5
ebgR,444,1662,1.9042888004202385,1218,Unchanged,100000,5
ygjH,6,380,5.984893107609792,374,Unchanged,100000,5
patA,306,2431,2.989946335336077,2125,Unchanged,100000,5
aer,185,2941,3.990709608370752,2756,Unchanged,100000,5
nfeR,1179,1221,0.05049948200764056,42,Unchanged,100000,5
nfeF,133,1323,3.314314910777487,1190,Unchanged,100000,5
mug,1050,1094,0.05922341023907156,44,Unchanged,100000,5
rpoD,12120,7711,-0.6523998257123927,-4409,Unchanged,100000,5
dnaG,4439,4268,-0.05667453250066833,-171,Unchanged,100000,5
rpsU,3308,384,-3.1067810184501186,-2924,Unchanged,100000,5
tsaD,2887,2215,-0.3822644087936013,-672,Unchanged,100000,5
ttdT,78,2873,5.202940058670276,2795,Unchanged,100000,5
ttdB,137,1004,2.873511470990245,867,Unchanged,100000,5
ttdA,194,1390,2.840956325423742,1196,Unchanged,100000,5
ttdR,134,1392,3.376854305390956,1258,Unchanged,100000,5
plsY,481,899,0.9022842217444054,418,Unchanged,100000,5
folB,235,528,1.1678771727934538,293,Unchanged,100000,5
bacA,997,1647,0.7241751453281589,650,Unchanged,100000,5
cca,2899,2989,0.044107563616697605,90,Unchanged,100000,5
ygiM,3729,2044,-0.8673936008360197,-1685,Unchanged,100000,5
ygiF,1686,2589,0.618790428958029,903,Unchanged,100000,5
glnE,4421,6303,0.5116659284401358,1882,Unchanged,100000,5
hldE,2863,3195,0.15828826083500397,332,Unchanged,100000,5
yqiK,77,2629,5.093511885923145,2552,Unchanged,100000,5
yqiJ,19,397,4.385067683699372,378,Unchanged,100000,5
glgS,276,80,-1.7865963618908067,-196,Unchanged,100000,5
yqiI,47,517,3.4594316186372973,470,Unchanged,100000,5
yqiH,40,361,3.1739269319998087,321,Unchanged,100000,5
yqiG,258,3301,3.677460167799282,3043,Unchanged,100000,5
insD5,419,649,0.631268234299787,230,Unchanged,100000,5
insC5,388,374,-0.05301838229949099,-14,Unchanged,100000,5
ygiL,11,351,4.9958956016672635,340,Unchanged,100000,5
ubiK,1100,370,-1.5719063478957098,-730,Unchanged,100000,5
ribB,4708,1358,-1.7936308407937125,-3350,Unchanged,100000,5
zupT,1120,1151,0.03938910118726399,31,Unchanged,100000,5
ygiD,168,1069,2.6697287149417304,901,Unchanged,100000,5
ygiC,4783,2546,-0.9096833720849474,-2237,Unchanged,100000,5
ygiB,3032,1622,-0.9024959339538187,-1410,Unchanged,100000,5
tolC,11961,4410,-1.439487450273604,-7551,Unchanged,100000,5
nudF,1144,892,-0.35897143685808475,-252,Unchanged,100000,5
yqiB,709,558,-0.3455205054103285,-151,Unchanged,100000,5
cpdA,2709,1885,-0.5231958700459878,-824,Unchanged,100000,5
yqiA,967,941,-0.039321166748304485,-26,Unchanged,100000,5
parE,4327,4059,-0.09224278072419789,-268,Unchanged,100000,5
ygiN,3693,622,-2.5698067770750113,-3071,Unchanged,100000,5
mdaB,921,842,-0.12938092302493956,-79,Unchanged,100000,5
ygiZ,9,59,2.712718047919529,50,Unchanged,100000,5
qseC,371,2323,2.6464980621880043,1952,Unchanged,100000,5
qseB,184,911,2.3077452877450377,727,Unchanged,100000,5
ygiW,2630,545,-2.270734664515376,-2085,Unchanged,100000,5
ygiV,424,532,0.32736198093799046,108,Unchanged,100000,5
mqsR,432,412,-0.06838697498025013,-20,Unchanged,100000,5
mqsA,613,779,0.3457362543708877,166,Unchanged,100000,5
ygiS,629,2644,2.071590254628403,2015,Unchanged,100000,5
parC,6193,5018,-0.3035259753083543,-1175,Unchanged,100000,5
plsC,947,891,-0.087938993946463,-56,Unchanged,100000,5
ftsP,2332,2706,0.2145940507760408,374,Unchanged,100000,5
yqhH,15,163,3.441837558622559,148,Unchanged,100000,5
yqhG,108,1103,3.352329573427914,995,Unchanged,100000,5
dkgA,3767,3626,-0.05503710820323461,-141,Unchanged,100000,5
yqhD,7937,12203,0.6205701546581761,4266,Unchanged,100000,5
yqhC,450,1404,1.6415460290875237,954,Unchanged,100000,5
yghB,859,888,0.04790154521164227,29,Unchanged,100000,5
metC,3522,1898,-0.891914916810099,-1624,Unchanged,100000,5
exbB,410,941,1.1985708132230906,531,Unchanged,100000,5
exbD,152,357,1.2318527505855144,205,Unchanged,100000,5
yghA,3921,1504,-1.3824170748389522,-2417,Unchanged,100000,5
yqhA,1118,1033,-0.11407993397813058,-85,Unchanged,100000,5
gpr,1742,2642,0.600885842647963,900,Unchanged,100000,5
yghW,10,275,4.78135971352466,265,Unchanged,100000,5
hybO,9003,6137,-0.552872236181934,-2866,Unchanged,100000,5
hybA,6466,4321,-0.5815082765363517,-2145,Unchanged,100000,5
hybB,4812,3264,-0.5599955852045808,-1548,Unchanged,100000,5
hybC,7003,6707,-0.06230548542503315,-296,Unchanged,100000,5
hybD,1761,1393,-0.3381996512299555,-368,Unchanged,100000,5
hybE,1558,1264,-0.3016987698845663,-294,Unchanged,100000,5
hybF,270,331,0.2938718097563867,61,Unchanged,100000,5
hybG,260,180,-0.5305147166987798,-80,Unchanged,100000,5
yghU,2035,1817,-0.16347037491949354,-218,Unchanged,100000,5
gss,6278,3983,-0.6564495492179292,-2295,Unchanged,100000,5
pitB,49,2667,5.766292265435718,2618,Unchanged,100000,5
yghT,11,860,6.288761230952163,849,Unchanged,100000,5
yghS,23,980,5.413075982945558,957,Unchanged,100000,5
yghR,22,1246,5.823656734386705,1224,Unchanged,100000,5
yghQ,28,1654,5.884388597113671,1626,Unchanged,100000,5
insH9,8435,3459,-1.286033054802,-4976,Unchanged,100000,5
yghO,58,2245,5.274518734500937,2187,Unchanged,100000,5
glcC,36,1427,5.308844618033451,1391,Unchanged,100000,5
glcD,108,3740,5.11393505261153,3632,Unchanged,100000,5
glcG,194,630,1.6992951762001511,436,Unchanged,100000,5
glcB,1975,5449,1.4641388376246995,3474,Unchanged,100000,5
glcA,80,2929,5.194264382992005,2849,Unchanged,100000,5
pppA,608,1301,1.0974777332742098,693,Unchanged,100000,5
yghG,100,363,1.859969548221026,263,Unchanged,100000,5
yghF,109,1375,3.657031578522458,1266,Unchanged,100000,5
yghE,429,1651,1.9442905674137125,1222,Unchanged,100000,5
yghD,63,678,3.4278615396364276,615,Unchanged,100000,5
yqgA,202,1036,2.358596804934759,834,Unchanged,100000,5
speC,4947,3646,-0.4402393381194889,-1301,Unchanged,100000,5
nupG,776,2199,1.5027190466678404,1423,Unchanged,100000,5
mltC,1057,1697,0.6830111881599804,640,Unchanged,100000,5
yggX,571,233,-1.2931607907085627,-338,Unchanged,100000,5
mutY,1232,2016,0.7104933828050152,784,Unchanged,100000,5
trmB,1644,1293,-0.3464880238714287,-351,Unchanged,100000,5
yggL,1162,400,-1.5385381636298043,-762,Unchanged,100000,5
yggN,575,1372,1.2546466203410749,797,Unchanged,100000,5
ansB,3176,2156,-0.5588537343904522,-1020,Unchanged,100000,5
yggM,43,1205,4.808552676415226,1162,Unchanged,100000,5
hemW,835,2153,1.3665002168058191,1318,Unchanged,100000,5
rdgB,792,1168,0.5604679388004076,376,Unchanged,100000,5
yggU,186,265,0.5106897383425302,79,Unchanged,100000,5
yggT,1213,916,-0.40516004702356645,-297,Unchanged,100000,5
yggS,575,1072,0.898671044626035,497,Unchanged,100000,5
yggR,43,1759,5.354275012769863,1716,Unchanged,100000,5
yqgF,396,591,0.5776577000979228,195,Unchanged,100000,5
yqgE,1563,1407,-0.15169544976313168,-156,Unchanged,100000,5
gshB,1785,1954,0.13050639305192333,169,Unchanged,100000,5
rsmE,922,1206,0.38739125147074693,284,Unchanged,100000,5
endA,144,930,2.6911619045530815,786,Unchanged,100000,5
yggI,237,550,1.214544559513763,313,Unchanged,100000,5
galP,6076,3254,-0.9009076188295557,-2822,Unchanged,100000,5
metK,44281,4382,-3.3370264134996166,-39899,Unchanged,100000,5
yqgC,53,60,0.1789701410453193,7,Unchanged,100000,5
yqgB,4,3,-0.4150374992788438,-1,Unchanged,100000,5
speA,8034,4151,-0.9526595294418588,-3883,Unchanged,100000,5
speB,1381,1420,0.04017761013399361,39,Unchanged,100000,5
loiP,1397,1491,0.09394823687397919,94,Unchanged,100000,5
tktA,40006,8739,-2.194676280715382,-31267,Unchanged,100000,5
cmtB,7,241,5.105534414172357,234,Unchanged,100000,5
cmtA,42,1733,5.366738516381409,1691,Unchanged,100000,5
yggF,58,1365,4.556704240679642,1307,Unchanged,100000,5
fumE,555,924,0.7354050801785893,369,Unchanged,100000,5
yggC,563,1177,1.0639074929582146,614,Unchanged,100000,5
epd,15423,4216,-1.8711366458342684,-11207,Unchanged,100000,5
pgk,58834,15751,-1.9012066999993138,-43083,Unchanged,100000,5
fbaA,127930,16826,-2.926590466055984,-111104,Downregulated,100000,5
mscS,16583,3317,-2.3217541085098135,-13266,Unchanged,100000,5
argO,334,855,1.3560763172992079,521,Unchanged,100000,5
yggE,6522,1741,-1.9053982380973644,-4781,Unchanged,100000,5
ygfI,231,959,2.0536379636020734,728,Unchanged,100000,5
scpC,118,2210,4.227187604916953,2092,Unchanged,100000,5
scpB,81,979,3.59531504671907,898,Unchanged,100000,5
argK,68,1382,4.34507905913792,1314,Unchanged,100000,5
scpA,140,3559,4.667973200564819,3419,Unchanged,100000,5
argP,1776,1544,-0.20195882908202553,-232,Unchanged,100000,5
yqfE,17,187,3.4594316186372973,170,Unchanged,100000,5
rpiA,7654,2989,-1.3565510039904012,-4665,Unchanged,100000,5
serA,48418,9691,-2.3208260392246167,-38727,Unchanged,100000,5
fau,364,706,0.955729733072484,342,Unchanged,100000,5
ssrS,6382,624,-3.3543906744170635,-5758,Unchanged,100000,5
zapA,1183,460,-1.362744307395413,-723,Unchanged,100000,5
ygfB,4239,1617,-1.390404287581434,-2622,Unchanged,100000,5
pepP,10390,4728,-1.1358937136140417,-5662,Unchanged,100000,5
ubiH,4132,3224,-0.3579885103370922,-908,Unchanged,100000,5
ubiI,3056,2643,-0.20946811839417878,-413,Unchanged,100000,5
gcvT,2759,2186,-0.3358520556813683,-573,Unchanged,100000,5
gcvH,1286,556,-1.2097338546044398,-730,Unchanged,100000,5
gcvP,4765,5353,0.16787143851768954,588,Unchanged,100000,5
ygfF,137,1043,2.928491359559239,906,Unchanged,100000,5
bglA,3541,2603,-0.443981531986804,-938,Unchanged,100000,5
yqfB,500,296,-0.7563309190331373,-204,Unchanged,100000,5
yqfA,468,1126,1.266626392496825,658,Unchanged,100000,5
ygfZ,5845,3029,-0.9483614466236463,-2816,Unchanged,100000,5
sdhE,872,598,-0.5441826505788212,-274,Unchanged,100000,5
ygfX,1050,993,-0.08052370502511108,-57,Unchanged,100000,5
fldB,1045,708,-0.5616816768852476,-337,Unchanged,100000,5
xerD,2425,1805,-0.425985910187319,-620,Unchanged,100000,5
dsbC,2407,1563,-0.6229183634748325,-844,Unchanged,100000,5
recJ,4869,4760,-0.03266392707382181,-109,Unchanged,100000,5
prfB,6706,3578,-0.9062990957418762,-3128,Unchanged,100000,5
lysS,11239,5398,-1.0580167942800915,-5841,Unchanged,100000,5
idi,181,509,1.49167595899249,328,Unchanged,100000,5
uacT,14,1355,6.59672221418363,1341,Unchanged,100000,5
ygfT,170,2332,3.777961137062795,2162,Unchanged,100000,5
ygfS,41,420,3.356693513048039,379,Unchanged,100000,5
guaD,321,1480,2.204951973394009,1159,Unchanged,100000,5
xanQ,81,1283,3.985455452205058,1202,Unchanged,100000,5
xdhD,412,3601,3.127681357007062,3189,Unchanged,100000,5
ygfM,55,791,3.846174170948132,736,Unchanged,100000,5
ssnA,48,1502,4.967706596793116,1454,Unchanged,100000,5
ygfK,131,3110,4.569275863480515,2979,Unchanged,100000,5
mocA,72,366,2.34577483684173,294,Unchanged,100000,5
yqeC,68,788,3.534588978206037,720,Unchanged,100000,5
yqeB,312,1897,2.604101744549227,1585,Unchanged,100000,5
yqeA,155,781,2.333054332867742,626,Unchanged,100000,5
hyuA,67,1470,4.455511249265954,1403,Unchanged,100000,5
ygeY,108,1108,3.3588546638857197,1000,Unchanged,100000,5
ygeX,68,1344,4.304854581528421,1276,Unchanged,100000,5
ygeW,39,1194,4.936184902402557,1155,Unchanged,100000,5
ygeV,542,1615,1.5751694082274157,1073,Unchanged,100000,5
xdhC,85,400,2.234465253637023,315,Unchanged,100000,5
xdhB,119,982,3.0447614510067496,863,Unchanged,100000,5
xdhA,362,2539,2.8101987925643006,2177,Unchanged,100000,5
ygeR,833,936,0.16819203421785683,103,Unchanged,100000,5
ygeQ,169,600,1.8279392542136965,431,Unchanged,100000,5
insC4,261,494,0.9204612350147932,233,Unchanged,100000,5
insD4,297,752,1.3402697308768716,455,Unchanged,100000,5
ygeO,36,68,0.9175378398080271,32,Unchanged,100000,5
ygeN,36,39,0.11547721741993588,3,Unchanged,100000,5
ygeL,9,132,3.8744691179161412,123,Unchanged,100000,5
pbl,2,58,4.857980995127572,56,Unchanged,100000,5
ygeI,2,3,0.5849625007211562,1,Unchanged,100000,5
ygeH,12,130,3.4374053123072983,118,Unchanged,100000,5
ygeG,4,20,2.321928094887362,16,Unchanged,100000,5
ygeF,5,52,3.37851162325373,47,Unchanged,100000,5
yqeK,5,7,0.48542682717024166,2,Unchanged,100000,5
yqeJ,45,37,-0.282399730700725,-8,Unchanged,100000,5
yqeI,222,245,0.14222207265246467,23,Unchanged,100000,5
yqeH,37,138,1.8990710911492192,101,Unchanged,100000,5
yqeG,393,779,0.9870940158030628,386,Unchanged,100000,5
yqeF,130,1295,3.3163685695454617,1165,Unchanged,100000,5
kduI,78,740,3.2459792416540636,662,Unchanged,100000,5
kduD,153,772,2.3350691945754285,619,Unchanged,100000,5
araE,535,1642,1.6178433304892954,1107,Unchanged,100000,5
ygeA,439,672,0.6142402932434021,233,Unchanged,100000,5
lysR,267,1107,2.0517435750939983,840,Unchanged,100000,5
lysA,718,1585,1.1424270912037182,867,Unchanged,100000,5
galR,663,1519,1.1960410943894957,856,Unchanged,100000,5
aas,1936,2778,0.5209676467067981,842,Unchanged,100000,5
lplT,801,1632,1.0267669095627856,831,Unchanged,100000,5
tas,3231,2100,-0.6215914227118787,-1131,Unchanged,100000,5
ygdR,408,99,-2.043068721891886,-309,Unchanged,100000,5
ygdQ,382,1163,1.6062065534374697,781,Unchanged,100000,5
mutH,409,1181,1.5298362164554085,772,Unchanged,100000,5
rppH,3547,1514,-1.228234124949457,-2033,Unchanged,100000,5
ptsP,6027,5486,-0.13568544260617083,-541,Unchanged,100000,5
lgt,796,1141,0.5194584557450329,345,Unchanged,100000,5
thyA,1386,1144,-0.27684020535882436,-242,Unchanged,100000,5
ppdA,46,565,3.618545101245537,519,Unchanged,100000,5
ppdB,135,734,2.442820655792382,599,Unchanged,100000,5
ygdB,95,409,2.106101424610801,314,Unchanged,100000,5
ppdC,58,262,2.1754420064098783,204,Unchanged,100000,5
recC,3896,6288,0.6906075401762644,2392,Unchanged,100000,5
ptrA,3035,5745,0.9206103763904312,2710,Unchanged,100000,5
recB,4763,9327,0.9695425686981982,4564,Unchanged,100000,5
recD,1512,3949,1.385029228239276,2437,Unchanged,100000,5
argA,2043,5720,1.4853259429325243,3677,Unchanged,100000,5
amiC,3720,2741,-0.44060029316961863,-979,Unchanged,100000,5
mltA,2422,1986,-0.28633324216595485,-436,Unchanged,100000,5
tcdA,309,1510,2.2888698063080666,1201,Unchanged,100000,5
csdE,474,826,0.8012547225211862,352,Unchanged,100000,5
csdA,2838,3493,0.29959205333431327,655,Unchanged,100000,5
ygdI,787,166,-2.2451803941605615,-621,Unchanged,100000,5
gcvA,1154,1751,0.6015358597880753,597,Unchanged,100000,5
ygdD,429,674,0.6517709436823129,245,Unchanged,100000,5
rlmM,1847,2280,0.30384995806966586,433,Unchanged,100000,5
fucR,551,939,0.7690728390826168,388,Unchanged,100000,5
fucU,454,560,0.3027345296540515,106,Unchanged,100000,5
fucK,235,2406,3.355903980611077,2171,Unchanged,100000,5
fucI,240,3344,3.8004685364723643,3104,Unchanged,100000,5
fucP,40,1792,5.485426827170242,1752,Unchanged,100000,5
fucA,37,822,4.473541218052733,785,Unchanged,100000,5
fucO,1239,2308,0.8974670365048809,1069,Unchanged,100000,5
ygdG,509,1252,1.2984970008569232,743,Unchanged,100000,5
sdaB,1306,2363,0.855464732427416,1057,Unchanged,100000,5
sdaC,3225,2429,-0.40893667056211386,-796,Unchanged,100000,5
ppnN,5017,3382,-0.5689482783543135,-1635,Unchanged,100000,5
queF,935,1189,0.3467104449706569,254,Unchanged,100000,5
syd,688,840,0.28798076296402464,152,Unchanged,100000,5
yqcC,227,274,0.2714835956696118,47,Unchanged,100000,5
truC,600,1086,0.8559896973084807,486,Unchanged,100000,5
yqcA,1328,630,-1.0758314129596458,-698,Unchanged,100000,5
gudP,63,1746,4.792557920129523,1683,Unchanged,100000,5
gudX,179,1748,3.287673692236342,1569,Unchanged,100000,5
gudD,447,2124,2.248437029620836,1677,Unchanged,100000,5
barA,1859,3721,1.001163620206291,1862,Unchanged,100000,5
rlmD,961,2028,1.0774493162295902,1067,Unchanged,100000,5
relA,4341,4857,0.1620380637708414,516,Unchanged,100000,5
mazE,228,461,1.0157329262645964,233,Unchanged,100000,5
mazF,274,358,0.3857836943037298,84,Unchanged,100000,5
mazG,1247,2351,0.9148130738233513,1104,Unchanged,100000,5
pyrG,25298,7476,-1.7586848591770456,-17822,Unchanged,100000,5
eno,95671,30399,-1.6540578123284673,-65272,Unchanged,100000,5
ygcG,13,321,4.625989768981211,308,Unchanged,100000,5
queE,539,1103,1.0330756128388772,564,Unchanged,100000,5
ygcE,81,1673,4.368371727153728,1592,Unchanged,100000,5
yqcE,24,1512,5.977279923499917,1488,Unchanged,100000,5
ygcW,14,671,5.582814034142579,657,Unchanged,100000,5
ygcS,56,1777,4.987873043971074,1721,Unchanged,100000,5
ygcR,42,1244,4.888453347351843,1202,Unchanged,100000,5
ygcQ,80,1208,3.9164766444377164,1128,Unchanged,100000,5
ygcP,85,530,2.6404576133128597,445,Unchanged,100000,5
ygcO,10,142,3.8278190246173196,132,Unchanged,100000,5
ygcN,370,1949,2.3971369147415778,1579,Unchanged,100000,5
queD,429,405,-0.08305573972755852,-24,Unchanged,100000,5
cysJ,422,5213,3.626798955888827,4791,Unchanged,100000,5
cysI,469,5428,3.5327608929034775,4959,Unchanged,100000,5
cysH,236,1489,2.6574849892202588,1253,Unchanged,100000,5
cas3,306,2941,3.264703226194412,2635,Unchanged,100000,5
casA,164,1734,3.4023361786037514,1570,Unchanged,100000,5
casB,92,504,2.4537179674429037,412,Unchanged,100000,5
casC,353,1240,1.8126000320030573,887,Unchanged,100000,5
casD,180,898,2.3187185384114724,718,Unchanged,100000,5
casE,222,731,1.7193117296023313,509,Unchanged,100000,5
cas1,318,1412,2.150641417986825,1094,Unchanged,100000,5
cas2,60,276,2.2016338611696504,216,Unchanged,100000,5
iap,545,1587,1.5419739931708931,1042,Unchanged,100000,5
cysD,382,3783,3.3078862330136274,3401,Unchanged,100000,5
cysN,880,6089,2.7906298840799177,5209,Unchanged,100000,5
cysC,130,1389,3.417463070952938,1259,Unchanged,100000,5
ygbE,61,298,2.2884311828992754,237,Unchanged,100000,5
ftsB,714,479,-0.5758984182929195,-235,Unchanged,100000,5
ispD,1716,1620,-0.08305573972755852,-96,Unchanged,100000,5
ispF,1077,709,-0.6031607173046915,-368,Unchanged,100000,5
truD,3937,2572,-0.6142060698310937,-1365,Unchanged,100000,5
umpG,2166,1754,-0.30438449516359406,-412,Unchanged,100000,5
pcm,1324,1128,-0.23113605440842414,-196,Unchanged,100000,5
nlpD,8032,12648,0.6550780984075988,4616,Unchanged,100000,5
rpoS,26810,22547,-0.24983573142950463,-4263,Unchanged,100000,5
ygbN,132,1960,3.892243819644117,1828,Unchanged,100000,5
ygbM,92,1072,3.5425272344007595,980,Unchanged,100000,5
ygbL,54,1100,4.3484003062485534,1046,Unchanged,100000,5
ygbK,103,2074,4.331699651630007,1971,Unchanged,100000,5
ygbJ,62,1604,4.693262116068045,1542,Unchanged,100000,5
ygbI,471,1357,1.5266217558060708,886,Unchanged,100000,5
pphB,34,493,3.8579809951275723,459,Unchanged,100000,5
mutS,2242,5382,1.2633561128349906,3140,Unchanged,100000,5
ygbA,37,463,3.6454150176312865,426,Unchanged,100000,5
fhlA,1088,4631,2.089645200453354,3543,Unchanged,100000,5
hypE,1891,2273,0.2654483208680863,382,Unchanged,100000,5
hypD,2762,3198,0.21145661922228126,436,Unchanged,100000,5
hypC,262,377,0.5249977117312139,115,Unchanged,100000,5
hypB,2678,2636,-0.022805590316258825,-42,Unchanged,100000,5
hypA,168,614,1.869777422591419,446,Unchanged,100000,5
hycA,178,814,2.1931515532998493,636,Unchanged,100000,5
hycB,153,1186,2.954500451853352,1033,Unchanged,100000,5
hycC,477,4998,3.389289730081192,4521,Unchanged,100000,5
hycD,215,2287,3.4110478008222125,2072,Unchanged,100000,5
hycE,590,4908,3.0563483894137016,4318,Unchanged,100000,5
hycF,162,1198,2.886562189904161,1036,Unchanged,100000,5
hycG,319,1666,2.3847600716006783,1347,Unchanged,100000,5
hycH,180,694,1.9469387562485863,514,Unchanged,100000,5
hycI,257,836,1.7017345828870047,579,Unchanged,100000,5
ascB,431,3340,2.9540883282723165,2909,Unchanged,100000,5
ascF,310,3787,3.610715300610182,3477,Unchanged,100000,5
ascG,412,2505,2.6040943608993525,2093,Unchanged,100000,5
hydN,207,768,1.8914755432218309,561,Unchanged,100000,5
hypF,1876,6526,1.7985391595764877,4650,Unchanged,100000,5
norW,116,2928,4.65771884315647,2812,Unchanged,100000,5
norV,249,3637,3.868531278387536,3388,Unchanged,100000,5
norR,792,3969,2.3252032269202236,3177,Unchanged,100000,5
gutQ,1080,2405,1.1550055816065732,1325,Unchanged,100000,5
srlR,672,1493,1.1516810273557812,821,Unchanged,100000,5
gutM,45,461,3.356769844099663,416,Unchanged,100000,5
srlD,346,1916,2.4692536180994558,1570,Unchanged,100000,5
srlB,36,591,4.03708931873522,555,Unchanged,100000,5
srlE,87,1760,4.338416217675931,1673,Unchanged,100000,5
srlA,41,699,4.091596640757353,658,Unchanged,100000,5
mltB,1378,2250,0.7073491134001081,872,Unchanged,100000,5
pncC,685,778,0.18366616713830297,93,Unchanged,100000,5
recA,17576,4915,-1.8383434531953335,-12661,Unchanged,100000,5
recX,112,628,2.487265826834023,516,Unchanged,100000,5
alaS,28405,11168,-1.3467740563194006,-17237,Unchanged,100000,5
csrA,1690,209,-3.015448399088664,-1481,Unchanged,100000,5
yqaB,769,951,0.3064617428987369,182,Unchanged,100000,5
yqaA,623,484,-0.36422511574940736,-139,Unchanged,100000,5
gshA,5324,3238,-0.7174075856093258,-2086,Unchanged,100000,5
luxS,7464,1341,-2.4766397489472847,-6123,Unchanged,100000,5
emrB,1165,2349,1.0117167584705542,1184,Unchanged,100000,5
emrA,1958,1855,-0.07796157809552932,-103,Unchanged,100000,5
mprA,4158,1218,-1.7713756249520376,-2940,Unchanged,100000,5
ygaH,691,555,-0.3161979391507903,-136,Unchanged,100000,5
ygaZ,3482,2195,-0.6656952632283807,-1287,Unchanged,100000,5
ygaY,261,2112,3.016488122788569,1851,Unchanged,100000,5
proX,21168,17839,-0.24685022229369336,-3329,Unchanged,100000,5
proW,20183,20659,0.0336297896684495,476,Unchanged,100000,5
proV,29020,25379,-0.19341229512175842,-3641,Unchanged,100000,5
nrdF,34,1274,5.227686721005961,1240,Unchanged,100000,5
nrdE,114,3660,5.004737919006663,3546,Unchanged,100000,5
nrdI,10,348,5.121015400961366,338,Unchanged,100000,5
nrdH,7,179,4.676460855206653,172,Unchanged,100000,5
ygaM,2129,484,-2.1370969971776996,-1645,Unchanged,100000,5
ygaC,795,346,-1.200182822534993,-449,Unchanged,100000,5
alaE,143,446,1.6410285631419153,303,Unchanged,100000,5
stpA,7718,1603,-2.2674526183867063,-6115,Unchanged,100000,5
ygaP,221,666,1.5914758076798305,445,Unchanged,100000,5
ygaV,67,246,1.8764253148814674,179,Unchanged,100000,5
yqaE,34,44,0.37196877738695794,10,Unchanged,100000,5
kbp,3208,787,-2.0272386009474337,-2421,Unchanged,100000,5
glaR,326,1185,1.861943189554544,859,Unchanged,100000,5
gabP,140,2040,3.8650704199138914,1900,Unchanged,100000,5
gabT,630,2902,2.2036237856794654,2272,Unchanged,100000,5
gabD,737,3073,2.0599112424978925,2336,Unchanged,100000,5
lhgD,230,2559,3.475874381095071,2329,Unchanged,100000,5
glaH,222,1571,2.8230515989440903,1349,Unchanged,100000,5
ypjC,10,184,4.20163386116965,174,Unchanged,100000,5
pinH,1,97,6.599912842187128,96,Unchanged,100000,5
ypjA,579,5165,3.1571330957631853,4586,Unchanged,100000,5
ypjF,12,137,3.5130695822393703,125,Unchanged,100000,5
yfjZ,3,115,5.260527550223219,112,Unchanged,100000,5
yfjY,9,350,5.281286110390016,341,Unchanged,100000,5
yfjX,10,488,5.608809242675524,478,Unchanged,100000,5
yfjW,751,237,-1.6639258486160127,-514,Unchanged,100000,5
yfjV,226,1065,2.236458752698013,839,Unchanged,100000,5
yfjU,3,2,-0.5849625007211563,-1,Unchanged,100000,5
yfjT,47,384,3.030373649043519,337,Unchanged,100000,5
yfjS,14,289,4.3675707604430745,275,Unchanged,100000,5
ypjK,7,109,3.9608294027193223,102,Unchanged,100000,5
yfjR,27,593,4.457000792382535,566,Unchanged,100000,5
yfjQ,18,800,5.473931188332412,782,Unchanged,100000,5
yfjP,75,952,3.665999072812063,877,Unchanged,100000,5
rnlB,396,325,-0.28506071216379275,-71,Unchanged,100000,5
rnlA,4217,1619,-1.3811140359765677,-2598,Unchanged,100000,5
yfjM,14,109,2.9608294027193223,95,Unchanged,100000,5
abpA,1810,1794,-0.01280980705130656,-16,Unchanged,100000,5
abpB,1926,2173,0.1740804713378237,247,Unchanged,100000,5
yfjJ,25,146,2.5459683691052923,121,Unchanged,100000,5
yfjI,45,437,3.2796363731709235,392,Unchanged,100000,5
alpA,7,62,3.146841388329271,55,Unchanged,100000,5
yfjH,292,345,0.2406279927855141,53,Unchanged,100000,5
intA,1577,1368,-0.20511442990461237,-209,Unchanged,100000,5
ssrA,836700,230403,-1.8605509333377752,-606297,Downregulated,100000,5
smpB,1129,586,-0.9460729163507529,-543,Unchanged,100000,5
ratA,1459,749,-0.9619422594591398,-710,Unchanged,100000,5
yfjF,337,212,-0.6686843266186594,-125,Unchanged,100000,5
bamE,2178,451,-2.271804615461526,-1727,Unchanged,100000,5
recN,4802,2374,-1.0163154685885099,-2428,Unchanged,100000,5
nadK,1039,895,-0.21523606675259307,-144,Unchanged,100000,5
grpE,13820,4361,-1.6640267201940149,-9459,Unchanged,100000,5
ypjD,620,749,0.2726975031845134,129,Unchanged,100000,5
ffh,7914,4949,-0.677270023105698,-2965,Unchanged,100000,5
rpsP,3736,790,-2.241569896645197,-2946,Unchanged,100000,5
rimM,20347,4125,-2.302350072026451,-16222,Unchanged,100000,5
trmD,22564,4815,-2.2284151388740416,-17749,Unchanged,100000,5
rplS,6860,906,-2.9206256210139396,-5954,Unchanged,100000,5
yfiB,519,272,-0.9321278871075415,-247,Unchanged,100000,5
dgcN,547,986,0.8500468135853549,439,Unchanged,100000,5
yfiR,386,430,0.1557358123213798,44,Unchanged,100000,5
yfiL,47,144,1.615336149764675,97,Unchanged,100000,5
aroF,1014,3907,1.9460036031803325,2893,Unchanged,100000,5
tyrA,1266,3519,1.4748881093213233,2253,Unchanged,100000,5
pheA,2987,1816,-0.7179330350198756,-1171,Unchanged,100000,5
pheL,1,1,0.0,0,Unchanged,100000,5
raiA,10047,3287,-1.6119214203475616,-6760,Unchanged,100000,5
bamD,6003,1875,-1.6787930723562918,-4128,Unchanged,100000,5
rluD,2293,1726,-0.40980389040183846,-567,Unchanged,100000,5
pgeF,778,832,0.0968133731549001,54,Unchanged,100000,5
clpB,36074,29838,-0.27380856564118633,-6236,Unchanged,100000,5
kgtP,3210,4043,0.3328529062620291,833,Unchanged,100000,5
yfiM,100,301,1.5897634869849773,201,Unchanged,100000,5
pssA,4784,2306,-1.0528248765463333,-2478,Unchanged,100000,5
patZ,2061,4108,0.9950916767789388,2047,Unchanged,100000,5
tapT,142,783,2.4631213777863588,641,Unchanged,100000,5
trxC,116,351,1.5973462251769885,235,Unchanged,100000,5
yfiF,2027,1938,-0.06477751805181789,-89,Unchanged,100000,5
ung,1231,1055,-0.22258776288990983,-176,Unchanged,100000,5
grcA,2592,1976,-0.39148277129994696,-616,Unchanged,100000,5
eamB,196,795,2.0201012060565096,599,Unchanged,100000,5
yfiE,174,1283,2.882361959240954,1109,Unchanged,100000,5
srmB,3008,3387,0.17120341981651963,379,Unchanged,100000,5
yfiC,508,1020,1.005668750086692,512,Unchanged,100000,5
nadB,16222,3755,-2.1110668866170283,-12467,Unchanged,100000,5
rpoE,9016,2998,-1.5884871322243617,-6018,Unchanged,100000,5
rseA,13743,5654,-1.2813531804079885,-8089,Unchanged,100000,5
rseB,7779,2854,-1.4465993720986874,-4925,Unchanged,100000,5
rseC,2917,1030,-1.5018410488275968,-1887,Unchanged,100000,5
lepA,10039,5222,-0.9429412046435173,-4817,Unchanged,100000,5
lepB,3404,1888,-0.8503722723241213,-1516,Unchanged,100000,5
rnc,2100,1337,-0.6513898624601321,-763,Unchanged,100000,5
era,3271,2582,-0.3412427587755877,-689,Unchanged,100000,5
recO,630,1027,0.7050124479309162,397,Unchanged,100000,5
pdxJ,2397,1487,-0.6888252615967143,-910,Unchanged,100000,5
acpS,605,552,-0.13226687538378784,-53,Unchanged,100000,5
yfhL,99,112,0.17799830197799443,13,Unchanged,100000,5
yfhH,425,1286,1.597355896302883,861,Unchanged,100000,5
pgpC,1126,1457,0.3717940499842829,331,Unchanged,100000,5
tadA,684,952,0.4769652484220457,268,Unchanged,100000,5
mltF,354,2764,2.964936350305261,2410,Unchanged,100000,5
purL,26525,18325,-0.533539552780953,-8200,Unchanged,100000,5
glrK,1115,3405,1.6106110880917666,2290,Unchanged,100000,5
qseG,780,1496,0.9395641461380261,716,Unchanged,100000,5
glrR,1138,3048,1.4213623451867403,1910,Unchanged,100000,5
glnB,1054,452,-1.2214801892220268,-602,Unchanged,100000,5
hmp,402,2387,2.569931159902848,1985,Unchanged,100000,5
glyA,93445,9592,-3.2842139072946566,-83853,Unchanged,100000,5
yphH,303,2184,2.8495831574469017,1881,Unchanged,100000,5
yphG,152,6405,5.397055341785423,6253,Unchanged,100000,5
yphF,51,1392,4.770518153877233,1341,Unchanged,100000,5
yphE,52,3191,5.93935317513822,3139,Unchanged,100000,5
yphD,58,1914,5.044394119358453,1856,Unchanged,100000,5
yphC,290,2141,2.884159990370575,1851,Unchanged,100000,5
yphB,183,1595,3.1236408703681895,1412,Unchanged,100000,5
yphA,471,473,0.006113123726612006,2,Unchanged,100000,5
hcaD,206,2111,3.3572103361639374,1905,Unchanged,100000,5
hcaB,180,1745,3.27715822476734,1565,Unchanged,100000,5
hcaC,50,475,3.2479275134435857,425,Unchanged,100000,5
hcaF,53,665,3.649290075825353,612,Unchanged,100000,5
hcaE,854,3166,1.8903532805166907,2312,Unchanged,100000,5
hcaR,164,1769,3.4311663280723748,1605,Unchanged,100000,5
hcaT,380,2506,2.7213150909909127,2126,Unchanged,100000,5
csiE,616,2389,1.955404597761431,1773,Unchanged,100000,5
yfhR,49,1977,5.334387311614,1928,Unchanged,100000,5
suhB,2777,1927,-0.5271706055231249,-850,Unchanged,100000,5
trmJ,2986,4118,0.463729664497713,1132,Unchanged,100000,5
iscR,525,1270,1.274439169106043,745,Unchanged,100000,5
iscS,4420,5898,0.41617945278294277,1478,Unchanged,100000,5
iscU,1186,1325,0.1598883497919203,139,Unchanged,100000,5
iscA,1381,1280,-0.10956950937068856,-101,Unchanged,100000,5
hscB,757,1434,0.9216798187161731,677,Unchanged,100000,5
hscA,5431,7576,0.48021846754418435,2145,Unchanged,100000,5
fdx,758,794,0.06694115897186609,36,Unchanged,100000,5
iscX,121,228,0.9140267768901471,107,Unchanged,100000,5
pepB,2829,5045,0.8345620925974669,2216,Unchanged,100000,5
sseB,1007,1602,0.6698104644019254,595,Unchanged,100000,5
sseA,2118,2089,-0.019890096925228282,-29,Unchanged,100000,5
yfhM,7373,14354,0.9611291637400687,6981,Unchanged,100000,5
pbpC,591,5700,3.269731883761934,5109,Unchanged,100000,5
ndk,263,834,1.6649845841523612,571,Unchanged,100000,5
rlmN,1606,2891,0.848096715959735,1285,Unchanged,100000,5
rodZ,3168,3074,-0.043455170388838255,-94,Unchanged,100000,5
ispG,5829,4374,-0.41429518125840753,-1455,Unchanged,100000,5
hisS,7522,4323,-0.7990834701444027,-3199,Unchanged,100000,5
yfgM,3246,1861,-0.8025849444888199,-1385,Unchanged,100000,5
bamB,9072,4553,-0.9946031809230298,-4519,Unchanged,100000,5
der,2925,3850,0.3964218211114968,925,Unchanged,100000,5
yfgJ,25,92,1.8797057662822882,67,Unchanged,100000,5
xseA,2388,2775,0.21668493486002566,387,Unchanged,100000,5
guaB,42100,4813,-3.1288119048762484,-37287,Unchanged,100000,5
guaA,43232,4688,-3.205055104903437,-38544,Unchanged,100000,5
yfgI,48,854,4.153129758899334,806,Unchanged,100000,5
yfgH,25,453,4.17951105027151,428,Unchanged,100000,5
yfgG,37,84,1.1828640571498104,47,Unchanged,100000,5
pdeF,214,3472,4.020084246043332,3258,Unchanged,100000,5
ppx,3634,3416,-0.0892504446136255,-218,Unchanged,100000,5
ppk,6678,5093,-0.39090037616558193,-1585,Unchanged,100000,5
purN,3619,1701,-1.0892079667091537,-1918,Unchanged,100000,5
purM,12455,5024,-1.3098166522365717,-7431,Unchanged,100000,5
upp,17025,1252,-3.7653483308541777,-15773,Unchanged,100000,5
uraA,7735,2163,-1.8383676263744193,-5572,Unchanged,100000,5
hda,1509,1751,0.21458627790687457,242,Unchanged,100000,5
yfgD,1555,699,-1.1535502196425285,-856,Unchanged,100000,5
bepA,3959,4232,0.09620356008392907,273,Unchanged,100000,5
yfgO,1210,2575,1.0895653847959863,1365,Unchanged,100000,5
focB,97,1824,4.232977171977614,1727,Unchanged,100000,5
hyfR,167,4278,4.679016474690992,4111,Unchanged,100000,5
hyfJ,33,563,4.092596992721776,530,Unchanged,100000,5
hyfI,71,1370,4.270213058343207,1299,Unchanged,100000,5
hyfH,61,982,4.008841876751807,921,Unchanged,100000,5
hyfG,231,3849,4.0585189143947815,3618,Unchanged,100000,5
hyfF,92,2853,4.954702075524707,2761,Unchanged,100000,5
hyfE,19,1270,6.062685268215943,1251,Unchanged,100000,5
hyfD,34,2758,6.341943900263641,2724,Unchanged,100000,5
hyfC,10,1798,7.490249210627085,1788,Unchanged,100000,5
hyfB,105,4560,5.4405725913859815,4455,Unchanged,100000,5
hyfA,13,1186,6.511448576404911,1173,Unchanged,100000,5
bcp,4909,1094,-2.1658164285734918,-3815,Unchanged,100000,5
gcvR,2622,1276,-1.0390393564568852,-1346,Unchanged,100000,5
dapA,12848,5392,-1.252651396335456,-7456,Unchanged,100000,5
bamC,10846,6171,-0.8135868757691186,-4675,Unchanged,100000,5
purC,16539,4418,-1.9044066834569928,-12121,Unchanged,100000,5
ypfJ,1889,2527,0.41980296255640537,638,Unchanged,100000,5
tmcA,1729,5079,1.5546066049745162,3350,Unchanged,100000,5
ypfH,1234,1969,0.6741207167521358,735,Unchanged,100000,5
dapE,1373,2801,1.028610357927406,1428,Unchanged,100000,5
yffB,299,509,0.7675201718775903,210,Unchanged,100000,5
acrD,590,7637,3.694219164132008,7047,Unchanged,100000,5
narQ,1044,3821,1.8718285457876267,2777,Unchanged,100000,5
aegA,577,4592,2.9924794180302055,4015,Unchanged,100000,5
nudK,547,1258,1.2015191840867327,711,Unchanged,100000,5
ypfG,1168,2779,1.2505255603205445,1611,Unchanged,100000,5
tktB,9029,5549,-0.7023384089773067,-3480,Unchanged,100000,5
talA,4121,1996,-1.045882742943239,-2125,Unchanged,100000,5
maeB,3955,7260,0.8762918535229589,3305,Unchanged,100000,5
eutS,3,592,7.624490864907794,589,Unchanged,100000,5
eutP,8,762,6.573647187493322,754,Unchanged,100000,5
eutQ,28,1891,6.077578725892158,1863,Unchanged,100000,5
eutT,34,2262,6.0559203727394815,2228,Unchanged,100000,5
eutD,40,3074,6.263973354803409,3034,Unchanged,100000,5
eutM,22,300,3.7693870718585836,278,Unchanged,100000,5
eutN,1,410,8.679480099505446,409,Unchanged,100000,5
eutE,41,3690,6.491853096329675,3649,Unchanged,100000,5
eutJ,17,2236,7.0392416315928505,2219,Unchanged,100000,5
eutG,58,3404,5.87503432655839,3346,Unchanged,100000,5
eutH,64,3375,5.720671786825555,3311,Unchanged,100000,5
eutA,68,3885,5.8362360420447335,3817,Unchanged,100000,5
yffS,1061,1909,0.8473924464891729,848,Unchanged,100000,5
yffR,350,616,0.8155754288625726,266,Unchanged,100000,5
yffQ,19,335,4.1400897719015495,316,Unchanged,100000,5
yffP,70,1248,4.156119201917282,1178,Unchanged,100000,5
yffO,52,584,3.489384840738925,532,Unchanged,100000,5
yffN,21,491,4.547261791535933,470,Unchanged,100000,5
yffM,6,238,5.309855262586788,232,Unchanged,100000,5
yffL,322,1063,1.7230090034164878,741,Unchanged,100000,5
intZ,335,2598,2.9551684301027463,2263,Unchanged,100000,5
eutB,1718,4213,1.2941178794237909,2495,Unchanged,100000,5
eutC,532,1618,1.604713456928788,1086,Unchanged,100000,5
eutL,472,1549,1.7144783794277272,1077,Unchanged,100000,5
eutK,305,1070,1.8107296488382607,765,Unchanged,100000,5
eutR,393,2680,2.7696317830865285,2287,Unchanged,100000,5
hemF,810,1930,1.2526070343834557,1120,Unchanged,100000,5
amiA,1373,2284,0.7342310252157421,911,Unchanged,100000,5
ypeA,656,1134,0.7896529203241452,478,Unchanged,100000,5
yfeZ,277,934,1.7535365736604736,657,Unchanged,100000,5
yfeY,758,1244,0.7147167319595109,486,Unchanged,100000,5
yfeX,5567,2892,-0.9448325309147156,-2675,Unchanged,100000,5
yfeW,108,2888,4.740967524723702,2780,Unchanged,100000,5
murP,144,3370,4.548607874626908,3226,Unchanged,100000,5
murQ,163,2127,3.7058761637295947,1964,Unchanged,100000,5
murR,216,2029,3.2316656475931906,1813,Unchanged,100000,5
ucpA,1306,2375,0.8627726165592418,1069,Unchanged,100000,5
cysP,329,4508,3.7763280264369796,4179,Unchanged,100000,5
cysU,126,2847,4.4979468542423495,2721,Unchanged,100000,5
cysW,204,3261,3.99867338377697,3057,Unchanged,100000,5
cysA,366,5022,3.7783464749874573,4656,Unchanged,100000,5
cysM,795,3112,1.9688152948144741,2317,Unchanged,100000,5
yfeS,267,511,0.9364835492500674,244,Unchanged,100000,5
yfeK,103,367,1.8331357256599945,264,Unchanged,100000,5
pdxK,2480,1933,-0.35949848306300186,-547,Unchanged,100000,5
crr,33596,4329,-2.9561837677075102,-29267,Unchanged,100000,5
ptsI,141378,27201,-2.377826042236528,-114177,Downregulated,100000,5
ptsH,17812,2381,-2.9032099911725697,-15431,Unchanged,100000,5
cysK,9227,22902,1.3115400305896625,13675,Unchanged,100000,5
cysZ,1228,1754,0.5143381870745536,526,Unchanged,100000,5
zipA,6068,3569,-0.7657011841980108,-2499,Unchanged,100000,5
ligA,3873,5243,0.43694104448800836,1370,Unchanged,100000,5
yfeH,505,1848,1.8716094637769005,1343,Unchanged,100000,5
yfeR,249,1853,2.895645233959185,1604,Unchanged,100000,5
yfeN,124,972,2.970616193218906,848,Unchanged,100000,5
xapA,27,1285,5.572665141917772,1258,Unchanged,100000,5
xapB,252,1929,2.936357504549187,1677,Unchanged,100000,5
xapR,432,1545,1.8385036206282683,1113,Unchanged,100000,5
gltX,10436,4711,-1.147463612149531,-5725,Unchanged,100000,5
yfeD,238,384,0.6901447374132127,146,Unchanged,100000,5
yfeC,183,310,0.7604245669901952,127,Unchanged,100000,5
pdeA,2579,3873,0.5866397282391328,1294,Unchanged,100000,5
insL3,895,2493,1.4779232953398818,1598,Unchanged,100000,5
nupC,4556,2436,-0.9032536138017795,-2120,Unchanged,100000,5
mntH,249,2205,3.146561008376802,1956,Unchanged,100000,5
ypeC,313,495,0.6612658680343536,182,Unchanged,100000,5
yfeO,189,1851,3.2918467556495017,1662,Unchanged,100000,5
glk,3112,4006,0.36432036082651587,894,Unchanged,100000,5
fryB,3,312,6.700439718141092,309,Unchanged,100000,5
fryC,28,2076,6.212235806300277,2048,Unchanged,100000,5
ypdF,49,1997,5.348908773328764,1948,Unchanged,100000,5
ypdE,24,1459,5.925801667196735,1435,Unchanged,100000,5
fryA,199,4641,4.543595361626543,4442,Unchanged,100000,5
ypdC,232,1474,2.6675398139674975,1242,Unchanged,100000,5
pyrR,434,979,1.1736138171592156,545,Unchanged,100000,5
pyrS,303,2444,3.0118545863457786,2141,Unchanged,100000,5
alaC,1743,2657,0.6082256583648216,914,Unchanged,100000,5
lpxP,110,1433,3.703463180737486,1323,Unchanged,100000,5
yfdY,183,163,-0.16697168405296492,-20,Unchanged,100000,5
ypdI,5,106,4.405992359675837,101,Unchanged,100000,5
yfdX,40,573,3.8404632338695426,533,Unchanged,100000,5
frc,63,1091,4.114155462823691,1028,Unchanged,100000,5
oxc,43,1478,5.103165799444053,1435,Unchanged,100000,5
yfdV,24,609,4.6653359171851765,585,Unchanged,100000,5
yfdE,57,951,4.060411516695822,894,Unchanged,100000,5
evgS,3760,2604,-0.5300032133993643,-1156,Unchanged,100000,5
evgA,2842,729,-1.9629158349158433,-2113,Unchanged,100000,5
emrK,75,574,2.936088236179807,499,Unchanged,100000,5
emrY,53,797,3.910515459427273,744,Unchanged,100000,5
dsdA,519,1365,1.3950945074493342,846,Unchanged,100000,5
dsdX,86,1253,3.8649059446197627,1167,Unchanged,100000,5
dsdC,460,896,0.9618648711132289,436,Unchanged,100000,5
yfdT,8,130,4.022367813028454,122,Unchanged,100000,5
yfdS,5,163,5.026800059343715,158,Unchanged,100000,5
yfdR,2,349,7.447083226209652,347,Unchanged,100000,5
yfdQ,53,650,3.616375453352618,597,Unchanged,100000,5
yfdP,8,218,4.768184324776926,210,Unchanged,100000,5
yfdO,5,596,6.897240425574799,591,Unchanged,100000,5
yfdN,3,448,7.222392421336448,445,Unchanged,100000,5
yfdM,2,163,6.348728154231077,161,Unchanged,100000,5
yfdL,5,424,6.405992359675837,419,Unchanged,100000,5
yfdK,61,245,2.0059006014396843,184,Unchanged,100000,5
tfaS,22,129,2.5517956367859567,107,Unchanged,100000,5
yfdI,514,142,-1.855877429689196,-372,Unchanged,100000,5
yfdH,920,562,-0.7110637307234491,-358,Unchanged,100000,5
yfdG,289,212,-0.4470052279374796,-77,Unchanged,100000,5
intS,574,1301,1.1804983200421075,727,Unchanged,100000,5
yfdC,477,900,0.9159357352115255,423,Unchanged,100000,5
mlaA,5785,1100,-2.3948134355828303,-4685,Unchanged,100000,5
yfdF,46,258,2.4876652993662414,212,Unchanged,100000,5
fadL,415,1341,1.6921259956701868,926,Unchanged,100000,5
yfcZ,971,280,-1.7940444684742258,-691,Unchanged,100000,5
fadI,57,1688,4.888209174542443,1631,Unchanged,100000,5
fadJ,295,3042,3.366233293475293,2747,Unchanged,100000,5
sixA,1782,871,-1.0327527129230574,-911,Unchanged,100000,5
yfcV,9,496,5.784271308944563,487,Unchanged,100000,5
yfcS,23,1040,5.498805856971441,1017,Unchanged,100000,5
yfcR,35,439,3.6487941125903918,404,Unchanged,100000,5
yfcQ,22,441,4.325203226920223,419,Unchanged,100000,5
yfcP,27,675,4.643856189774724,648,Unchanged,100000,5
yfcO,624,971,0.6379252665569439,347,Unchanged,100000,5
smrB,1050,1099,0.06580205839574609,49,Unchanged,100000,5
prmB,4764,2105,-1.1783531799103557,-2659,Unchanged,100000,5
aroC,6610,3877,-0.7697095366438736,-2733,Unchanged,100000,5
mepA,2355,1967,-0.25973010222161524,-388,Unchanged,100000,5
yfcA,1300,1687,0.3759483503717489,387,Unchanged,100000,5
epmC,1294,1022,-0.34044242105488615,-272,Unchanged,100000,5
yfcL,394,370,-0.09067035894006407,-24,Unchanged,100000,5
mnmC,1426,4951,1.7957459675182725,3525,Unchanged,100000,5
fabB,4505,8243,0.8716423888252957,3738,Unchanged,100000,5
yfcJ,390,2621,2.7485713245788066,2231,Unchanged,100000,5
flk,872,1911,1.1319277382005304,1039,Unchanged,100000,5
pdxB,3710,3424,-0.11573648510701863,-286,Unchanged,100000,5
usg,1978,2961,0.5820420644184431,983,Unchanged,100000,5
truA,555,1242,1.162105496983013,687,Unchanged,100000,5
dedA,692,1230,0.8298143725898777,538,Unchanged,100000,5
accD,13002,4494,-1.5326615296349224,-8508,Unchanged,100000,5
folC,2611,3447,0.40073884105442764,836,Unchanged,100000,5
dedD,2006,1673,-0.26188416057382796,-333,Unchanged,100000,5
cvpA,4868,2123,-1.1972247968083507,-2745,Unchanged,100000,5
purF,7738,5515,-0.48859984296447145,-2223,Unchanged,100000,5
ubiX,634,1019,0.6845993060264066,385,Unchanged,100000,5
argT,206,1178,2.515623296647242,972,Unchanged,100000,5
hisJ,1225,3490,1.5104452872070817,2265,Unchanged,100000,5
hisQ,422,1865,2.143860726435415,1443,Unchanged,100000,5
hisM,278,1192,2.100227447738654,914,Unchanged,100000,5
hisP,311,1687,2.4394734881569633,1376,Unchanged,100000,5
rpnB,127,895,2.817059185379453,768,Unchanged,100000,5
yfcH,1907,2064,0.11413812711049784,157,Unchanged,100000,5
folX,662,308,-1.1039008661123162,-354,Unchanged,100000,5
yfcG,248,841,1.761765679868269,593,Unchanged,100000,5
yfcF,507,894,0.8182890841799771,387,Unchanged,100000,5
yfcE,2076,1156,-0.8446650458572021,-920,Unchanged,100000,5
yfcD,2943,1323,-1.153474480661718,-1620,Unchanged,100000,5
yfcC,1489,2693,0.8548704759195719,1204,Unchanged,100000,5
pta,1966,4752,1.2732715144601852,2786,Unchanged,100000,5
ackA,2,1,-1.0,-1,Unchanged,100000,5
yfbV,1435,1347,-0.09130088610074703,-88,Unchanged,100000,5
yfbU,2808,1368,-1.0374747054186628,-1440,Unchanged,100000,5
hxpA,4106,2090,-0.9742306851403568,-2016,Unchanged,100000,5
yfbS,1499,3405,1.183654414951574,1906,Unchanged,100000,5
yfbR,796,862,0.1149194385454494,66,Unchanged,100000,5
alaA,4858,2801,-0.7944205065613587,-2057,Unchanged,100000,5
lrhA,1614,2427,0.5885335298733533,813,Unchanged,100000,5
nuoA,1799,1096,-0.7149473882909556,-703,Unchanged,100000,5
nuoB,4216,2742,-0.6206462958579887,-1474,Unchanged,100000,5
nuoC,9393,7895,-0.25064674311222684,-1498,Unchanged,100000,5
nuoE,2488,1928,-0.3678814339006409,-560,Unchanged,100000,5
nuoF,6727,5652,-0.2512017924974152,-1075,Unchanged,100000,5
nuoG,10852,10182,-0.09193998201804657,-670,Unchanged,100000,5
nuoH,3331,2832,-0.23413408859135365,-499,Unchanged,100000,5
nuoI,1099,1533,0.4801663107095463,434,Unchanged,100000,5
nuoJ,1365,1481,0.11767068948163283,116,Unchanged,100000,5
nuoK,291,389,0.418751002077908,98,Unchanged,100000,5
nuoL,4609,5209,0.17655266941405348,600,Unchanged,100000,5
nuoM,3547,3878,0.12871347317160373,331,Unchanged,100000,5
nuoN,5211,4153,-0.3274063830067539,-1058,Unchanged,100000,5
yfbP,59,838,3.8281633843375102,779,Unchanged,100000,5
yfbO,30,176,2.5525410230287786,146,Unchanged,100000,5
yfbN,19,398,4.3886971071000636,379,Unchanged,100000,5
yfbM,173,631,1.8668679673458244,458,Unchanged,100000,5
yfbL,28,1046,5.223312214189337,1018,Unchanged,100000,5
yfbK,79,2576,5.027136129937515,2497,Unchanged,100000,5
elaD,55,415,2.9156078127096277,360,Unchanged,100000,5
rbn,411,1558,1.9224849343799864,1147,Unchanged,100000,5
elaA,690,784,0.18425729244967684,94,Unchanged,100000,5
elaB,9861,641,-3.9433376951827253,-9220,Unchanged,100000,5
menF,1610,2641,0.7140236131651136,1031,Unchanged,100000,5
menD,1714,4043,1.238059094159195,2329,Unchanged,100000,5
menH,147,1329,3.17645304443981,1182,Unchanged,100000,5
menB,3115,2260,-0.4629093906088141,-855,Unchanged,100000,5
menC,2646,2405,-0.13777616762127248,-241,Unchanged,100000,5
menE,1821,3248,0.834820710208338,1427,Unchanged,100000,5
pmrD,174,246,0.49957100949051153,72,Unchanged,100000,5
arnF,69,400,2.5353317329965557,331,Unchanged,100000,5
arnT,173,2970,4.101618988051404,2797,Unchanged,100000,5
arnD,129,1585,3.6190398696035158,1456,Unchanged,100000,5
arnA,615,3468,2.4954455829952327,2853,Unchanged,100000,5
arnC,164,1267,2.9496488045227256,1103,Unchanged,100000,5
arnB,326,2036,2.6427936918446178,1710,Unchanged,100000,5
ais,34,458,3.7517409468466045,424,Unchanged,100000,5
nudI,203,508,1.3233487695869897,305,Unchanged,100000,5
yfaZ,155,796,2.3605002152694112,641,Unchanged,100000,5
yfaY,1564,2724,0.8004861907047189,1160,Unchanged,100000,5
yfaX,17,1011,5.894104440652675,994,Unchanged,100000,5
rhmD,49,2224,5.504231228608299,2175,Unchanged,100000,5
yfaV,37,2380,6.007292492566356,2343,Unchanged,100000,5
yfaU,40,1353,5.0800180290891745,1313,Unchanged,100000,5
rpnE,283,1170,2.0476345716388846,887,Unchanged,100000,5
glpC,14723,6938,-1.0854799232219399,-7785,Unchanged,100000,5
glpB,17244,9755,-0.8218806896821039,-7489,Unchanged,100000,5
glpA,27879,16500,-0.7567127892131932,-11379,Unchanged,100000,5
glpT,9621,4959,-0.956137629149333,-4662,Unchanged,100000,5
glpQ,8403,3497,-1.2647866880979461,-4906,Unchanged,100000,5
yfaH,3,106,5.142957953842043,103,Unchanged,100000,5
inaA,544,1205,1.1473545898669844,661,Unchanged,100000,5
yfaE,201,241,0.26183764505103296,40,Unchanged,100000,5
nrdB,2013,2355,0.2263798875788059,342,Unchanged,100000,5
nrdA,1142,4666,2.0306236566213562,3524,Unchanged,100000,5
yfaL,1171,6569,2.487932689709059,5398,Unchanged,100000,5
ubiG,1622,1788,0.14057291696604474,166,Unchanged,100000,5
gyrA,16891,12835,-0.39617144681057487,-4056,Unchanged,100000,5
yfaA,167,2759,4.046225448879221,2592,Unchanged,100000,5
yfaT,17,849,5.642157902302699,832,Unchanged,100000,5
yfaQ,111,2774,4.643336205973497,2663,Unchanged,100000,5
yfaP,28,1013,5.1770635367435345,985,Unchanged,100000,5
atoB,96,1658,4.110265790774594,1562,Unchanged,100000,5
atoE,62,2130,5.102441404726325,2068,Unchanged,100000,5
atoA,9,989,6.779901709316799,980,Unchanged,100000,5
atoD,12,953,6.311369903188786,941,Unchanged,100000,5
atoC,286,1897,2.7296326266330864,1611,Unchanged,100000,5
atoS,165,2557,3.953914230995833,2392,Unchanged,100000,5
rcsC,3070,5008,0.7059959066750766,1938,Unchanged,100000,5
rcsB,6121,2103,-1.5413185180747846,-4018,Unchanged,100000,5
rcsD,7900,6604,-0.25851253303856964,-1296,Unchanged,100000,5
ompC,353442,36375,-3.2804543343829895,-317067,Downregulated,100000,5
ftp,341,2012,2.5607866607813548,1671,Unchanged,100000,5
ada,613,2311,1.9145582807768495,1698,Unchanged,100000,5
alkB,157,1046,2.7360463873553145,889,Unchanged,100000,5
yojI,106,2952,4.799556551497197,2846,Unchanged,100000,5
mqo,82,3739,5.510884751240085,3657,Unchanged,100000,5
eco,1033,860,-0.26443168927559924,-173,Unchanged,100000,5
napF,210,1020,2.2801079191927354,810,Unchanged,100000,5
napD,41,288,2.812372996824229,247,Unchanged,100000,5
napA,1787,7122,1.9947428013215722,5335,Unchanged,100000,5
napG,268,1491,2.47597535182567,1223,Unchanged,100000,5
napH,250,1942,2.957543200757105,1692,Unchanged,100000,5
napB,144,787,2.450294824065174,643,Unchanged,100000,5
napC,321,946,1.5592668862170922,625,Unchanged,100000,5
ccmA,437,1405,1.68486494560769,968,Unchanged,100000,5
ccmB,202,1227,2.6027080509111102,1025,Unchanged,100000,5
ccmC,401,1443,1.8473971580362778,1042,Unchanged,100000,5
ccmD,39,184,2.2381597371947644,145,Unchanged,100000,5
ccmE,332,939,1.4999419163068497,607,Unchanged,100000,5
ccmF,792,4796,2.598259323334614,4004,Unchanged,100000,5
ccmG,203,921,2.1817214289061595,718,Unchanged,100000,5
ccmH,455,1900,2.0620609681322515,1445,Unchanged,100000,5
narP,1519,1264,-0.2651254063249806,-255,Unchanged,100000,5
insH8,7246,3927,-0.8837572077868905,-3319,Unchanged,100000,5
yejM,1918,3987,1.0557008849792,2069,Unchanged,100000,5
yejL,277,210,-0.3994966483830657,-67,Unchanged,100000,5
yejK,3066,2200,-0.47885417324675567,-866,Unchanged,100000,5
rplY,9196,1156,-2.991865068217501,-8040,Unchanged,100000,5
radD,504,3226,2.6782507996557263,2722,Unchanged,100000,5
rsuA,1416,1479,0.06280078701607025,63,Unchanged,100000,5
bcr,1387,2263,0.7062687969432897,876,Unchanged,100000,5
yejG,163,505,1.6314114234080794,342,Unchanged,100000,5
yejF,716,2588,1.8538061247282511,1872,Unchanged,100000,5
yejE,272,1356,2.3176786218860044,1084,Unchanged,100000,5
yejB,322,1590,2.3038941720571007,1268,Unchanged,100000,5
yejA,1017,2815,1.4688152431100918,1798,Unchanged,100000,5
pdeN,611,2480,2.021095835455508,1869,Unchanged,100000,5
mepS,8428,1858,-2.1814398124346535,-6570,Unchanged,100000,5
lpxT,494,771,0.6422198183303567,277,Unchanged,100000,5
yeiR,757,1704,1.1705601302401067,947,Unchanged,100000,5
yeiQ,90,2504,4.798165750602943,2414,Unchanged,100000,5
yeiP,1136,542,-1.0675980781508105,-594,Unchanged,100000,5
setB,91,1872,4.362570079384708,1781,Unchanged,100000,5
fruB,12073,3052,-1.9839573462841358,-9021,Unchanged,100000,5
fruK,8840,2580,-1.7766753039681773,-6260,Unchanged,100000,5
fruA,22641,5623,-2.009525728050357,-17018,Unchanged,100000,5
psuK,40,977,4.610286657081023,937,Unchanged,100000,5
psuG,83,1428,4.104740832682175,1345,Unchanged,100000,5
psuT,211,2147,3.3470072871515884,1936,Unchanged,100000,5
yeiL,35,501,3.839383776250242,466,Unchanged,100000,5
rihB,21,1173,5.803669875249748,1152,Unchanged,100000,5
nupX,52,1823,5.131659127898042,1771,Unchanged,100000,5
yeiI,661,1942,1.5548210239115006,1281,Unchanged,100000,5
nfo,985,1790,0.8617639578078801,805,Unchanged,100000,5
yeiH,1807,1907,0.07770833744815672,100,Unchanged,100000,5
yeiE,1258,1735,0.46380374058633406,477,Unchanged,100000,5
lysP,3826,2848,-0.4258877273797146,-978,Unchanged,100000,5
cirA,218,3231,3.8895807104884375,3013,Unchanged,100000,5
yeiG,3311,3785,0.19302628947609457,474,Unchanged,100000,5
folE,6927,1649,-2.0706392750578044,-5278,Unchanged,100000,5
yeiB,1356,2163,0.6736764868256349,807,Unchanged,100000,5
galS,218,1860,3.092902581218467,1642,Unchanged,100000,5
mglB,126,1676,3.733526510199435,1550,Unchanged,100000,5
mglA,30,1812,5.916476644437717,1782,Unchanged,100000,5
mglC,34,1684,5.630213581816057,1650,Unchanged,100000,5
preA,1569,2762,0.8158679672899533,1193,Unchanged,100000,5
preT,2219,3272,0.5602630807447375,1053,Unchanged,100000,5
yeiS,54,189,1.8073549220576042,135,Unchanged,100000,5
sanA,314,929,1.5649140374910258,615,Unchanged,100000,5
cdd,632,2438,1.9477016624431092,1806,Unchanged,100000,5
yohK,185,1505,3.0241663111307524,1320,Unchanged,100000,5
yohJ,86,802,3.2211936717528222,716,Unchanged,100000,5
dusC,165,2308,3.806105294399667,2143,Unchanged,100000,5
mdtQ,39,3047,6.2877715658242375,3008,Unchanged,100000,5
yohF,287,1591,2.47081119365536,1304,Unchanged,100000,5
yohD,419,1101,1.3937923198650173,682,Unchanged,100000,5
yohC,377,1073,1.5090136474878577,696,Unchanged,100000,5
pbpG,1595,1746,0.13049713497720836,151,Unchanged,100000,5
dld,4718,4521,-0.0615335009204825,-197,Unchanged,100000,5
bglX,3112,6246,1.0050905090343814,3134,Unchanged,100000,5
osmF,919,1761,0.9382581425421738,842,Unchanged,100000,5
yehY,448,2612,2.543584259488827,2164,Unchanged,100000,5
yehX,252,2102,3.060267030462262,1850,Unchanged,100000,5
yehW,135,1352,3.3240638392313535,1217,Unchanged,100000,5
mlrA,430,1274,1.5669567126668402,844,Unchanged,100000,5
btsS,453,3196,2.8186844528817416,2743,Unchanged,100000,5
btsR,363,1122,1.628031222613042,759,Unchanged,100000,5
yehS,271,770,1.5065655942283922,499,Unchanged,100000,5
yehR,16,435,4.764871590736091,419,Unchanged,100000,5
yehQ,123,3454,4.8115378621896845,3331,Unchanged,100000,5
yehP,32,1860,5.861086905995394,1828,Unchanged,100000,5
yehM,68,4365,6.004303097266463,4297,Unchanged,100000,5
yehL,22,1949,6.469086756620593,1927,Unchanged,100000,5
yehI,305,5956,4.287462606131851,5651,Unchanged,100000,5
metG,10395,6258,-0.7321161945048105,-4137,Unchanged,100000,5
mrp,6457,4014,-0.6858234103847323,-2443,Unchanged,100000,5
yehE,273,95,-1.5229015325889046,-178,Unchanged,100000,5
yehD,115,218,0.9226942738325511,103,Unchanged,100000,5
yehC,16,387,4.59618975614441,371,Unchanged,100000,5
yehB,89,2652,4.89713162914619,2563,Unchanged,100000,5
yehA,18,434,4.5916262310021665,416,Unchanged,100000,5
rcnB,1118,456,-1.2938144586784484,-662,Unchanged,100000,5
rcnA,78,1094,3.809994803930308,1016,Unchanged,100000,5
rcnR,115,276,1.2630344058337937,161,Unchanged,100000,5
thiM,194,1102,2.50599566638403,908,Unchanged,100000,5
thiD,232,1166,2.329371078072924,934,Unchanged,100000,5
yegX,154,1141,2.8892965355937803,987,Unchanged,100000,5
yegW,332,1003,1.595066459265256,671,Unchanged,100000,5
yegV,288,1793,2.6382347714260623,1505,Unchanged,100000,5
yegU,323,1996,2.627505650643336,1673,Unchanged,100000,5
yegT,140,2037,3.8629472480209217,1897,Unchanged,100000,5
fbaB,28402,3261,-3.1226061781960226,-25141,Unchanged,100000,5
gatY,63081,52673,-0.2601419000437396,-10408,Unchanged,100000,5
gatZ,94167,68585,-0.45732848476521315,-25582,Unchanged,100000,5
gatA,12288,8185,-0.5861957993596403,-4103,Unchanged,100000,5
gatB,6011,1944,-1.6285768011158377,-4067,Unchanged,100000,5
gatC,39885,22508,-0.825408409408629,-17377,Unchanged,100000,5
gatD,5237,6935,0.405155277761614,1698,Unchanged,100000,5
insF5,30,675,4.491853096329675,645,Unchanged,100000,5
insE5,80,103,0.3645724322958561,23,Unchanged,100000,5
yegS,830,1382,0.7355743741539715,552,Unchanged,100000,5
yegR,26,87,1.7425037777076362,61,Unchanged,100000,5
yegZ,5,57,3.5109619192773796,52,Unchanged,100000,5
ogrK,95,130,0.4525122046975067,35,Unchanged,100000,5
trhP,1783,3475,0.9627062748732371,1692,Unchanged,100000,5
yegP,396,276,-0.5208321633014404,-120,Unchanged,100000,5
baeR,709,1435,1.017193204323534,726,Unchanged,100000,5
baeS,206,2176,3.400962314067121,1970,Unchanged,100000,5
mdtD,195,2620,3.748020782675202,2425,Unchanged,100000,5
mdtC,498,6795,3.7702559035866727,6297,Unchanged,100000,5
mdtB,687,7160,3.3815775833335184,6473,Unchanged,100000,5
mdtA,358,2090,2.5454714497039888,1732,Unchanged,100000,5
yegL,54,1058,4.292236409950557,1004,Unchanged,100000,5
pphC,23,1372,5.898502810115799,1349,Unchanged,100000,5
yegJ,19,339,4.157213949692759,320,Unchanged,100000,5
yegI,167,3354,4.327962681090294,3187,Unchanged,100000,5
yegD,419,2672,2.6728978587747005,2253,Unchanged,100000,5
alkA,316,1378,2.1245794245271883,1062,Unchanged,100000,5
dgcE,1170,6681,2.5135555290381792,5511,Unchanged,100000,5
udk,1166,1154,-0.014924564555013892,-12,Unchanged,100000,5
dcd,3006,2147,-0.4855228180575914,-859,Unchanged,100000,5
asmA,3564,4666,0.38868897046227724,1102,Unchanged,100000,5
yegH,1224,3651,1.5766881107422328,2427,Unchanged,100000,5
wza,169,1416,3.0667261138008133,1247,Unchanged,100000,5
wzb,37,533,3.848538357130226,496,Unchanged,100000,5
wzc,342,3733,3.448267278417172,3391,Unchanged,100000,5
wcaA,129,1122,3.1206297051855385,993,Unchanged,100000,5
wcaB,60,557,3.2146429217315133,497,Unchanged,100000,5
wcaC,155,1827,3.559136513353251,1672,Unchanged,100000,5
wcaD,137,944,2.7846109664013143,807,Unchanged,100000,5
wcaE,64,682,3.4136279290241727,618,Unchanged,100000,5
wcaF,31,426,3.780513309838963,395,Unchanged,100000,5
gmd,291,1452,2.318950395087467,1161,Unchanged,100000,5
fcl,241,1314,2.446860224092368,1073,Unchanged,100000,5
gmm,66,437,2.727095350142145,371,Unchanged,100000,5
wcaI,137,1658,3.5971962085352236,1521,Unchanged,100000,5
cpsB,146,2095,3.842909969706697,1949,Unchanged,100000,5
cpsG,135,1835,3.764748750679744,1700,Unchanged,100000,5
wcaJ,108,1972,4.190556334214443,1864,Unchanged,100000,5
wzxC,103,1853,4.1691466388440475,1750,Unchanged,100000,5
wcaK,198,1800,3.1844245711374275,1602,Unchanged,100000,5
wcaL,283,1732,2.6135649718948426,1449,Unchanged,100000,5
wcaM,260,1368,2.3954847018574434,1108,Unchanged,100000,5
galF,12704,2315,-2.456198718995359,-10389,Unchanged,100000,5
rfbB,4733,1652,-1.5185412353189183,-3081,Unchanged,100000,5
rfbD,3083,1511,-1.028831228942346,-1572,Unchanged,100000,5
rfbA,3124,1145,-1.448046855157673,-1979,Unchanged,100000,5
rfbC,1192,395,-1.5934596773976963,-797,Unchanged,100000,5
rfbX,1662,601,-1.467483486059159,-1061,Unchanged,100000,5
glf,2686,1029,-1.3842163225334738,-1657,Unchanged,100000,5
wbbH,987,513,-0.9440912588493436,-474,Unchanged,100000,5
wbbI,2331,592,-1.9772799234999165,-1739,Unchanged,100000,5
wbbJ,1085,583,-0.8961272541313453,-502,Unchanged,100000,5
wbbK,1597,283,-2.4964903545793504,-1314,Unchanged,100000,5
insH7,2926,2885,-0.02035845060564203,-41,Unchanged,100000,5
gnd,40426,5825,-2.7949535065669906,-34601,Unchanged,100000,5
ugd,1130,905,-0.3203330753319823,-225,Unchanged,100000,5
wzzB,6004,2255,-1.412796543477945,-3749,Unchanged,100000,5
hisI,1914,1093,-0.808297428814121,-821,Unchanged,100000,5
hisF,1889,1433,-0.39858409212622414,-456,Unchanged,100000,5
hisA,1544,1471,-0.06987550601325024,-73,Unchanged,100000,5
hisH,1302,1105,-0.23668307888684156,-197,Unchanged,100000,5
hisB,3244,2322,-0.4824058473517066,-922,Unchanged,100000,5
hisC,2844,2568,-0.1472762624971122,-276,Unchanged,100000,5
hisD,3180,3383,0.0892764116222706,203,Unchanged,100000,5
hisG,2132,2193,0.04069837391441764,61,Unchanged,100000,5
hisL,1,1,0.0,0,Unchanged,100000,5
yefM,295,285,-0.049753035197099615,-10,Unchanged,100000,5
yeeZ,3853,2428,-0.6662137644038679,-1425,Unchanged,100000,5
yeeY,311,1361,2.129680581373392,1050,Unchanged,100000,5
plaP,1482,1908,0.36451572369967766,426,Unchanged,100000,5
yeeE,251,2267,3.175025121790014,2016,Unchanged,100000,5
yeeD,97,310,1.67621156308711,213,Unchanged,100000,5
sbcB,2188,2526,0.20724190099499581,338,Unchanged,100000,5
dacD,369,1468,1.9921592467828166,1099,Unchanged,100000,5
sbmC,870,514,-0.7592470415422125,-356,Unchanged,100000,5
yeeA,580,1031,0.829919527353174,451,Unchanged,100000,5
yeeX,6484,1324,-2.291980968710324,-5160,Unchanged,100000,5
yeeW,6,27,2.169925001442312,21,Unchanged,100000,5
cbtA,9,194,4.429987840744816,185,Unchanged,100000,5
cbeA,17,318,4.225420114034016,301,Unchanged,100000,5
yeeT,5,88,4.137503523749935,83,Unchanged,100000,5
yeeS,81,450,2.473931188332412,369,Unchanged,100000,5
yeeR,1122,2184,0.9609001803110596,1062,Unchanged,100000,5
flu,38462,25731,-0.5799262573462889,-12731,Unchanged,100000,5
yeeP,83,557,2.746494085993107,474,Unchanged,100000,5
insC3,233,153,-0.6067983019616285,-80,Unchanged,100000,5
insD3,456,438,-0.05810295456356828,-18,Unchanged,100000,5
insH6,511,1656,1.6963074765617039,1145,Unchanged,100000,5
cobU,194,535,1.4634822391013815,341,Unchanged,100000,5
cobS,373,1097,1.556315990147955,724,Unchanged,100000,5
cobT,829,1589,0.9386751178527688,760,Unchanged,100000,5
ldtA,1397,1039,-0.4271363665052513,-358,Unchanged,100000,5
nac,79,638,3.0136318655877665,559,Unchanged,100000,5
cbl,117,875,2.902774487136287,758,Unchanged,100000,5
yeeO,650,1648,1.3422046192674015,998,Unchanged,100000,5
yeeN,1875,761,-1.30092223676706,-1114,Unchanged,100000,5
amn,4097,2585,-0.6644036122780042,-1512,Unchanged,100000,5
shiA,1386,1416,0.030894007945783775,30,Unchanged,100000,5
yeeJ,1294,7180,2.472146226717906,5886,Unchanged,100000,5
mtfA,1449,900,-0.6870606883398924,-549,Unchanged,100000,5
yodB,70,270,1.9475325801058645,200,Unchanged,100000,5
zinT,51,190,1.8974302663594522,139,Unchanged,100000,5
msrQ,194,536,1.4661763482706447,342,Unchanged,100000,5
msrP,476,1049,1.1399811992693243,573,Unchanged,100000,5
hiuH,31,173,2.4804319172498497,142,Unchanged,100000,5
hprR,378,491,0.3773367900936203,113,Unchanged,100000,5
hprS,416,747,0.8445247146481449,331,Unchanged,100000,5
hchA,6245,911,-2.7771786126932687,-5334,Unchanged,100000,5
drpB,486,353,-0.4612881303346007,-133,Unchanged,100000,5
yedJ,1422,1072,-0.40761655916164274,-350,Unchanged,100000,5
dcm,2938,2402,-0.2905982448506457,-536,Unchanged,100000,5
vsr,225,410,0.865698908288409,185,Unchanged,100000,5
yedA,31,882,4.830438535170646,851,Unchanged,100000,5
yedI,806,1206,0.5813781633721175,400,Unchanged,100000,5
yodC,133,80,-0.7333543406138273,-53,Unchanged,100000,5
dgcQ,1065,2066,0.9559868237518588,1001,Unchanged,100000,5
yedP,900,874,-0.04229172171643864,-26,Unchanged,100000,5
dsrA,1,1,0.0,0,Unchanged,100000,5
yodD,312,101,-1.6271907361104536,-211,Unchanged,100000,5
dsrB,115,50,-1.2016338611696507,-65,Unchanged,100000,5
rcsA,605,214,-1.49932434576081,-391,Unchanged,100000,5
fliR,70,733,3.3883863711888456,663,Unchanged,100000,5
fliQ,39,187,2.261492241025388,148,Unchanged,100000,5
fliP,195,683,1.8084114545404797,488,Unchanged,100000,5
fliO,160,315,0.9772799234999164,155,Unchanged,100000,5
fliN,343,301,-0.1884450894131103,-42,Unchanged,100000,5
fliM,895,1085,0.277735455180223,190,Unchanged,100000,5
fliL,388,325,-0.25561693427131077,-63,Unchanged,100000,5
fliK,341,1315,1.9472191551554923,974,Unchanged,100000,5
fliJ,128,315,1.2992080183872787,187,Unchanged,100000,5
fliI,526,1813,1.7852442204518557,1287,Unchanged,100000,5
fliH,546,839,0.6197698595199709,293,Unchanged,100000,5
fliG,755,1299,0.78285288123544,544,Unchanged,100000,5
fliF,1100,2147,0.9648186674467513,1047,Unchanged,100000,5
fliE,356,213,-0.7410238107405596,-143,Unchanged,100000,5
intG,1,14,3.807354922057604,13,Unchanged,100000,5
yedL,77,406,2.398549376490275,329,Unchanged,100000,5
yedK,102,706,2.7910990312996846,604,Unchanged,100000,5
yedF,150,110,-0.4474589769712214,-40,Unchanged,100000,5
yedE,1585,1795,0.17950100368364416,210,Unchanged,100000,5
yedD,1123,564,-0.9935908600018076,-559,Unchanged,100000,5
amyA,977,1698,0.7974059915846532,721,Unchanged,100000,5
fliT,50,268,2.4222330006830477,218,Unchanged,100000,5
fliS,97,263,1.4390061471051747,166,Unchanged,100000,5
fliD,453,1915,2.079761436766084,1462,Unchanged,100000,5
fliC,4914,1763,-1.4788653830419831,-3151,Unchanged,100000,5
fliA,2101,761,-1.4651078031695006,-1340,Unchanged,100000,5
fliZ,827,527,-0.6500843675340601,-300,Unchanged,100000,5
tcyJ,4462,4044,-0.14190751634112583,-418,Unchanged,100000,5
dcyD,2511,2486,-0.01443573221901491,-25,Unchanged,100000,5
tcyL,929,1102,0.24637372218850462,173,Unchanged,100000,5
tcyN,1082,1431,0.4033231728998524,349,Unchanged,100000,5
sdiA,168,686,2.029747343394052,518,Unchanged,100000,5
yecF,153,71,-1.1076407231879697,-82,Unchanged,100000,5
uvrY,2317,1116,-1.0539210170356341,-1201,Unchanged,100000,5
uvrC,3224,3042,-0.08383159080347061,-182,Unchanged,100000,5
pgsA,1305,840,-0.6355885737911242,-465,Unchanged,100000,5
yecA,2045,1225,-0.7393190939391782,-820,Unchanged,100000,5
tyrP,643,1570,1.287873916451042,927,Unchanged,100000,5
yecH,461,271,-0.7664738990754665,-190,Unchanged,100000,5
ftnA,20910,1511,-3.7906174963121124,-19399,Unchanged,100000,5
yecR,63,203,1.6880559936852597,140,Unchanged,100000,5
ftnB,1587,552,-1.5235619560570128,-1035,Unchanged,100000,5
araF,121,1145,3.2422686457097116,1024,Unchanged,100000,5
araG,171,2094,3.6141932120449107,1923,Unchanged,100000,5
otsB,2591,1202,-1.108072119468909,-1389,Unchanged,100000,5
otsA,8145,2323,-1.8099255446040725,-5822,Unchanged,100000,5
uspC,284,318,0.1631358357796734,34,Unchanged,100000,5
insA5,26,90,1.7914133781885826,64,Unchanged,100000,5
insB5,32,769,4.586839787961827,737,Unchanged,100000,5
flhD,773,319,-1.276911990159978,-454,Unchanged,100000,5
flhC,1344,571,-1.2349704874159175,-773,Unchanged,100000,5
motA,183,1257,2.780069096136465,1074,Unchanged,100000,5
motB,154,1315,3.0940605434847632,1161,Unchanged,100000,5
cheA,517,2872,2.473819563508117,2355,Unchanged,100000,5
cheW,188,540,1.5222267453731935,352,Unchanged,100000,5
tar,475,2445,2.363835046621286,1970,Unchanged,100000,5
tap,282,2352,3.0601209924375707,2070,Unchanged,100000,5
cheR,124,1158,3.2232232276023614,1034,Unchanged,100000,5
cheB,99,1349,3.768318012868658,1250,Unchanged,100000,5
cheY,95,346,1.864772619305777,251,Unchanged,100000,5
cheZ,243,875,1.8483267031139103,632,Unchanged,100000,5
flhB,506,1618,1.6770023177356674,1112,Unchanged,100000,5
flhA,997,3210,1.6869078876114694,2213,Unchanged,100000,5
flhE,96,337,1.8116422804607022,241,Unchanged,100000,5
yecT,35,172,2.2969817377571315,137,Unchanged,100000,5
argS,4800,3297,-0.5418805188254936,-1503,Unchanged,100000,5
yecM,543,764,0.4926204402313871,221,Unchanged,100000,5
cutC,936,1099,0.23161095136582666,163,Unchanged,100000,5
torY,13,938,6.173004394374285,925,Unchanged,100000,5
torZ,328,3126,3.2525500583815807,2798,Unchanged,100000,5
cmoB,1181,1623,0.4586540351508142,442,Unchanged,100000,5
cmoA,1152,1150,-0.0025068556105748664,-2,Unchanged,100000,5
yecN,669,469,-0.5124182881260844,-200,Unchanged,100000,5
yecE,315,803,1.3500481591300355,488,Unchanged,100000,5
yecD,866,874,0.013266254773873592,8,Unchanged,100000,5
aspS,9753,8775,-0.1524469313322267,-978,Unchanged,100000,5
nudB,978,810,-0.27191255718024665,-168,Unchanged,100000,5
yebC,2981,2288,-0.38170932321277934,-693,Unchanged,100000,5
ruvC,1283,1176,-0.12563311025331814,-107,Unchanged,100000,5
yebB,37,434,3.5520978668155294,397,Unchanged,100000,5
ruvA,769,747,-0.04187535517258934,-22,Unchanged,100000,5
ruvB,2052,1825,-0.16913426695231218,-227,Unchanged,100000,5
znuB,644,963,0.5804751097288424,319,Unchanged,100000,5
znuC,759,939,0.30702527223830817,180,Unchanged,100000,5
znuA,1247,1272,0.028637205454685438,25,Unchanged,100000,5
mepM,4091,3182,-0.3625197015569986,-909,Unchanged,100000,5
lpxM,1591,1727,0.11833424719787643,136,Unchanged,100000,5
pykA,39109,14137,-1.4680246478466752,-24972,Unchanged,100000,5
yebK,829,1338,0.6906341091457104,509,Unchanged,100000,5
zwf,5426,2890,-0.908819554893825,-2536,Unchanged,100000,5
edd,3784,2938,-0.3650776927831154,-846,Unchanged,100000,5
eda,9402,2647,-1.828609485698338,-6755,Unchanged,100000,5
purT,3466,1840,-0.9135658882157943,-1626,Unchanged,100000,5
yebG,1595,615,-1.3748981084256295,-980,Unchanged,100000,5
yebF,1866,906,-1.0423660308055236,-960,Unchanged,100000,5
yebE,617,1215,0.9776139193437254,598,Unchanged,100000,5
ptrB,1446,2692,0.8966108576591993,1246,Unchanged,100000,5
exoX,1039,965,-0.10659480674876895,-74,Unchanged,100000,5
yobB,1053,749,-0.4914678125669659,-304,Unchanged,100000,5
holE,509,130,-1.9691540330472408,-379,Unchanged,100000,5
yobA,1006,736,-0.4508526337485142,-270,Unchanged,100000,5
yebZ,1348,2008,0.5749387727689135,660,Unchanged,100000,5
yebY,664,333,-0.9956610642756626,-331,Unchanged,100000,5
pphA,105,590,2.490325626583081,485,Unchanged,100000,5
yebW,76,48,-0.6629650127224294,-28,Unchanged,100000,5
yebV,517,89,-2.538287039348537,-428,Unchanged,100000,5
rsmF,596,1844,1.6294544199671765,1248,Unchanged,100000,5
letB,2046,3532,0.7876791979031373,1486,Unchanged,100000,5
letA,828,1540,0.8952276780829385,712,Unchanged,100000,5
msrC,4221,843,-2.3239802930156066,-3378,Unchanged,100000,5
proQ,9926,2443,-2.022558591029864,-7483,Unchanged,100000,5
prc,14880,4310,-1.7876147520189332,-10570,Unchanged,100000,5
htpX,5623,4150,-0.4382287104191545,-1473,Unchanged,100000,5
yebQ,59,1292,4.452747305332084,1233,Unchanged,100000,5
kdgR,2476,1831,-0.4353795234169275,-645,Unchanged,100000,5
mgrB,45,11,-2.0324214776923775,-34,Unchanged,100000,5
yebO,760,220,-1.7884958948062881,-540,Unchanged,100000,5
yobF,1076,53,-4.343541907993425,-1023,Unchanged,100000,5
cspC,8006,425,-4.235546869362475,-7581,Unchanged,100000,5
rlmA,545,971,0.8332150657549035,426,Unchanged,100000,5
mntP,177,656,1.8899464545350864,479,Unchanged,100000,5
yobD,853,446,-0.9355020313979854,-407,Unchanged,100000,5
manZ,23603,10209,-1.2091286842324276,-13394,Unchanged,100000,5
manY,23378,10298,-1.1827873365932655,-13080,Unchanged,100000,5
manX,24692,11537,-1.0977755719525577,-13155,Unchanged,100000,5
yoaE,1632,2503,0.6170172337168363,871,Unchanged,100000,5
pdeD,324,1715,2.40414285817555,1391,Unchanged,100000,5
sdaA,1818,2541,0.4830441758592477,723,Unchanged,100000,5
nudL,547,694,0.34339482978570424,147,Unchanged,100000,5
pabB,1206,1971,0.7086978691434009,765,Unchanged,100000,5
yoaH,124,85,-0.5448053742491735,-39,Unchanged,100000,5
yoaC,291,174,-0.7419318470595556,-117,Unchanged,100000,5
yoaB,2553,549,-2.21731548340192,-2004,Unchanged,100000,5
yoaA,2064,3174,0.6208591574119279,1110,Unchanged,100000,5
tsaB,661,1159,0.8101583894987802,498,Unchanged,100000,5
yeaY,919,821,-0.16268263951122966,-98,Unchanged,100000,5
fadD,671,2176,1.6972938850501558,1505,Unchanged,100000,5
rnd,994,1599,0.6858521819180459,605,Unchanged,100000,5
yeaX,155,953,2.6202079986357045,798,Unchanged,100000,5
yeaW,107,1439,3.7493838903391508,1332,Unchanged,100000,5
yeaV,86,1656,4.267222202797227,1570,Unchanged,100000,5
dmlA,87244,1543,-5.8212459497692866,-85701,Unchanged,100000,5
dmlR,1036,1117,0.10860518279676099,81,Unchanged,100000,5
leuE,629,481,-0.38702312310924736,-148,Unchanged,100000,5
yeaR,28,246,3.1351595832816357,218,Unchanged,100000,5
yoaG,2,16,3.0,14,Unchanged,100000,5
yeaQ,2365,186,-3.668465657118726,-2179,Unchanged,100000,5
dgcP,2402,1469,-0.7094017551493541,-933,Unchanged,100000,5
yoaF,80,152,0.925999418556223,72,Unchanged,100000,5
yeaO,358,340,-0.07442484112655467,-18,Unchanged,100000,5
nimT,144,1366,3.245816766847778,1222,Unchanged,100000,5
nimR,279,908,1.7024271754617275,629,Unchanged,100000,5
yeaL,294,508,0.7890123419358014,214,Unchanged,100000,5
yoaI,1,1,0.0,0,Unchanged,100000,5
yeaK,1322,1063,-0.31458057997658706,-259,Unchanged,100000,5
dgcJ,427,1152,1.431832741821822,725,Unchanged,100000,5
cdgI,122,762,2.6429098499304358,640,Unchanged,100000,5
yeaH,733,1323,0.851927958144865,590,Unchanged,100000,5
yeaG,2926,2511,-0.220667740866987,-415,Unchanged,100000,5
mipA,4677,1445,-1.6945139360308996,-3232,Unchanged,100000,5
yeaE,704,1153,0.7117451790144745,449,Unchanged,100000,5
yeaD,11466,1765,-2.69962209554007,-9701,Unchanged,100000,5
gapA,318154,45160,-2.8166078688035605,-272994,Downregulated,100000,5
msrB,802,753,-0.09095237178299216,-49,Unchanged,100000,5
yeaC,448,415,-0.11038739582331702,-33,Unchanged,100000,5
ydjL,137,1262,3.203464112022022,1125,Unchanged,100000,5
ydjK,106,1349,3.6697541783850687,1243,Unchanged,100000,5
ydjJ,99,1112,3.4895844526438977,1013,Unchanged,100000,5
ydjI,154,755,2.2935462935175397,601,Unchanged,100000,5
ydjH,101,849,3.0714092608012438,748,Unchanged,100000,5
ydjG,190,944,2.3127874410308937,754,Unchanged,100000,5
ydjF,463,574,0.3100385434154514,111,Unchanged,100000,5
ydjE,45,1157,4.6843200527778155,1112,Unchanged,100000,5
pncA,444,792,0.8349407537295036,348,Unchanged,100000,5
ansA,561,1260,1.167351057778486,699,Unchanged,100000,5
sppA,1986,2726,0.45691993927683555,740,Unchanged,100000,5
ydjA,1447,1795,0.31091892217868905,348,Unchanged,100000,5
selD,6696,4166,-0.6846366885096968,-2530,Unchanged,100000,5
topB,5499,5407,-0.024340930179042635,-92,Unchanged,100000,5
ynjI,130,717,2.4634614956734504,587,Unchanged,100000,5
gdhA,22177,12819,-0.7907804948627224,-9358,Unchanged,100000,5
ynjH,44,145,1.7204774713776372,101,Unchanged,100000,5
nudG,113,442,1.9677235969762439,329,Unchanged,100000,5
ynjF,329,823,1.3228048466863842,494,Unchanged,100000,5
ynjE,3862,2603,-0.5691728525465383,-1259,Unchanged,100000,5
ynjD,428,825,0.9467833227320311,397,Unchanged,100000,5
ynjC,1098,2504,1.1893565079274198,1406,Unchanged,100000,5
ynjB,2106,2311,0.13401182344191415,205,Unchanged,100000,5
ynjA,767,900,0.23069842371410365,133,Unchanged,100000,5
ydjZ,1499,1177,-0.3488860629094155,-322,Unchanged,100000,5
ydjY,2364,1050,-1.1708407076240475,-1314,Unchanged,100000,5
ydjX,1211,919,-0.39806209840529433,-292,Unchanged,100000,5
xthA,1677,1280,-0.38973887867698387,-397,Unchanged,100000,5
astC,47,2311,5.619712692789993,2264,Unchanged,100000,5
astA,31,1997,6.009422307057098,1966,Unchanged,100000,5
astD,104,2929,4.815752759738275,2825,Unchanged,100000,5
astB,112,2427,4.43760347109353,2315,Unchanged,100000,5
astE,34,1527,5.489021505546512,1493,Unchanged,100000,5
spy,1578,1880,0.25263545655154107,302,Unchanged,100000,5
ves,45,807,4.1645717669481055,762,Unchanged,100000,5
cho,1004,1495,0.5743862151346953,491,Unchanged,100000,5
nadE,6223,2659,-1.2267264690297064,-3564,Unchanged,100000,5
osmE,9861,1027,-3.2632977754832715,-8834,Unchanged,100000,5
chbB,57,168,1.5594274086140185,111,Unchanged,100000,5
chbC,67,1759,4.714450577014189,1692,Unchanged,100000,5
chbA,79,378,2.2584616760439697,299,Unchanged,100000,5
chbR,236,738,1.6448339566985548,502,Unchanged,100000,5
chbF,158,1477,3.224673362587686,1319,Unchanged,100000,5
chbG,370,1035,1.4840335918703755,665,Unchanged,100000,5
katE,10012,3934,-1.3476613334098018,-6078,Unchanged,100000,5
cedA,98,192,0.970252656605948,94,Unchanged,100000,5
ydjO,10,181,4.177917792195843,171,Unchanged,100000,5
tcyP,1608,4421,1.4591053277751376,2813,Unchanged,100000,5
ydjM,149,714,2.260611743566938,565,Unchanged,100000,5
hxpB,873,995,0.18871487180157107,122,Unchanged,100000,5
yniB,1201,781,-0.6208416975636547,-420,Unchanged,100000,5
yniA,3329,2044,-0.7036936742026417,-1285,Unchanged,100000,5
ydiZ,485,236,-1.0391978877126489,-249,Unchanged,100000,5
pfkB,5287,3339,-0.6630332333178263,-1948,Unchanged,100000,5
ydiY,68,803,3.561793336266975,735,Unchanged,100000,5
thrS,43564,13497,-1.6904976541053067,-30067,Unchanged,100000,5
infC,37449,8442,-2.1492704605293826,-29007,Unchanged,100000,5
rpmI,4477,1441,-1.6354619827287968,-3036,Unchanged,100000,5
rplT,29138,6390,-2.1890140195284826,-22748,Unchanged,100000,5
pheM,1,1,0.0,0,Unchanged,100000,5
pheS,4551,2685,-0.7612614980954147,-1866,Unchanged,100000,5
pheT,14837,8307,-0.8367999529957835,-6530,Unchanged,100000,5
ihfA,4496,856,-2.392959333819779,-3640,Unchanged,100000,5
btuC,858,1462,0.7688937584528917,604,Unchanged,100000,5
btuE,1235,640,-0.9483672315846776,-595,Unchanged,100000,5
btuD,992,1084,0.1279527309669964,92,Unchanged,100000,5
nlpC,1156,574,-1.010018755824991,-582,Unchanged,100000,5
rflP,650,520,-0.3219280948873623,-130,Unchanged,100000,5
ydiU,550,2041,1.8917726586206973,1491,Unchanged,100000,5
ydiE,1,74,6.20945336562895,73,Unchanged,100000,5
aroH,2082,1991,-0.0644768475789144,-91,Unchanged,100000,5
ppsR,933,1058,0.18139064126226692,125,Unchanged,100000,5
ppsA,2893,4128,0.5128766474936545,1235,Unchanged,100000,5
fadK,113,1821,4.010336244561651,1708,Unchanged,100000,5
ydiT,12,102,3.0874628412503395,90,Unchanged,100000,5
ydiS,118,1558,3.722836468699828,1440,Unchanged,100000,5
ydiR,136,1197,3.1377445956931624,1061,Unchanged,100000,5
ydiQ,54,838,3.955918931535883,784,Unchanged,100000,5
ydiP,448,659,0.5567797329504476,211,Unchanged,100000,5
ydiO,62,1285,4.373356333694366,1223,Unchanged,100000,5
ydiF,35,1628,5.53960196732128,1593,Unchanged,100000,5
aroD,969,1127,0.21791894475713997,158,Unchanged,100000,5
ydiB,46,788,4.098489863399363,742,Unchanged,100000,5
ydiN,33,1220,5.208271313091795,1187,Unchanged,100000,5
ydiM,17,982,5.852116373064353,965,Unchanged,100000,5
ydiL,13,279,4.423681593688095,266,Unchanged,100000,5
ydiK,2717,2239,-0.2791600373693775,-478,Unchanged,100000,5
ydiJ,20150,10845,-0.8937497857430559,-9305,Unchanged,100000,5
menI,1683,865,-0.960263138805862,-818,Unchanged,100000,5
ydiH,1107,400,-1.4685833170068274,-707,Unchanged,100000,5
sufA,250,384,0.6191782160590692,134,Unchanged,100000,5
sufB,1808,2407,0.4128414640593092,599,Unchanged,100000,5
sufC,839,953,0.18380540347011853,114,Unchanged,100000,5
sufD,1622,1911,0.23655395876018365,289,Unchanged,100000,5
sufS,1259,1702,0.4349527539669462,443,Unchanged,100000,5
sufE,296,350,0.24175774620337906,54,Unchanged,100000,5
ldtE,3764,1416,-1.4104453626455393,-2348,Unchanged,100000,5
lpp,50412,2420,-4.380688239045717,-47992,Unchanged,100000,5
pykF,35641,6452,-2.465719472344591,-29189,Unchanged,100000,5
fumD,568,150,-1.9209284290088013,-418,Unchanged,100000,5
ydhY,1114,502,-1.1499899633892599,-612,Unchanged,100000,5
ydhV,3625,2378,-0.6082322800440033,-1247,Unchanged,100000,5
ydhW,684,751,0.1348165826283738,67,Unchanged,100000,5
ydhX,496,720,0.5376567859427995,224,Unchanged,100000,5
ydhU,539,787,0.5460783627549809,248,Unchanged,100000,5
ydhT,346,1073,1.6328061331197974,727,Unchanged,100000,5
ydhS,1414,1831,0.37284967098793814,417,Unchanged,100000,5
ydhR,3473,845,-2.039159164212545,-2628,Unchanged,100000,5
ydhQ,7311,2816,-1.3764214178071996,-4495,Unchanged,100000,5
mdtK,1116,2488,1.1566494583014149,1372,Unchanged,100000,5
ribC,4026,1281,-1.6520766965796931,-2745,Unchanged,100000,5
cfa,31218,7370,-2.0826415887154166,-23848,Unchanged,100000,5
ydhC,342,1701,2.314314910777487,1359,Unchanged,100000,5
ydhB,575,1302,1.179095587333898,727,Unchanged,100000,5
purR,3336,1999,-0.7388408167000359,-1337,Unchanged,100000,5
ydhP,328,1712,2.383914981783063,1384,Unchanged,100000,5
sodB,19516,8797,-1.1495738712222052,-10719,Unchanged,100000,5
mepH,795,937,0.23709418748746908,142,Unchanged,100000,5
grxD,2100,614,-1.7740787671833054,-1486,Unchanged,100000,5
lhr,3450,10768,1.6420820480574232,7318,Unchanged,100000,5
rnt,733,1343,0.8735742012936304,610,Unchanged,100000,5
gloA,2760,1116,-1.3063312398363438,-1644,Unchanged,100000,5
nemA,1073,1992,0.8925675713115591,919,Unchanged,100000,5
nemR,260,775,1.5756846871331454,515,Unchanged,100000,5
ydhL,172,224,0.38109016735550627,52,Unchanged,100000,5
ydhF,1465,1609,0.135263661413836,144,Unchanged,100000,5
sodC,1438,758,-0.923793922268206,-680,Unchanged,100000,5
ydhK,254,2985,3.5548305293800015,2731,Unchanged,100000,5
ydhJ,151,984,2.704109766014161,833,Unchanged,100000,5
ydhI,59,160,1.439285045525521,101,Unchanged,100000,5
slyA,3696,895,-2.046005169264439,-2801,Unchanged,100000,5
slyB,15455,5913,-1.3861114719809438,-9542,Unchanged,100000,5
anmK,1482,1821,0.2971854746710044,339,Unchanged,100000,5
mliC,375,250,-0.5849625007211563,-125,Unchanged,100000,5
pdxH,3123,1131,-1.4653336400307528,-1992,Unchanged,100000,5
tyrS,12363,4420,-1.4839105947228617,-7943,Unchanged,100000,5
pdxY,2549,1275,-0.9994341262759816,-1274,Unchanged,100000,5
gstA,4497,1407,-1.676340555432483,-3090,Unchanged,100000,5
dtpA,22029,2339,-3.2354402390036,-19690,Unchanged,100000,5
nth,208,562,1.433986602079834,354,Unchanged,100000,5
rsxE,257,834,1.6982790242507855,577,Unchanged,100000,5
rsxG,225,714,1.6659990728120626,489,Unchanged,100000,5
rsxD,396,1312,1.728195384538474,916,Unchanged,100000,5
rsxC,1148,3059,1.4139374648825147,1911,Unchanged,100000,5
rsxB,313,709,1.1796229703068979,396,Unchanged,100000,5
rsxA,399,709,0.8293968810171704,310,Unchanged,100000,5
ydgK,557,513,-0.1187185017329777,-44,Unchanged,100000,5
cnu,105,66,-0.6698513983076693,-39,Unchanged,100000,5
ydgJ,2365,1709,-0.4686877865506181,-656,Unchanged,100000,5
add,2223,1743,-0.35093537890130505,-480,Unchanged,100000,5
malY,1567,1316,-0.25184569073733876,-251,Unchanged,100000,5
malX,318,1971,2.6318291057591305,1653,Unchanged,100000,5
malI,281,1324,2.2362610865862917,1043,Unchanged,100000,5
hdhA,7599,1287,-2.5617975242129556,-6312,Unchanged,100000,5
uidR,854,705,-0.27661281233433443,-149,Unchanged,100000,5
uidA,84,2028,4.59352451422458,1944,Unchanged,100000,5
uidB,26,1201,5.529580717564542,1175,Unchanged,100000,5
uidC,24,903,5.233619676759702,879,Unchanged,100000,5
ydgA,7832,2741,-1.51467843677792,-5091,Unchanged,100000,5
manA,6596,2470,-1.4170803569654271,-4126,Unchanged,100000,5
fumA,1055,1934,0.8743447958822937,879,Unchanged,100000,5
fumC,435,1574,1.8553482347713957,1139,Unchanged,100000,5
tus,407,953,1.2274474196436949,546,Unchanged,100000,5
rstB,1227,1378,0.16744063904138629,151,Unchanged,100000,5
rstA,1658,1034,-0.6812078211808157,-624,Unchanged,100000,5
ydgC,82,176,1.1018796140192137,94,Unchanged,100000,5
folM,333,554,0.7343637989779263,221,Unchanged,100000,5
ydgI,437,1565,1.8404574723193823,1128,Unchanged,100000,5
ydgH,4232,1815,-1.2213700792309126,-2417,Unchanged,100000,5
pntA,20019,7852,-1.3502378317680022,-12167,Unchanged,100000,5
pntB,18260,6722,-1.4417243175635825,-11538,Unchanged,100000,5
tqsA,398,1120,1.4926583964013178,722,Unchanged,100000,5
mdtJ,32,278,3.1189410727235076,246,Unchanged,100000,5
mdtI,18,183,3.34577483684173,165,Unchanged,100000,5
ydgD,569,738,0.3751921637538141,169,Unchanged,100000,5
asr,77,145,0.9131225493200331,68,Unchanged,100000,5
ynfM,783,1435,0.8739665242720095,652,Unchanged,100000,5
ynfL,308,1055,1.776240742899646,747,Unchanged,100000,5
mlc,2569,2592,0.012858827983807924,23,Unchanged,100000,5
ynfK,4051,2020,-1.0039227920472795,-2031,Unchanged,100000,5
clcB,272,1077,1.985339693293868,805,Unchanged,100000,5
dmsD,1985,595,-1.7381774338350142,-1390,Unchanged,100000,5
ynfH,6173,964,-2.6788667397930284,-5209,Unchanged,100000,5
ynfG,2804,429,-2.708436796511078,-2375,Unchanged,100000,5
ynfF,19327,2400,-3.0095114041497926,-16927,Unchanged,100000,5
ynfE,6240,2094,-1.5752845868188023,-4146,Unchanged,100000,5
ynfD,417,167,-1.3201992809706113,-250,Unchanged,100000,5
ynfC,511,625,0.2905328986118282,114,Unchanged,100000,5
speG,2243,577,-1.9587863964407897,-1666,Unchanged,100000,5
ynfB,1402,389,-1.8496442890244311,-1013,Unchanged,100000,5
ynfA,174,244,0.487793841714158,70,Unchanged,100000,5
rspA,134,1014,2.919752746545568,880,Unchanged,100000,5
rspB,87,709,3.026698321390788,622,Unchanged,100000,5
intQ,67,604,3.1723155488673065,537,Unchanged,100000,5
insD7,6,1627,8.083036034951371,1621,Unchanged,100000,5
ydfE,36,584,4.0198995574377046,548,Unchanged,100000,5
ydfD,1,23,4.523561956057013,22,Unchanged,100000,5
dicB,2,4,1.0,2,Unchanged,100000,5
dicF,1,1,0.0,0,Unchanged,100000,5
ydfC,5,56,3.4854268271702415,51,Unchanged,100000,5
ydfB,1,7,2.807354922057604,6,Unchanged,100000,5
ydfA,3,13,2.1154772174199357,10,Unchanged,100000,5
dicA,1209,278,-2.120657456525616,-931,Unchanged,100000,5
dicC,5,42,3.070389327891398,37,Unchanged,100000,5
ydfX,8,104,3.700439718141092,96,Unchanged,100000,5
ydfW,4,18,2.169925001442312,14,Unchanged,100000,5
flxA,112,141,0.3321964303411894,29,Unchanged,100000,5
ydfV,9,99,3.4594316186372973,90,Unchanged,100000,5
relB,516,287,-0.8463203287475664,-229,Unchanged,100000,5
relE,685,437,-0.6484707083472907,-248,Unchanged,100000,5
hokD,39,29,-0.42742122373467617,-10,Unchanged,100000,5
rem,29,98,1.756728848987636,69,Unchanged,100000,5
ydfU,26,876,5.074347341460081,850,Unchanged,100000,5
ydfT,65,486,2.9024446905773265,421,Unchanged,100000,5
cspF,17,66,1.956931278108114,49,Unchanged,100000,5
cspB,10,26,1.3785116232537298,16,Unchanged,100000,5
essQ,1,29,4.857980995127572,28,Unchanged,100000,5
ydfR,10,105,3.3923174227787602,95,Unchanged,100000,5
rrrQ,11,372,5.079727192470735,361,Unchanged,100000,5
rzpQ,14,292,4.382469636822413,278,Unchanged,100000,5
cspI,3,22,2.8744691179161412,19,Unchanged,100000,5
ynfN,1,10,3.321928094887362,9,Unchanged,100000,5
gnsB,61,6,-3.34577483684173,-55,Unchanged,100000,5
ydfO,32,10,-1.6780719051126376,-22,Unchanged,100000,5
nohA,28,429,3.9374789154419414,401,Unchanged,100000,5
stfQ,28,677,4.595657101517393,649,Unchanged,100000,5
tfaQ,19,372,4.291231297664446,353,Unchanged,100000,5
pinQ,37,337,3.1871514155529086,300,Unchanged,100000,5
ydfK,9,10,0.15200309344505006,1,Unchanged,100000,5
ydfI,132,1074,3.024384158626959,942,Unchanged,100000,5
ydfZ,11569,474,-4.609233296964281,-11095,Unchanged,100000,5
ydfH,1623,1352,-0.26356784826578716,-271,Unchanged,100000,5
ydfG,6165,2726,-1.1773153324849919,-3439,Unchanged,100000,5
dcp,6944,3189,-1.1226628501922185,-3755,Unchanged,100000,5
ydeJ,316,316,0.0,0,Unchanged,100000,5
ydeI,995,248,-2.004356405044136,-747,Unchanged,100000,5
dgcZ,1305,637,-1.0346845292009466,-668,Unchanged,100000,5
ydeE,258,884,1.7766753039681773,626,Unchanged,100000,5
eamA,480,823,0.7778580248131072,343,Unchanged,100000,5
marB,117,47,-1.3157758679057672,-70,Unchanged,100000,5
marA,345,273,-0.337695410745679,-72,Unchanged,100000,5
marR,345,380,0.13940305666541644,35,Unchanged,100000,5
marC,628,766,0.2865798330333302,138,Unchanged,100000,5
ydeA,837,1149,0.4570792700957695,312,Unchanged,100000,5
yneK,41,390,3.249778309131527,349,Unchanged,100000,5
yneJ,493,967,0.9719282430989297,474,Unchanged,100000,5
sad,844,1877,1.153113746123689,1033,Unchanged,100000,5
glsB,823,1337,0.7000351296717271,514,Unchanged,100000,5
yneG,117,276,1.2381597371947646,159,Unchanged,100000,5
dgcF,216,788,1.8671643172929078,572,Unchanged,100000,5
uxaB,245,1471,2.5859435922522596,1226,Unchanged,100000,5
yneE,302,639,1.0812673816219154,337,Unchanged,100000,5
tam,685,640,-0.09803208296052676,-45,Unchanged,100000,5
lsrG,37,132,1.8349407537295037,95,Unchanged,100000,5
lsrF,253,728,1.524801065504386,475,Unchanged,100000,5
lsrB,137,781,2.5111466551814527,644,Unchanged,100000,5
lsrD,104,785,2.916109125637897,681,Unchanged,100000,5
lsrC,109,969,3.152168530638155,860,Unchanged,100000,5
lsrA,213,1472,2.7888523358311748,1259,Unchanged,100000,5
lsrR,384,799,1.0570891922068204,415,Unchanged,100000,5
lsrK,456,1455,1.6739134236309046,999,Unchanged,100000,5
hipB,69,125,0.8572598278839181,56,Unchanged,100000,5
hipA,877,1411,0.686069240152531,534,Unchanged,100000,5
yneL,4,35,3.1292830169449664,31,Unchanged,100000,5
ydeT,116,866,2.9002422195991526,750,Unchanged,100000,5
ydeS,20,314,3.9726926540042644,294,Unchanged,100000,5
ydeR,21,273,3.700439718141092,252,Unchanged,100000,5
ydeQ,29,471,4.021602254485211,442,Unchanged,100000,5
ydeP,375,2104,2.488172203909059,1729,Unchanged,100000,5
safA,2,8,2.0,6,Unchanged,100000,5
ydeO,19,215,3.500265336145875,196,Unchanged,100000,5
ydeN,521,983,0.9159080440620724,462,Unchanged,100000,5
ydeM,76,431,2.503616545645513,355,Unchanged,100000,5
yddA,15,920,5.938599455335857,905,Unchanged,100000,5
yddB,139,1547,3.4763164087255283,1408,Unchanged,100000,5
pqqL,310,2170,2.807354922057604,1860,Unchanged,100000,5
gadB,196014,1537,-6.994695725052132,-194477,Downregulated,100000,5
gadC,146286,1329,-6.782306791089309,-144957,Downregulated,100000,5
digH,2243,1294,-0.7935920030937648,-949,Unchanged,100000,5
dosC,125,902,2.851199338593294,777,Unchanged,100000,5
dosP,196,2354,3.586188760923236,2158,Unchanged,100000,5
ddpX,9,439,5.608152128093046,430,Unchanged,100000,5
ddpA,124,1410,3.5072831368992805,1286,Unchanged,100000,5
ddpB,49,965,4.299675288040234,916,Unchanged,100000,5
ddpC,104,842,3.017236704925304,738,Unchanged,100000,5
ddpD,130,1089,3.0664204256884524,959,Unchanged,100000,5
ddpF,117,907,2.954594020945118,790,Unchanged,100000,5
osmC,15380,3259,-2.238554246110625,-12121,Unchanged,100000,5
bdm,228,119,-0.9380722508567982,-109,Unchanged,100000,5
sra,384,41,-3.2274104961030727,-343,Unchanged,100000,5
maeA,13004,5143,-1.3382734023378988,-7861,Unchanged,100000,5
adhP,787,1269,0.6892565283336195,482,Unchanged,100000,5
yddM,248,319,0.36321630337799427,71,Unchanged,100000,5
fdnI,220,621,1.4970897446958218,401,Unchanged,100000,5
fdnH,172,1049,2.6085342078751697,877,Unchanged,100000,5
fdnG,992,4205,2.0836937747556314,3213,Unchanged,100000,5
yddG,606,731,0.27055361247948656,125,Unchanged,100000,5
yddL,1,73,6.189824558880018,72,Unchanged,100000,5
yddK,2,67,5.066089190457772,65,Unchanged,100000,5
yddJ,2,38,4.247927513443585,36,Unchanged,100000,5
narU,284,1498,2.399074788954069,1214,Unchanged,100000,5
narZ,1449,5706,1.9774221520247903,4257,Unchanged,100000,5
narY,439,1852,2.076791253724878,1413,Unchanged,100000,5
narW,162,869,2.4233623639297757,707,Unchanged,100000,5
narV,184,848,2.204358498506186,664,Unchanged,100000,5
yddE,1129,1750,0.6323094359466903,621,Unchanged,100000,5
nhoA,87,1204,3.7906761809109737,1117,Unchanged,100000,5
yddH,151,650,2.105891168590738,499,Unchanged,100000,5
pptA,161,72,-1.1609918766723046,-89,Unchanged,100000,5
ydcC,27,882,5.029747343394052,855,Unchanged,100000,5
yncI,103,489,2.247190127769015,386,Unchanged,100000,5
ydcD,47,26,-0.8541491335365452,-21,Unchanged,100000,5
rhsE,164,2170,3.725927322713758,2006,Unchanged,100000,5
yncH,3,2,-0.5849625007211563,-1,Unchanged,100000,5
yncG,247,715,1.533432200081074,468,Unchanged,100000,5
ansP,470,2201,2.2274264833265573,1731,Unchanged,100000,5
yncE,157,1340,3.093396536453508,1183,Unchanged,100000,5
yncD,225,2948,3.7117396178780324,2723,Unchanged,100000,5
mcbR,117,563,2.266626392496825,446,Unchanged,100000,5
curA,1107,1406,0.34494137229098315,299,Unchanged,100000,5
mnaT,1256,998,-0.3317247435543665,-258,Unchanged,100000,5
ydcZ,302,369,0.28907226673531705,67,Unchanged,100000,5
ydcY,1480,368,-2.0078195044592992,-1112,Unchanged,100000,5
ortT,8,23,1.5235619560570128,15,Unchanged,100000,5
patD,401,1851,2.2066307534156535,1450,Unchanged,100000,5
ydcV,59,867,3.877245133859994,808,Unchanged,100000,5
ydcU,128,1114,3.1215335173400316,986,Unchanged,100000,5
ydcT,105,1204,3.5193741590935796,1099,Unchanged,100000,5
ydcS,238,1403,2.5594815303119556,1165,Unchanged,100000,5
ydcR,829,1904,1.199589471812193,1075,Unchanged,100000,5
hicB,319,255,-0.32305917690601155,-64,Unchanged,100000,5
yncJ,27,107,1.9865794842376783,80,Unchanged,100000,5
rlhA,2155,2709,0.330072524225554,554,Unchanged,100000,5
sutR,158,492,1.638733757162137,334,Unchanged,100000,5
ydcO,113,1274,3.4949705998411127,1161,Unchanged,100000,5
insQ,2129,1555,-0.45326136943432904,-574,Unchanged,100000,5
ydcL,407,456,0.16400502989849455,49,Unchanged,100000,5
tehB,1310,581,-1.1729567430202839,-729,Unchanged,100000,5
tehA,539,1460,1.4376111910148741,921,Unchanged,100000,5
ydcK,465,938,1.0123572065199826,473,Unchanged,100000,5
rimL,682,610,-0.16096249657392386,-72,Unchanged,100000,5
ydcH,605,135,-2.163975735111126,-470,Unchanged,100000,5
opgD,2569,1982,-0.37424992771432875,-587,Unchanged,100000,5
ydcJ,377,1726,2.194796035910291,1349,Unchanged,100000,5
ydcI,125,943,2.9153296760130094,818,Unchanged,100000,5
trg,288,1891,2.715008646507449,1603,Unchanged,100000,5
mokB,21,28,0.41503749927884376,7,Unchanged,100000,5
ydcA,97,42,-1.2075954194083673,-55,Unchanged,100000,5
cybB,725,607,-0.25628447864661474,-118,Unchanged,100000,5
aldA,664,2236,1.7516650414962653,1572,Unchanged,100000,5
ydcF,3467,1345,-1.3660816637588469,-2122,Unchanged,100000,5
hrpA,5991,8892,0.5697111148618612,2901,Unchanged,100000,5
azoR,730,684,-0.09390013888148166,-46,Unchanged,100000,5
ynbD,320,1442,2.17192735435346,1122,Unchanged,100000,5
ynbC,313,2018,2.6886916121737388,1705,Unchanged,100000,5
ynbB,10,790,6.303780748177103,780,Unchanged,100000,5
ynbA,9,490,5.766712937560258,481,Unchanged,100000,5
ydbD,127,1902,3.9046168440883977,1775,Unchanged,100000,5
pdxI,624,1354,1.1176098047127483,730,Unchanged,100000,5
insI2,24,14,-0.777607578663552,-10,Unchanged,100000,5
insC2,441,166,-1.4095954142105958,-275,Unchanged,100000,5
insD2,189,1633,3.1110666513406224,1444,Unchanged,100000,5
paaY,519,990,0.9316939866090912,471,Unchanged,100000,5
paaX,1037,1845,0.8312049221345328,808,Unchanged,100000,5
paaK,236,2047,3.116652337661569,1811,Unchanged,100000,5
paaJ,211,2121,3.3294297168233697,1910,Unchanged,100000,5
paaI,44,434,3.302119613807182,390,Unchanged,100000,5
paaH,179,2266,3.6621163685562594,2087,Unchanged,100000,5
paaG,39,1114,4.836131298477784,1075,Unchanged,100000,5
paaF,43,1170,4.766028059768669,1127,Unchanged,100000,5
paaE,92,1689,4.198391656744373,1597,Unchanged,100000,5
paaD,23,592,4.685891409571937,569,Unchanged,100000,5
paaC,12,1118,6.541741972122034,1106,Unchanged,100000,5
paaB,4,325,6.344295907915817,321,Unchanged,100000,5
paaA,8,1296,7.339850002884624,1288,Unchanged,100000,5
paaZ,61,3063,5.649992314036071,3002,Unchanged,100000,5
tynA,272,3119,3.5194049961238125,2847,Unchanged,100000,5
feaB,433,2687,2.633557391286441,2254,Unchanged,100000,5
feaR,78,1040,3.736965594166206,962,Unchanged,100000,5
ydbL,94,278,1.5643522210458702,184,Unchanged,100000,5
ynbE,8,31,1.9541963103868751,23,Unchanged,100000,5
ydbH,2187,4757,1.1210988049143613,2570,Unchanged,100000,5
ldhA,1,3,1.584962500721156,2,Unchanged,100000,5
hslJ,1511,696,-1.1183444493161008,-815,Unchanged,100000,5
ydbK,6758,7839,0.21407327487737546,1081,Unchanged,100000,5
ompN,37,1344,5.182864057149811,1307,Unchanged,100000,5
uspF,2875,736,-1.965784284662087,-2139,Unchanged,100000,5
ynaE,13,22,0.7589919004962051,9,Unchanged,100000,5
pinR,38,636,4.06495544184077,598,Unchanged,100000,5
tfaR,85,855,3.3303896736355583,770,Unchanged,100000,5
stfR,294,6096,4.373974842656958,5802,Unchanged,100000,5
insH5,215,367,0.7714434032537526,152,Unchanged,100000,5
ynaA,158,1057,2.74197891320558,899,Unchanged,100000,5
ydaY,19,410,4.43155258606186,391,Unchanged,100000,5
ynaK,15,181,3.592955291474687,166,Unchanged,100000,5
trkG,593,823,0.4728603258756221,230,Unchanged,100000,5
rzpR,17,452,4.732716121164849,435,Unchanged,100000,5
ydaW,51,575,3.4949928038602422,524,Unchanged,100000,5
ydaV,38,1217,5.001185939270143,1179,Unchanged,100000,5
ydaU,53,882,4.056714390994321,829,Unchanged,100000,5
ydaT,21,424,4.335603031784439,403,Unchanged,100000,5
ydaS,12,111,3.2094533656289497,99,Unchanged,100000,5
racR,1145,466,-1.296945738330026,-679,Unchanged,100000,5
ydaG,1,6,2.584962500721156,5,Unchanged,100000,5
sieB,124,171,0.4636562044990228,47,Unchanged,100000,5
kilR,1,27,4.754887502163468,26,Unchanged,100000,5
racC,2,70,5.129283016944966,68,Unchanged,100000,5
recE,127,3621,4.833487774704012,3494,Unchanged,100000,5
recT,147,841,2.5162896454187798,694,Unchanged,100000,5
ralR,2,28,3.807354922057604,26,Unchanged,100000,5
rcbA,3,15,2.321928094887362,12,Unchanged,100000,5
xisR,1,45,5.491853096329675,44,Unchanged,100000,5
intR,85,1006,3.5650236536678253,921,Unchanged,100000,5
ttcA,1511,1296,-0.2214379422802043,-215,Unchanged,100000,5
dbpA,1226,1940,0.6620976733837085,714,Unchanged,100000,5
zntB,1530,1780,0.2183455882737461,250,Unchanged,100000,5
dgcM,564,1238,1.134244246815471,674,Unchanged,100000,5
smrA,916,943,0.041910172578152605,27,Unchanged,100000,5
abgR,190,914,2.266194746727122,724,Unchanged,100000,5
abgA,55,1664,4.919080004616433,1609,Unchanged,100000,5
abgB,104,1982,4.252301529045396,1878,Unchanged,100000,5
abgT,116,1859,4.002330059791909,1743,Unchanged,100000,5
ogt,310,656,1.0814275993438462,346,Unchanged,100000,5
fnr,5164,3184,-0.6976486647635418,-1980,Unchanged,100000,5
uspE,9296,3253,-1.5148392463633968,-6043,Unchanged,100000,5
ynaJ,463,205,-1.1753882837547904,-258,Unchanged,100000,5
insH4,2431,3950,0.7003027599230988,1519,Unchanged,100000,5
ynaI,2268,1205,-0.9123874938249048,-1063,Unchanged,100000,5
mppA,1034,2278,1.1395315613931771,1244,Unchanged,100000,5
pgrR,531,962,0.8573250329658884,431,Unchanged,100000,5
ycjY,243,995,2.03374021182523,752,Unchanged,100000,5
mpaA,1099,1275,0.2143058607969892,176,Unchanged,100000,5
ycjG,965,1995,1.0477878989542653,1030,Unchanged,100000,5
tpx,5110,3004,-0.7664384783107119,-2106,Unchanged,100000,5
tyrR,3765,4109,0.1261374656083659,344,Unchanged,100000,5
ycjF,1053,2524,1.261206473956832,1471,Unchanged,100000,5
ycjX,1446,2784,0.9450916588976105,1338,Unchanged,100000,5
ycjW,963,1342,0.47877696835672423,379,Unchanged,100000,5
ompG,27,1412,5.708636871107712,1385,Unchanged,100000,5
ycjU,4,1343,8.391243589427443,1339,Unchanged,100000,5
ycjT,176,5304,4.9134334414752905,5128,Unchanged,100000,5
ycjS,120,2054,4.097329870709677,1934,Unchanged,100000,5
ycjR,60,973,4.019405399172593,913,Unchanged,100000,5
ycjQ,103,2082,4.337253826116199,1979,Unchanged,100000,5
ycjP,47,1764,5.230045993879883,1717,Unchanged,100000,5
ycjO,38,1420,5.223747700948459,1382,Unchanged,100000,5
ycjN,58,2498,5.4285767664803855,2440,Unchanged,100000,5
ycjM,92,2275,4.6280888739164086,2183,Unchanged,100000,5
pspE,2218,2399,0.11317379213172468,181,Unchanged,100000,5
pspD,430,785,0.868355994189529,355,Unchanged,100000,5
pspC,2288,2807,0.29494201173413503,519,Unchanged,100000,5
pspB,792,867,0.13053156314222542,75,Unchanged,100000,5
pspA,15001,18263,0.2838650941409044,3262,Unchanged,100000,5
pspF,596,2843,2.254029863215366,2247,Unchanged,100000,5
puuE,93,3444,5.210710616288813,3351,Unchanged,100000,5
puuB,76,2784,5.195015982405143,2708,Unchanged,100000,5
puuC,171,3570,4.383855844030564,3399,Unchanged,100000,5
puuR,311,849,1.448849973422436,538,Unchanged,100000,5
puuD,89,1508,4.082687282302267,1419,Unchanged,100000,5
puuA,149,2326,3.964466861011057,2177,Unchanged,100000,5
puuP,70,2208,4.979241439833203,2138,Unchanged,100000,5
ymjA,251,188,-0.41695470227313464,-63,Unchanged,100000,5
sapA,2278,3838,0.7525869644872685,1560,Unchanged,100000,5
sapB,839,1898,1.177737276581286,1059,Unchanged,100000,5
sapC,546,1818,1.7353793432742548,1272,Unchanged,100000,5
sapD,1390,2021,0.5399844387688656,631,Unchanged,100000,5
sapF,661,1193,0.8518718661875364,532,Unchanged,100000,5
ycjD,76,363,2.255898224552165,287,Unchanged,100000,5
fabI,17639,4454,-1.9855953099056673,-13185,Unchanged,100000,5
yciW,207,2074,3.3247132213139006,1867,Unchanged,100000,5
rnb,12315,5798,-1.0867893893249263,-6517,Unchanged,100000,5
pdeR,1106,2600,1.23316023768111,1494,Unchanged,100000,5
yciT,1665,1086,-0.6164980741542629,-579,Unchanged,100000,5
osmB,2245,259,-3.1156914419419555,-1986,Unchanged,100000,5
yciH,444,235,-0.9178989197851062,-209,Unchanged,100000,5
pyrF,3520,1514,-1.217210223538928,-2006,Unchanged,100000,5
lapB,2581,3383,0.3903730357000183,802,Unchanged,100000,5
lapA,1009,617,-0.7095837799569394,-392,Unchanged,100000,5
pgpB,770,1196,0.6352870386158413,426,Unchanged,100000,5
ribA,1494,1027,-0.5407439664710421,-467,Unchanged,100000,5
acnA,3775,7988,1.081357688344169,4213,Unchanged,100000,5
cysB,1645,1663,0.01570058466466533,18,Unchanged,100000,5
topA,17377,7770,-1.1611925301497397,-9607,Unchanged,100000,5
yciN,702,230,-1.6098371693601854,-472,Unchanged,100000,5
sohB,3009,2016,-0.5777884678334203,-993,Unchanged,100000,5
yciK,1581,1162,-0.44422729895384194,-419,Unchanged,100000,5
btuR,759,692,-0.13332784777874168,-67,Unchanged,100000,5
rluB,1853,1966,0.08540044031331483,113,Unchanged,100000,5
yciQ,402,2066,2.361572847686131,1664,Unchanged,100000,5
yciO,1248,972,-0.36058971525646744,-276,Unchanged,100000,5
yciV,1408,1390,-0.01856245102642752,-18,Unchanged,100000,5
trpL,1,1,0.0,0,Unchanged,100000,5
trpE,447,3005,2.74901825441523,2558,Unchanged,100000,5
trpD,486,2912,2.5829821365929155,2426,Unchanged,100000,5
trpC,695,2552,1.8765434461539996,1857,Unchanged,100000,5
trpB,1220,2652,1.1201996276623392,1432,Unchanged,100000,5
trpA,961,1512,0.6538498034473221,551,Unchanged,100000,5
yciG,49,48,-0.029747343394052068,-1,Unchanged,100000,5
yciF,394,377,-0.06363110618771194,-17,Unchanged,100000,5
yciE,421,242,-0.7988131857918015,-179,Unchanged,100000,5
ompW,148,832,2.4909863525121425,684,Unchanged,100000,5
yciC,1653,1078,-0.6167295465398084,-575,Unchanged,100000,5
yciB,1086,695,-0.6439392201934918,-391,Unchanged,100000,5
yciA,606,359,-0.7553339496498995,-247,Unchanged,100000,5
tonB,291,1147,1.9787743331075411,856,Unchanged,100000,5
yciI,2138,267,-3.001350206032937,-1871,Unchanged,100000,5
kch,1565,1134,-0.46474201687775174,-431,Unchanged,100000,5
clsA,2828,2905,0.038756043482492404,77,Unchanged,100000,5
yciU,565,324,-0.8022570544179252,-241,Unchanged,100000,5
oppF,19319,10416,-0.8912190649685247,-8903,Unchanged,100000,5
oppD,19341,11709,-0.724044520709988,-7632,Unchanged,100000,5
oppC,14520,9481,-0.614930314102267,-5039,Unchanged,100000,5
oppB,12135,8750,-0.47181918643144266,-3385,Unchanged,100000,5
oppA,137677,44347,-1.6343791492722417,-93330,Unchanged,100000,5
ychE,552,998,0.8543715485590915,446,Unchanged,100000,5
adhE,309420,108494,-1.5119511912780845,-200926,Downregulated,100000,5
tdk,659,403,-0.7094986264800844,-256,Unchanged,100000,5
hns,19492,1620,-3.5888164094203283,-17872,Unchanged,100000,5
galU,9254,2068,-2.161840913250361,-7186,Unchanged,100000,5
rssB,1397,1426,0.029641961034424947,29,Unchanged,100000,5
rssA,1569,1533,-0.03348765530932006,-36,Unchanged,100000,5
ychJ,1019,599,-0.7665261433770281,-420,Unchanged,100000,5
purU,5913,2151,-1.458882752341581,-3762,Unchanged,100000,5
tpr,1,3,1.584962500721156,2,Unchanged,100000,5
narI,4057,1259,-1.6881350194872562,-2798,Unchanged,100000,5
narJ,3377,1367,-1.3047289364014167,-2010,Unchanged,100000,5
narH,10284,3365,-1.6117231053359766,-6919,Unchanged,100000,5
narG,32374,9038,-1.840760167980422,-23336,Unchanged,100000,5
narK,2637,2262,-0.22129864187473972,-375,Unchanged,100000,5
narX,1510,2975,0.9783411188702269,1465,Unchanged,100000,5
narL,2927,1446,-1.0173551934576328,-1481,Unchanged,100000,5
ychO,668,2328,1.8011710504342318,1660,Unchanged,100000,5
ychN,1650,693,-1.2515387669959646,-957,Unchanged,100000,5
chaC,782,994,0.3460772442549339,212,Unchanged,100000,5
chaB,163,124,-0.39453184384420226,-39,Unchanged,100000,5
chaA,752,1871,1.3150049915631468,1119,Unchanged,100000,5
kdsA,5904,2643,-1.1595162964188261,-3261,Unchanged,100000,5
ychA,1692,1370,-0.3045536752720607,-322,Unchanged,100000,5
ychQ,97,337,1.796691938994731,240,Unchanged,100000,5
prmC,630,1378,1.1291521543170124,748,Unchanged,100000,5
prfA,1895,1827,-0.052721214430965446,-68,Unchanged,100000,5
hemA,3806,2947,-0.36902850115002167,-859,Unchanged,100000,5
lolB,2723,1389,-0.9711503830624035,-1334,Unchanged,100000,5
ispE,3312,1785,-0.8917785985828631,-1527,Unchanged,100000,5
prs,49915,6529,-2.9345394796826705,-43386,Unchanged,100000,5
dauA,3378,3270,-0.04687869241594091,-108,Unchanged,100000,5
ychH,1684,846,-0.9931625699464464,-838,Unchanged,100000,5
pth,1487,722,-1.0423339051652476,-765,Unchanged,100000,5
ychF,4157,2428,-0.7757743263686903,-1729,Unchanged,100000,5
ycgV,1025,3310,1.6912073073017717,2285,Unchanged,100000,5
dhaR,704,2359,1.7445280846021654,1655,Unchanged,100000,5
dhaK,9338,4852,-0.9445340381216788,-4486,Unchanged,100000,5
dhaL,4879,2234,-1.1269562974427123,-2645,Unchanged,100000,5
dhaM,10626,4924,-1.109695950988613,-5702,Unchanged,100000,5
treA,1261,2158,0.775126589159797,897,Unchanged,100000,5
ycgY,23,223,3.2773379438632917,200,Unchanged,100000,5
ymgE,116,156,0.4274212237346762,40,Unchanged,100000,5
ycgR,59,867,3.877245133859994,808,Unchanged,100000,5
emtA,1523,729,-1.0629252221603551,-794,Unchanged,100000,5
ldcA,1018,1445,0.505331931312346,427,Unchanged,100000,5
cvrA,1648,2647,0.6836419523121802,999,Unchanged,100000,5
dadX,727,1607,1.1443426597554995,880,Unchanged,100000,5
dadA,1547,2592,0.7445925214355891,1045,Unchanged,100000,5
ycgB,1043,1553,0.5743186718675356,510,Unchanged,100000,5
fadR,1069,995,-0.10349342228947936,-74,Unchanged,100000,5
nhaB,2823,2726,-0.05044356664448337,-97,Unchanged,100000,5
dsbB,1210,749,-0.6919694237032059,-461,Unchanged,100000,5
umuC,330,1658,2.328906077249935,1328,Unchanged,100000,5
umuD,259,292,0.1730162711934633,33,Unchanged,100000,5
hlyE,500,536,0.10030490579568548,36,Unchanged,100000,5
ycgN,568,458,-0.31054333140773804,-110,Unchanged,100000,5
ycgM,1868,841,-1.1513167494545176,-1027,Unchanged,100000,5
ycgL,1140,307,-1.8927232636819247,-833,Unchanged,100000,5
pliG,753,330,-1.1901838404261125,-423,Unchanged,100000,5
ycgJ,283,188,-0.5900693911542451,-95,Unchanged,100000,5
minC,5471,1875,-1.5449139601119741,-3596,Unchanged,100000,5
minD,10017,2326,-2.1065274973110535,-7691,Unchanged,100000,5
minE,1105,154,-2.8430441135838924,-951,Unchanged,100000,5
ymgG,2792,521,-2.421943663931144,-2271,Unchanged,100000,5
ymgD,4200,527,-2.9945144609162706,-3673,Unchanged,100000,5
pdeG,39,1012,4.697591355832062,973,Unchanged,100000,5
ymgC,1,16,4.0,15,Unchanged,100000,5
ariR,4,20,2.321928094887362,16,Unchanged,100000,5
ymgA,14,70,2.321928094887362,56,Unchanged,100000,5
ycgZ,12,93,2.9541963103868754,81,Unchanged,100000,5
bluF,89,724,3.0241124561168076,635,Unchanged,100000,5
bluR,790,774,-0.029519086920054966,-16,Unchanged,100000,5
ycgX,43,95,1.14359085362885,52,Unchanged,100000,5
iraM,20,12,-0.7369655941662062,-8,Unchanged,100000,5
mcrA,310,312,0.00927781358801065,2,Unchanged,100000,5
pinE,11,477,5.4384138373682145,466,Unchanged,100000,5
stfE,6,238,5.309855262586788,232,Unchanged,100000,5
tfaE,22,367,4.060204634205916,345,Unchanged,100000,5
tfaP,20,100,2.321928094887362,80,Unchanged,100000,5
ycfK,16,424,4.727920454563199,408,Unchanged,100000,5
ymfQ,13,575,5.466978427690646,562,Unchanged,100000,5
jayE,48,667,3.796580450463429,619,Unchanged,100000,5
beeE,27,319,3.562525111601401,292,Unchanged,100000,5
ymfR,2,55,4.78135971352466,53,Unchanged,100000,5
ymfM,33,267,3.0163018123291008,234,Unchanged,100000,5
ymfL,69,438,2.666262602823004,369,Unchanged,100000,5
ymfT,10,37,1.8875252707415875,27,Unchanged,100000,5
ymfK,716,489,-0.5501251223120228,-227,Unchanged,100000,5
ymfJ,44,184,2.0641303374197157,140,Unchanged,100000,5
ymfI,474,126,-1.9114633253983428,-348,Unchanged,100000,5
xisE,23,91,1.9842326841416833,68,Unchanged,100000,5
intE,215,887,2.0445974447116035,672,Unchanged,100000,5
lit,1333,669,-0.9945986644475123,-664,Unchanged,100000,5
ymfE,310,184,-0.7525624492172248,-126,Unchanged,100000,5
ymfD,123,188,0.6120743463383976,65,Unchanged,100000,5
icd,15230,10430,-0.5461767839675266,-4800,Unchanged,100000,5
rluE,640,966,0.5939512839484107,326,Unchanged,100000,5
nudJ,504,685,0.44268025434797265,181,Unchanged,100000,5
mnmA,4975,3828,-0.37810569583234804,-1147,Unchanged,100000,5
hflD,1842,1528,-0.2696285180555868,-314,Unchanged,100000,5
purB,11656,5235,-1.1548113402463418,-6421,Unchanged,100000,5
phoP,4041,1957,-1.0460685955566553,-2084,Unchanged,100000,5
phoQ,3668,3544,-0.049615035040036094,-124,Unchanged,100000,5
roxA,5382,3228,-0.737501812362637,-2154,Unchanged,100000,5
pepT,7856,2870,-1.452744192751643,-4986,Unchanged,100000,5
potA,1398,2112,0.5952454739830171,714,Unchanged,100000,5
potB,497,1040,1.0652657714661684,543,Unchanged,100000,5
potC,524,981,0.9046863246817884,457,Unchanged,100000,5
potD,3991,2167,-0.8810511254175981,-1824,Unchanged,100000,5
ymfA,25,331,3.726831217032493,306,Unchanged,100000,5
ycfZ,16,513,5.002815015607054,497,Unchanged,100000,5
cobB,2059,1628,-0.3388431303660072,-431,Unchanged,100000,5
nagK,1770,1892,0.09616272836903554,122,Unchanged,100000,5
lolE,1665,2640,0.6650157522871913,975,Unchanged,100000,5
lolD,730,1559,1.0946525589304053,829,Unchanged,100000,5
lolC,932,2228,1.2573473726857516,1296,Unchanged,100000,5
ycfT,92,1180,3.6810091881921907,1088,Unchanged,100000,5
mfd,9569,9917,0.0515355907211584,348,Unchanged,100000,5
ldtC,113,1452,3.683646775580563,1339,Unchanged,100000,5
bhsA,272,1060,1.962385708200222,788,Unchanged,100000,5
comR,320,957,1.5804470195986633,637,Unchanged,100000,5
ycfJ,2616,1481,-0.8207909002092348,-1135,Unchanged,100000,5
ndh,344,2117,2.621540799305491,1773,Unchanged,100000,5
ycfP,4143,1870,-1.147637550204208,-2273,Unchanged,100000,5
nagZ,2421,2115,-0.19494541599162438,-306,Unchanged,100000,5
thiK,1191,1306,0.13298148368231688,115,Unchanged,100000,5
lpoB,6500,1840,-1.8207339518588042,-4660,Unchanged,100000,5
ycfL,3788,660,-2.5208984012225693,-3128,Unchanged,100000,5
hinT,2215,717,-1.6272616747404758,-1498,Unchanged,100000,5
fhuE,179,3044,4.087936866239289,2865,Unchanged,100000,5
ptsG,40519,13391,-1.5973348683281345,-27128,Unchanged,100000,5
ycfH,1022,1136,0.15256763856706065,114,Unchanged,100000,5
holB,1198,2101,0.8104482538842603,903,Unchanged,100000,5
tmk,837,1353,0.6928623114261934,516,Unchanged,100000,5
mltG,863,1745,1.0157945719180597,882,Unchanged,100000,5
pabC,698,1272,0.865799729074703,574,Unchanged,100000,5
fabF,19103,5762,-1.7291576561718742,-13341,Unchanged,100000,5
acpP,10587,1385,-2.9343359545643297,-9202,Unchanged,100000,5
fabG,18276,3711,-2.3000704415109223,-14565,Unchanged,100000,5
fabD,11227,3515,-1.6753758780002472,-7712,Unchanged,100000,5
fabH,5416,3740,-0.5341894687999977,-1676,Unchanged,100000,5
plsX,4789,3040,-0.6556531119050533,-1749,Unchanged,100000,5
rpmF,1189,227,-2.3889845124547406,-962,Unchanged,100000,5
yceD,13505,3007,-2.1670968668223263,-10498,Unchanged,100000,5
yceF,1923,1187,-0.6960388276979906,-736,Unchanged,100000,5
rluC,2826,1957,-0.5301177097071355,-869,Unchanged,100000,5
yceQ,20,211,3.399171093819823,191,Unchanged,100000,5
rne,18565,14960,-0.31147513996710374,-3605,Unchanged,100000,5
flgL,901,1871,1.0542105474272454,970,Unchanged,100000,5
flgK,870,3114,1.8396816383429462,2244,Unchanged,100000,5
flgJ,445,1679,1.91572498908327,1234,Unchanged,100000,5
flgI,756,2196,1.538419914784126,1440,Unchanged,100000,5
flgH,689,1203,0.8040607544717852,514,Unchanged,100000,5
flgG,2137,1575,-0.4402350793851699,-562,Unchanged,100000,5
flgF,2175,1749,-0.31448511170180043,-426,Unchanged,100000,5
flgE,4559,2179,-1.065051212748858,-2380,Unchanged,100000,5
flgD,2647,1170,-1.1778496650246317,-1477,Unchanged,100000,5
flgC,1173,455,-1.36626456294245,-718,Unchanged,100000,5
flgB,1528,545,-1.4873164083714598,-983,Unchanged,100000,5
flgA,978,906,-0.11032341490599867,-72,Unchanged,100000,5
flgM,296,325,0.13484254228686715,29,Unchanged,100000,5
flgN,360,428,0.24961389007147222,68,Unchanged,100000,5
murJ,456,2851,2.644362309773211,2395,Unchanged,100000,5
yceM,1690,1981,0.2292056337199397,291,Unchanged,100000,5
yceH,1595,1226,-0.37959744496145026,-369,Unchanged,100000,5
rimJ,1083,1019,-0.08787919144251333,-64,Unchanged,100000,5
mdtH,180,1996,3.471042909007586,1816,Unchanged,100000,5
grxB,9658,3604,-1.422125452359117,-6054,Unchanged,100000,5
yceB,2884,1121,-1.3632848864353957,-1763,Unchanged,100000,5
pyrC,18327,1994,-3.2002333314032056,-16333,Unchanged,100000,5
dinI,1134,222,-2.3527890585921227,-912,Unchanged,100000,5
bssS,560,174,-1.6863395210962382,-386,Unchanged,100000,5
solA,2910,2255,-0.36789171965290285,-655,Unchanged,100000,5
yceO,4,5,0.32192809488736235,1,Unchanged,100000,5
yceJ,23,574,4.6413449706186745,551,Unchanged,100000,5
yceI,120,606,2.3362833878644325,486,Unchanged,100000,5
trhO,392,1377,1.812603000019756,985,Unchanged,100000,5
lpxL,1470,2069,0.49311749013628287,599,Unchanged,100000,5
mdtG,254,1616,2.6695267959796287,1362,Unchanged,100000,5
msyB,1443,353,-2.0313312112200177,-1090,Unchanged,100000,5
yceK,152,139,-0.12898644072007803,-13,Unchanged,100000,5
opgH,7957,6686,-0.25108124403954035,-1271,Unchanged,100000,5
opgG,10984,4937,-1.1536969804060038,-6047,Unchanged,100000,5
opgC,246,1016,2.046170181432926,770,Unchanged,100000,5
clsC,1044,2250,1.1078032895345151,1206,Unchanged,100000,5
ymdB,428,591,0.4655473337763855,163,Unchanged,100000,5
ymdA,66,241,1.868495216871508,175,Unchanged,100000,5
csgC,10,153,3.9354597478052895,143,Unchanged,100000,5
csgA,338,470,0.4756375102828154,132,Unchanged,100000,5
csgB,12,181,3.914883386362049,169,Unchanged,100000,5
csgD,125,394,1.6562675347942892,269,Unchanged,100000,5
csgE,18,157,3.1246957474493144,139,Unchanged,100000,5
csgF,16,249,3.960001932068081,233,Unchanged,100000,5
csgG,166,1174,2.8221772617631276,1008,Unchanged,100000,5
ycdZ,596,750,0.33157826492108156,154,Unchanged,100000,5
ycdY,1768,1062,-0.735334508587278,-706,Unchanged,100000,5
ycdX,3393,1942,-0.8050182292917843,-1451,Unchanged,100000,5
ghrA,3850,3169,-0.28083078608739237,-681,Unchanged,100000,5
ycdU,19,889,5.548112095386185,870,Unchanged,100000,5
ymdE,3,111,5.20945336562895,108,Unchanged,100000,5
insE4,99,112,0.17799830197799443,13,Unchanged,100000,5
insF4,24,606,4.658211482751795,582,Unchanged,100000,5
dgcT,939,1005,0.09799843841251649,66,Unchanged,100000,5
pgaA,2502,3834,0.6157685475023308,1332,Unchanged,100000,5
pgaB,1215,2453,1.0135909200644588,1238,Unchanged,100000,5
pgaC,838,1786,1.0917099314218714,948,Unchanged,100000,5
pgaD,207,334,0.690217334974727,127,Unchanged,100000,5
phoH,67,1740,4.6987824002783185,1673,Unchanged,100000,5
efeB,142,2756,4.278613053199609,2614,Unchanged,100000,5
efeO,80,2367,4.8869158958472525,2287,Unchanged,100000,5
putP,897,3399,1.9219304716224106,2502,Unchanged,100000,5
putA,510,10181,4.319238215713851,9671,Unchanged,100000,5
rutR,426,1339,1.6522306250984724,913,Unchanged,100000,5
rutA,14,2489,7.473995592923432,2475,Unchanged,100000,5
rutB,19,1458,6.261847490883352,1439,Unchanged,100000,5
rutC,8,493,5.945443836377912,485,Unchanged,100000,5
rutD,27,1888,6.1277555471983725,1861,Unchanged,100000,5
rutE,21,1117,5.733096047704555,1096,Unchanged,100000,5
rutF,18,865,5.586631321081775,847,Unchanged,100000,5
rutG,202,2970,3.8780357329363335,2768,Unchanged,100000,5
wrbA,8996,2543,-1.8227521990877107,-6453,Unchanged,100000,5
yccJ,2763,528,-2.3876257274540382,-2235,Unchanged,100000,5
agp,2559,3336,0.38253914140521716,777,Unchanged,100000,5
yccE,76,289,1.9269981690570934,213,Unchanged,100000,5
cbpA,11798,2480,-2.2501302885543626,-9318,Unchanged,100000,5
cbpM,2625,546,-2.265344566520995,-2079,Unchanged,100000,5
torD,6279,2503,-1.3268765212885334,-3776,Unchanged,100000,5
torA,54276,16650,-1.7047922245065805,-37626,Unchanged,100000,5
torC,17968,4504,-1.9961511003203716,-13464,Unchanged,100000,5
torR,540,1436,1.4110244367722204,896,Unchanged,100000,5
torT,516,2121,2.039301650107301,1605,Unchanged,100000,5
torS,859,6052,2.816681951078274,5193,Unchanged,100000,5
yccM,233,1706,2.87221578666401,1473,Unchanged,100000,5
ymcE,1,39,5.285402218862249,38,Unchanged,100000,5
cspG,21,106,2.335603031784439,85,Unchanged,100000,5
cspH,2,103,5.6865005271832185,101,Unchanged,100000,5
insB4,177,924,2.3841434913330604,747,Unchanged,100000,5
gfcA,51,291,2.5124500009367883,240,Unchanged,100000,5
gfcB,26,667,4.681103233043493,641,Unchanged,100000,5
gfcC,37,1072,4.856635824828823,1035,Unchanged,100000,5
gfcD,132,3691,4.805401902887155,3559,Unchanged,100000,5
gfcE,118,1885,3.9977057587941855,1767,Unchanged,100000,5
etp,62,444,2.840219555963231,382,Unchanged,100000,5
etk,886,4143,2.2252972164241887,3257,Unchanged,100000,5
appA,2363,2466,0.06155317042899224,103,Unchanged,100000,5
appB,3375,2654,-0.3467191314553622,-721,Unchanged,100000,5
appC,4239,3418,-0.31057156937895625,-821,Unchanged,100000,5
hyaF,2995,1647,-0.8627154479497933,-1348,Unchanged,100000,5
hyaE,1064,691,-0.622740535112931,-373,Unchanged,100000,5
hyaD,3274,1419,-1.2061797324136019,-1855,Unchanged,100000,5
hyaC,2700,1413,-0.934197941604254,-1287,Unchanged,100000,5
hyaB,5664,4366,-0.37550913509220635,-1298,Unchanged,100000,5
hyaA,4584,2836,-0.6927495115173888,-1748,Unchanged,100000,5
yccA,4779,2897,-0.7221490829760625,-1882,Unchanged,100000,5
tusE,572,379,-0.5938172986072977,-193,Unchanged,100000,5
yccX,84,235,1.4841995237862393,151,Unchanged,100000,5
rlmI,2482,2324,-0.09489304672582782,-158,Unchanged,100000,5
hspQ,1831,1012,-0.8554225011030269,-819,Unchanged,100000,5
yccU,1754,893,-0.9739166673235102,-861,Unchanged,100000,5
yccT,122,1112,3.1882037351606214,990,Unchanged,100000,5
mgsA,2306,1255,-0.8777051488136377,-1051,Unchanged,100000,5
helD,4108,5220,0.34561362513905175,1112,Unchanged,100000,5
yccF,698,628,-0.15246247731802526,-70,Unchanged,100000,5
yccS,1818,3991,1.1343980793171646,2173,Unchanged,100000,5
sxy,419,915,1.1268214994720533,496,Unchanged,100000,5
sulA,2741,985,-1.4765066984820365,-1756,Unchanged,100000,5
ompA,206754,45709,-2.1773650792051917,-161045,Downregulated,100000,5
matP,515,603,0.22758556982950404,88,Unchanged,100000,5
ycbZ,1931,3540,0.8744011960197096,1609,Unchanged,100000,5
fabA,2426,1815,-0.41861000223739725,-611,Unchanged,100000,5
rmf,19615,7006,-1.485294442162395,-12609,Unchanged,100000,5
pqiC,610,825,0.43558487668292956,215,Unchanged,100000,5
pqiB,1559,2700,0.7923384792404085,1141,Unchanged,100000,5
pqiA,542,1941,1.8404353613597921,1399,Unchanged,100000,5
uup,3146,4285,0.4457765335841755,1139,Unchanged,100000,5
rlmL,3709,4931,0.41084998499810926,1222,Unchanged,100000,5
ycbX,752,1959,1.3813128305899496,1207,Unchanged,100000,5
zapC,1360,927,-0.5529654075121709,-433,Unchanged,100000,5
pyrD,20107,1467,-3.7767570689213334,-18640,Unchanged,100000,5
ycbF,119,638,2.422594850456926,519,Unchanged,100000,5
ycbV,62,596,3.2649722100752863,534,Unchanged,100000,5
ycbU,35,429,3.615550820554579,394,Unchanged,100000,5
elfG,161,1108,2.782825287934571,947,Unchanged,100000,5
elfC,175,3411,4.2847679277810755,3236,Unchanged,100000,5
elfD,15,502,5.064652958342253,487,Unchanged,100000,5
elfA,176,372,1.0797271924707341,196,Unchanged,100000,5
ssuE,12,733,5.932706887412656,721,Unchanged,100000,5
ssuA,32,1397,5.448116305409463,1365,Unchanged,100000,5
ssuD,83,1896,4.513703817551335,1813,Unchanged,100000,5
ssuC,44,1243,4.820178962415188,1199,Unchanged,100000,5
ssuB,152,1146,2.9144638153133196,994,Unchanged,100000,5
pepN,6759,6278,-0.10650478537446889,-481,Unchanged,100000,5
pncB,13139,4036,-1.702857397782121,-9103,Unchanged,100000,5
asnS,17274,8045,-1.1024378686737821,-9229,Unchanged,100000,5
ompF,11716,2336,-2.3263679189993494,-9380,Unchanged,100000,5
aspC,14428,5594,-1.3669191693113787,-8834,Unchanged,100000,5
gloC,4344,1939,-1.1637112996975691,-2405,Unchanged,100000,5
mepK,4820,1575,-1.6136813178426828,-3245,Unchanged,100000,5
ldtD,2920,3868,0.4056194257094617,948,Unchanged,100000,5
mukB,11670,10981,-0.08779511969410014,-689,Unchanged,100000,5
mukE,1015,1166,0.200088061127958,151,Unchanged,100000,5
mukF,1656,2238,0.43450736347706875,582,Unchanged,100000,5
cmoM,1597,1617,0.017955366062429045,20,Unchanged,100000,5
elyC,359,876,1.2869470257781221,517,Unchanged,100000,5
ycbJ,1854,1882,0.021625384103005865,28,Unchanged,100000,5
kdsB,3176,1899,-0.7419710069934603,-1277,Unchanged,100000,5
ycaR,149,117,-0.34880380087875706,-32,Unchanged,100000,5
ycaQ,281,1606,2.5148298572963883,1325,Unchanged,100000,5
lpxK,596,1728,1.5357189817013068,1132,Unchanged,100000,5
msbA,2833,3545,0.32345502574878005,712,Unchanged,100000,5
ycaI,267,2883,3.4326591898073526,2616,Unchanged,100000,5
ihfB,4169,543,-2.9406772690040275,-3626,Unchanged,100000,5
rpsA,111197,26814,-2.0520595102282333,-84383,Unchanged,100000,5
cmk,2341,1341,-0.8038156972075388,-1000,Unchanged,100000,5
ycaL,158,728,2.2040138920215933,570,Unchanged,100000,5
aroA,7840,2877,-1.4462884332632837,-4963,Unchanged,100000,5
serC,40422,7489,-2.432295710382022,-32933,Unchanged,100000,5
ycaP,358,629,0.8131004296150328,271,Unchanged,100000,5
ycaO,1024,2488,1.2807707701306026,1464,Unchanged,100000,5
focA,3653,2876,-0.3450180779227205,-777,Unchanged,100000,5
pflA,2310,1267,-0.8664763271626105,-1043,Unchanged,100000,5
ycaK,94,385,2.0341257839046265,291,Unchanged,100000,5
ycaN,239,852,1.8338428122450898,613,Unchanged,100000,5
ycaM,49,1510,4.945622990097233,1461,Unchanged,100000,5
ycaD,1249,1714,0.45659363250454255,465,Unchanged,100000,5
ycaC,1162,602,-0.9487746766448268,-560,Unchanged,100000,5
dmsC,4717,1628,-1.53476890126335,-3089,Unchanged,100000,5
dmsB,2469,936,-1.3993464015593775,-1533,Unchanged,100000,5
dmsA,11621,4690,-1.3090743917468417,-6931,Unchanged,100000,5
serS,19894,6684,-1.5735497432391965,-13210,Unchanged,100000,5
rarA,1869,2732,0.5476909145449325,863,Unchanged,100000,5
lolA,1526,1013,-0.5911207880333923,-513,Unchanged,100000,5
ftsK,12158,10309,-0.23800152960157073,-1849,Unchanged,100000,5
lrp,6467,1136,-2.509133775543195,-5331,Unchanged,100000,5
trxB,5474,2431,-1.1710455413362275,-3043,Unchanged,100000,5
cydD,2062,4856,1.2357240888875736,2794,Unchanged,100000,5
cydC,2670,4215,0.6586928892545283,1545,Unchanged,100000,5
aat,858,1389,0.694997046481847,531,Unchanged,100000,5
infA,2058,307,-2.744932421523789,-1751,Unchanged,100000,5
clpA,29579,21566,-0.4558146645997842,-8013,Unchanged,100000,5
clpS,455,516,0.18150452033719547,61,Unchanged,100000,5
cspD,1176,315,-1.9004643264490857,-861,Unchanged,100000,5
macB,1094,5070,2.212373009098146,3976,Unchanged,100000,5
macA,728,2767,1.9263122884112582,2039,Unchanged,100000,5
ybjX,13740,3962,-1.794081218815976,-9778,Unchanged,100000,5
ybjD,921,3715,2.012089149334623,2794,Unchanged,100000,5
aqpZ,356,1476,2.0517435750939983,1120,Unchanged,100000,5
lysO,1426,1720,0.2704345831455723,294,Unchanged,100000,5
hcp,293,3690,3.6546482465255106,3397,Unchanged,100000,5
hcr,312,1329,2.090723170413926,1017,Unchanged,100000,5
poxB,4689,3931,-0.2543839152967266,-758,Unchanged,100000,5
ltaE,3682,2458,-0.5830047109772448,-1224,Unchanged,100000,5
ybjT,2111,2893,0.45463974458244355,782,Unchanged,100000,5
ybjS,1614,1890,0.22774565583065481,276,Unchanged,100000,5
amiD,1618,2348,0.5372208006800746,730,Unchanged,100000,5
ybjQ,562,618,0.13703670768344833,56,Unchanged,100000,5
ybjP,2106,1071,-0.9755469562754611,-1035,Unchanged,100000,5
artP,2060,2361,0.1967537041580618,301,Unchanged,100000,5
artI,3090,2655,-0.21889497710022102,-435,Unchanged,100000,5
artQ,1630,1697,0.05811460042422344,67,Unchanged,100000,5
artM,1040,1367,0.3944297145776055,327,Unchanged,100000,5
artJ,1695,3465,1.0315700790008697,1770,Unchanged,100000,5
rlmC,472,1874,1.9892621882973456,1402,Unchanged,100000,5
ybjO,201,559,1.4756527816642615,358,Unchanged,100000,5
potI,121,1291,3.415410048032596,1170,Unchanged,100000,5
potH,31,1317,5.408843319869639,1286,Unchanged,100000,5
potG,98,1611,4.03903093459136,1513,Unchanged,100000,5
potF,141,1450,3.362285832503503,1309,Unchanged,100000,5
ybjN,1262,543,-1.2166878071781875,-719,Unchanged,100000,5
rimK,1282,1613,0.3313501765369017,331,Unchanged,100000,5
nfsA,1198,1319,0.1388166564627591,121,Unchanged,100000,5
ybjC,343,322,-0.09114788805819528,-21,Unchanged,100000,5
grxA,159,112,-0.5055280332267513,-47,Unchanged,100000,5
ybjM,592,506,-0.22645979093463967,-86,Unchanged,100000,5
ybjL,2238,4070,0.8628187581772154,1832,Unchanged,100000,5
rcdA,210,735,1.8073549220576042,525,Unchanged,100000,5
ybjJ,517,2100,2.02215314223855,1583,Unchanged,100000,5
ybjI,819,1106,0.4334160285936985,287,Unchanged,100000,5
ybjH,149,235,0.6573484261028382,86,Unchanged,100000,5
mdfA,472,1748,1.8888464201387571,1276,Unchanged,100000,5
ybjG,2358,1221,-0.9495005179923595,-1137,Unchanged,100000,5
deoR,1256,1179,-0.09127274591186439,-77,Unchanged,100000,5
dacC,4569,2970,-0.6214155115203204,-1599,Unchanged,100000,5
gstB,3048,1360,-1.1642562513556203,-1688,Unchanged,100000,5
yliI,463,2480,2.4212560220140014,2017,Unchanged,100000,5
bssR,10383,6662,-0.6401960882122527,-3721,Unchanged,100000,5
rimO,1654,2378,0.5237894805743811,724,Unchanged,100000,5
dgcI,654,1152,0.8167781759442299,498,Unchanged,100000,5
pdeI,1556,2375,0.6100854531194805,819,Unchanged,100000,5
gsiD,251,1506,2.584962500721156,1255,Unchanged,100000,5
gsiC,385,1878,2.2862667120715106,1493,Unchanged,100000,5
gsiB,1239,3863,1.6405454900913297,2624,Unchanged,100000,5
gsiA,2083,6300,1.5966889892339944,4217,Unchanged,100000,5
iaaA,1443,4880,1.7578098479590505,3437,Unchanged,100000,5
moeA,2189,3195,0.5455439766534106,1006,Unchanged,100000,5
moeB,916,1774,0.9535865062041199,858,Unchanged,100000,5
fsaA,155,869,2.4870879615401624,714,Unchanged,100000,5
ybiY,30,1492,5.636141224646719,1462,Unchanged,100000,5
ybiW,265,4667,4.138431202513582,4402,Unchanged,100000,5
ybiV,444,1088,1.2930469749002333,644,Unchanged,100000,5
ybiU,96,2480,4.6911619045530815,2384,Unchanged,100000,5
ybiT,3661,5084,0.4737262567004134,1423,Unchanged,100000,5
ldtB,3104,1894,-0.7126922267187425,-1210,Unchanged,100000,5
ybiR,287,1990,2.7936457887553234,1703,Unchanged,100000,5
mntR,583,1156,0.9875736093001823,573,Unchanged,100000,5
yliL,2,188,6.554588851677638,186,Unchanged,100000,5
opgE,265,2432,3.198078963993024,2167,Unchanged,100000,5
ompX,48807,9662,-2.3366943190254443,-39145,Unchanged,100000,5
rhtA,180,1640,3.187627003175771,1460,Unchanged,100000,5
dps,14671,2135,-2.7806592359214415,-12536,Unchanged,100000,5
glnH,9754,1919,-2.3456392608404877,-7835,Unchanged,100000,5
glnP,3277,1272,-1.3652770022584044,-2005,Unchanged,100000,5
glnQ,3497,1503,-1.2182727867813519,-1994,Unchanged,100000,5
ybiO,672,4518,2.749151132614324,3846,Unchanged,100000,5
rlmF,1442,1794,0.3151087256784386,352,Unchanged,100000,5
mcbA,69,224,1.698830465279435,155,Unchanged,100000,5
fiu,70,4128,5.881944238478288,4058,Unchanged,100000,5
ybiX,67,1146,4.096302138299133,1079,Unchanged,100000,5
ybiI,51,281,2.4620009782494305,230,Unchanged,100000,5
ybiJ,100,250,1.3219280948873624,150,Unchanged,100000,5
hcxB,9217,4083,-1.1746676831554574,-5134,Unchanged,100000,5
ybiB,2844,2333,-0.2857351576352161,-511,Unchanged,100000,5
dinG,1871,6136,1.7134889242621494,4265,Unchanged,100000,5
ybiA,112,859,2.9391593990808595,747,Unchanged,100000,5
rhlE,751,3454,2.2013832700146523,2703,Unchanged,100000,5
cecR,562,1703,1.5994363994576164,1141,Unchanged,100000,5
ybhG,1149,2752,1.2601016720559846,1603,Unchanged,100000,5
ybhF,2044,5108,1.3213633287651025,3064,Unchanged,100000,5
ybhS,629,2785,2.146545405348105,2156,Unchanged,100000,5
ybhR,485,2499,2.365294249012214,2014,Unchanged,100000,5
ybhQ,351,663,0.9175378398080271,312,Unchanged,100000,5
ybhP,600,1332,1.1505596765753814,732,Unchanged,100000,5
clsB,877,2672,1.607271260029319,1795,Unchanged,100000,5
ybhN,286,1777,2.6353566292502886,1491,Unchanged,100000,5
ybhM,64,618,3.2714630279043746,554,Unchanged,100000,5
ybhL,3891,1918,-1.0205382599547248,-1973,Unchanged,100000,5
moaE,1752,887,-0.9819967653001095,-865,Unchanged,100000,5
moaD,260,212,-0.2944473584652553,-48,Unchanged,100000,5
moaC,2860,1422,-1.0080936820463364,-1438,Unchanged,100000,5
moaB,3256,1582,-1.0413510997934552,-1674,Unchanged,100000,5
moaA,3302,2657,-0.31354189242275143,-645,Unchanged,100000,5
ybhK,1102,1725,0.6464721379817361,623,Unchanged,100000,5
uvrB,5067,7051,0.4766960517334962,1984,Unchanged,100000,5
bioD,627,1115,0.8305063620056281,488,Unchanged,100000,5
bioC,584,1616,1.4683869238717775,1032,Unchanged,100000,5
bioF,1223,3169,1.373603255854847,1946,Unchanged,100000,5
bioB,1832,3375,0.8814679987286117,1543,Unchanged,100000,5
bioA,1022,4147,2.02067285096834,3125,Unchanged,100000,5
ybhB,1312,862,-0.6060079455289856,-450,Unchanged,100000,5
ybhC,4620,3395,-0.44448127717132574,-1225,Unchanged,100000,5
ybhJ,126,4432,5.136462242549272,4306,Unchanged,100000,5
ybhI,19,1969,6.6953198824579685,1950,Unchanged,100000,5
ybhH,9,1233,7.098032082960526,1224,Unchanged,100000,5
ybhD,21,919,5.4516036285102745,898,Unchanged,100000,5
pgl,5304,2024,-1.3898714854182777,-3280,Unchanged,100000,5
ybhA,1185,1124,-0.07624502356469538,-61,Unchanged,100000,5
modC,548,2934,2.420621072712863,2386,Unchanged,100000,5
modB,333,1743,2.387978487054423,1410,Unchanged,100000,5
modA,403,3138,2.96099360844013,2735,Unchanged,100000,5
acrZ,112,12,-3.222392421336448,-100,Unchanged,100000,5
modE,525,1642,1.6450647992243197,1117,Unchanged,100000,5
modF,666,3309,2.3128012092412766,2643,Unchanged,100000,5
galE,2865,2524,-0.18282322866171827,-341,Unchanged,100000,5
galT,2229,2268,0.025024023682476366,39,Unchanged,100000,5
galK,3675,3084,-0.2529414846960549,-591,Unchanged,100000,5
galM,9684,3637,-1.4128541535433197,-6047,Unchanged,100000,5
gpmA,6870,3083,-1.1559752095982874,-3787,Unchanged,100000,5
aroG,13069,6744,-0.9544723133417239,-6325,Unchanged,100000,5
ybgS,686,346,-0.9874365385360876,-340,Unchanged,100000,5
zitB,773,1333,0.7861364611641258,560,Unchanged,100000,5
pnuC,10328,1578,-2.710391795293732,-8750,Unchanged,100000,5
nadA,15773,2695,-2.5490999064830935,-13078,Unchanged,100000,5
cpoB,8513,2280,-1.9006338060429238,-6233,Unchanged,100000,5
pal,12885,2556,-2.3337327957999876,-10329,Unchanged,100000,5
tolB,13827,4672,-1.5653759941777878,-9155,Unchanged,100000,5
tolA,2665,2547,-0.06533657337234353,-118,Unchanged,100000,5
tolR,476,489,0.03887289164429008,13,Unchanged,100000,5
tolQ,1786,1210,-0.5617250329592661,-576,Unchanged,100000,5
ybgC,891,449,-0.9887099867807749,-442,Unchanged,100000,5
ybgE,1043,406,-1.3611875253345895,-637,Unchanged,100000,5
cydB,10697,6818,-0.6497857413838689,-3879,Unchanged,100000,5
cydA,15778,9944,-0.6660161411773403,-5834,Unchanged,100000,5
mngB,695,3651,2.3932067858240145,2956,Unchanged,100000,5
mngA,36,3044,6.4018276420612334,3008,Unchanged,100000,5
mngR,443,965,1.1232222436004242,522,Unchanged,100000,5
sucD,2502,2196,-0.1882037351606212,-306,Unchanged,100000,5
sucC,3330,3138,-0.08567682499052688,-192,Unchanged,100000,5
sucB,4106,3606,-0.18733423067626032,-500,Unchanged,100000,5
sucA,5375,7546,0.4894473454459246,2171,Unchanged,100000,5
sdhB,312,1019,1.7075361173035655,707,Unchanged,100000,5
sdhA,571,3693,2.693230611842771,3122,Unchanged,100000,5
sdhD,45,388,3.108059745857453,343,Unchanged,100000,5
sdhC,57,509,3.1586318319109536,452,Unchanged,100000,5
gltA,4843,10211,1.076151253402954,5368,Unchanged,100000,5
ybgD,12,709,5.88467931651836,697,Unchanged,100000,5
ybgQ,17,4222,7.956248022096816,4205,Unchanged,100000,5
ybgP,16,969,5.920352855415081,953,Unchanged,100000,5
ybgO,33,1253,5.246776579963407,1220,Unchanged,100000,5
abrB,589,2139,1.8605969433345837,1550,Unchanged,100000,5
nei,1068,1807,0.7586848591770456,739,Unchanged,100000,5
pxpA,1773,2091,0.23800052569089059,318,Unchanged,100000,5
pxpC,3778,3246,-0.2189597018403983,-532,Unchanged,100000,5
pxpB,2126,1999,-0.0888631247864771,-127,Unchanged,100000,5
ybgI,2940,2890,-0.024746662335685607,-50,Unchanged,100000,5
dtpD,1059,3729,1.8160862077813047,2670,Unchanged,100000,5
phr,887,2930,1.7238946550085463,2043,Unchanged,100000,5
ybgA,438,770,0.8139275759810903,332,Unchanged,100000,5
ybfD,63,563,3.1597111885803133,500,Unchanged,100000,5
ybfL,66,1104,4.064130337419716,1038,Unchanged,100000,5
ybfC,106,337,1.6686843266186593,231,Unchanged,100000,5
ybfO,136,2421,4.153924522748597,2285,Unchanged,100000,5
ybfB,20,18,-0.15200309344504995,-2,Unchanged,100000,5
rhsC,1471,10618,2.8516428948689008,9147,Unchanged,100000,5
ybfA,2277,251,-3.1813750221858506,-2026,Unchanged,100000,5
kdpA,42,4335,6.689498855330437,4293,Unchanged,100000,5
kdpB,220,6069,4.78588339175478,5849,Unchanged,100000,5
kdpC,133,1235,3.2150128909708506,1102,Unchanged,100000,5
kdpD,1830,8244,2.1715008563678513,6414,Unchanged,100000,5
kdpE,187,1476,2.9805825461727595,1289,Unchanged,100000,5
speF,70,4158,5.892391025913404,4088,Unchanged,100000,5
potE,315,2476,2.9745875808269857,2161,Unchanged,100000,5
ybfG,20,713,5.155830171556525,693,Unchanged,100000,5
ybfP,47,438,3.220198207923536,391,Unchanged,100000,5
pgm,13779,5872,-1.2305473160988876,-7907,Unchanged,100000,5
seqA,2579,1436,-0.8447560239661627,-1143,Unchanged,100000,5
ybfF,1322,1348,0.028098319674166743,26,Unchanged,100000,5
ybfE,227,286,0.3333228494874745,59,Unchanged,100000,5
fldA,3509,1495,-1.2309144633166993,-2014,Unchanged,100000,5
fur,3036,1227,-1.3070365417525613,-1809,Unchanged,100000,5
chiQ,33,320,3.277533975528909,287,Unchanged,100000,5
chiP,92,2127,4.531042361903659,2035,Unchanged,100000,5
glnS,4970,4363,-0.18792537807314874,-607,Unchanged,100000,5
nagE,1753,3834,1.1290243409086127,2081,Unchanged,100000,5
nagB,1465,985,-0.5727050349658716,-480,Unchanged,100000,5
nagA,2314,2567,0.1496944314679285,253,Unchanged,100000,5
nagC,2087,3113,0.5768749763093446,1026,Unchanged,100000,5
umpH,2473,1850,-0.4187369689862633,-623,Unchanged,100000,5
asnB,11711,4559,-1.3610749582311916,-7152,Unchanged,100000,5
ubiF,1014,2940,1.5357585027203864,1926,Unchanged,100000,5
miaB,5129,4111,-0.31918819941338006,-1018,Unchanged,100000,5
ybeZ,4419,3751,-0.2364446680955357,-668,Unchanged,100000,5
ybeY,1362,1208,-0.17310624868699223,-154,Unchanged,100000,5
ybeX,5542,3226,-0.7806602723257742,-2316,Unchanged,100000,5
lnt,1961,3240,0.724404277579838,1279,Unchanged,100000,5
insH3,5086,3668,-0.471537823095052,-1418,Unchanged,100000,5
gltI,2328,1803,-0.3686916614759422,-525,Unchanged,100000,5
gltJ,234,934,1.9969140201262574,700,Unchanged,100000,5
gltK,302,1044,1.7895012572448055,742,Unchanged,100000,5
gltL,326,1234,1.9203985249183404,908,Unchanged,100000,5
rihA,1101,1559,0.5018064591334157,458,Unchanged,100000,5
hscC,143,2390,4.062923566089721,2247,Unchanged,100000,5
djlC,182,1910,3.391562282724415,1728,Unchanged,100000,5
ybeU,39,685,4.134557958985641,646,Unchanged,100000,5
ybeT,1,392,8.614709844115207,391,Unchanged,100000,5
djlB,51,1784,5.128474557948809,1733,Unchanged,100000,5
ybeR,15,675,5.491853096329675,660,Unchanged,100000,5
ybeQ,62,1100,4.149091498025147,1038,Unchanged,100000,5
ybeL,2112,889,-1.2483545105286835,-1223,Unchanged,100000,5
leuS,17258,8851,-0.9633529152638997,-8407,Unchanged,100000,5
lptE,2392,1202,-0.9927804934869194,-1190,Unchanged,100000,5
holA,1720,1713,-0.0058834135054613625,-7,Unchanged,100000,5
nadD,594,764,0.3631097072349828,170,Unchanged,100000,5
cobC,294,735,1.3219280948873624,441,Unchanged,100000,5
rsfS,744,401,-0.8917003846531112,-343,Unchanged,100000,5
rlmH,927,984,0.0860889767137092,57,Unchanged,100000,5
mrdA,1735,3095,0.8350037466360037,1360,Unchanged,100000,5
mrdB,1123,1828,0.7029081426574686,705,Unchanged,100000,5
rlpA,3505,2300,-0.607780583066248,-1205,Unchanged,100000,5
dacA,5294,2078,-1.3491625405911867,-3216,Unchanged,100000,5
ybeD,867,346,-1.3252599555851103,-521,Unchanged,100000,5
lipB,1228,1057,-0.2163351839874963,-171,Unchanged,100000,5
ybeF,39,933,4.580331051989511,894,Unchanged,100000,5
lipA,2513,2007,-0.32437005451803846,-506,Unchanged,100000,5
tatE,377,151,-1.3200159739435855,-226,Unchanged,100000,5
crcB,508,397,-0.355689489629208,-111,Unchanged,100000,5
cspE,9436,734,-3.68432345039625,-8702,Unchanged,100000,5
pagP,592,510,-0.2150999287700918,-82,Unchanged,100000,5
dcuC,806,2157,1.4201744326324868,1351,Unchanged,100000,5
dpiA,1051,838,-0.3267405202628268,-213,Unchanged,100000,5
dpiB,1865,2775,0.5733121409822306,910,Unchanged,100000,5
citC,6544,1529,-2.097584341580944,-5015,Unchanged,100000,5
citD,3627,280,-3.6952780130253133,-3347,Unchanged,100000,5
citE,17565,1522,-3.5286633126061884,-16043,Unchanged,100000,5
citF,35674,3061,-3.5427980392116187,-32613,Unchanged,100000,5
citX,8881,920,-3.2710163668036967,-7961,Unchanged,100000,5
citG,2388,1148,-1.0566801945891173,-1240,Unchanged,100000,5
citT,14439,2193,-2.718993112012435,-12246,Unchanged,100000,5
rna,806,1711,1.085988015961446,905,Unchanged,100000,5
rnk,886,704,-0.33173126991772117,-182,Unchanged,100000,5
ybdR,1588,2099,0.40249125414919645,511,Unchanged,100000,5
uspG,5319,1062,-2.324371270815691,-4257,Unchanged,100000,5
ahpF,5126,6331,0.30459991693185695,1205,Unchanged,100000,5
ahpC,18400,7356,-1.3227123814197999,-11044,Unchanged,100000,5
dsbG,491,1101,1.1650195392496758,610,Unchanged,100000,5
ybdO,29,625,4.429731384421878,596,Unchanged,100000,5
ybdN,47,2228,5.566944665662394,2181,Unchanged,100000,5
ybdM,134,1080,3.0107264065930583,946,Unchanged,100000,5
ybdL,1558,2395,0.6203304225618733,837,Unchanged,100000,5
hcxA,1912,3369,0.8172379051410089,1457,Unchanged,100000,5
cstA,571,6499,3.508655097282057,5928,Unchanged,100000,5
entH,42,745,4.148779192570764,703,Unchanged,100000,5
entA,100,1547,3.951401291674311,1447,Unchanged,100000,5
entB,95,2072,4.446952679355606,1977,Unchanged,100000,5
entE,47,4299,6.515196543305664,4252,Unchanged,100000,5
entC,21,3096,7.20387233336565,3075,Unchanged,100000,5
fepB,66,2470,5.225901207113586,2404,Unchanged,100000,5
entS,14,3182,7.828363198273443,3168,Unchanged,100000,5
fepD,43,2669,5.955818835439868,2626,Unchanged,100000,5
fepG,48,2789,5.860569718307156,2741,Unchanged,100000,5
fepC,48,1976,5.363404730863522,1928,Unchanged,100000,5
fepE,14,1776,6.987060944292502,1762,Unchanged,100000,5
entF,399,9184,4.524661990453342,8785,Unchanged,100000,5
fes,15,2305,7.263660439708182,2290,Unchanged,100000,5
fepA,159,4194,4.721228190812237,4035,Unchanged,100000,5
entD,21,678,5.012824040357583,657,Unchanged,100000,5
insL2,1964,1840,-0.09408916337031785,-124,Unchanged,100000,5
ybdK,648,1957,1.5945780377421792,1309,Unchanged,100000,5
ybdJ,47,147,1.645083493158727,100,Unchanged,100000,5
ybdF,259,368,0.506753668370459,109,Unchanged,100000,5
nfsB,3393,1642,-1.047107302933172,-1751,Unchanged,100000,5
ybdG,4126,2928,-0.49482826760244225,-1198,Unchanged,100000,5
pheP,1564,2811,0.8458429410729909,1247,Unchanged,100000,5
cusA,287,6000,4.3858398587075555,5713,Unchanged,100000,5
cusB,79,1771,4.486567748574811,1692,Unchanged,100000,5
cusF,13,279,4.423681593688095,266,Unchanged,100000,5
cusC,25,2003,6.324090516037983,1978,Unchanged,100000,5
cusR,556,1128,1.020610279675286,572,Unchanged,100000,5
cusS,545,2203,2.015141360036594,1658,Unchanged,100000,5
nfrB,321,4022,3.647267879183049,3701,Unchanged,100000,5
nfrA,834,5608,2.7493670605659597,4774,Unchanged,100000,5
ybcH,181,1260,2.7993621313040737,1079,Unchanged,100000,5
envY,58,650,3.4863149127882447,592,Unchanged,100000,5
ompT,109949,15187,-2.855925665843311,-94762,Unchanged,100000,5
appY,1342,73,-4.200344397320166,-1269,Unchanged,100000,5
tfaX,2,53,4.727920454563199,51,Unchanged,100000,5
ybcY,27,384,3.8300749985576874,357,Unchanged,100000,5
tfaD,18,478,4.7309418065384365,460,Unchanged,100000,5
nohD,39,819,4.392317422778761,780,Unchanged,100000,5
ybcW,157,55,-1.5132610353669675,-102,Unchanged,100000,5
ybcV,12,13,0.11547721741993588,1,Unchanged,100000,5
borD,4813,257,-4.227096158770994,-4556,Unchanged,100000,5
rzpD,83,548,2.722992651613602,465,Unchanged,100000,5
rrrD,51,414,3.0210616155278296,363,Unchanged,100000,5
essD,7,45,2.6844981742720706,38,Unchanged,100000,5
insH2,5183,3326,-0.6399992250974303,-1857,Unchanged,100000,5
quuD,11,242,4.459431618637297,231,Unchanged,100000,5
rusA,8,352,5.459431618637297,344,Unchanged,100000,5
ybcO,4,226,5.820178962415188,222,Unchanged,100000,5
ninE,1,27,4.754887502163468,26,Unchanged,100000,5
ybcN,7,410,5.872125177447842,403,Unchanged,100000,5
ybcM,646,288,-1.1654653532516126,-358,Unchanged,100000,5
ybcL,132,378,1.5178483048626192,246,Unchanged,100000,5
ybcK,25,446,4.15704371014558,421,Unchanged,100000,5
emrE,116,87,-0.4150374992788438,-29,Unchanged,100000,5
renD,1519,5201,1.775667168094117,3682,Unchanged,100000,5
insF3,23,685,4.896398221790876,662,Unchanged,100000,5
insE3,132,128,-0.044394119358453395,-4,Unchanged,100000,5
exoD,4,276,6.108524456778169,272,Unchanged,100000,5
intD,767,1675,1.1268626127295636,908,Unchanged,100000,5
fimZ,18,192,3.415037499278844,174,Unchanged,100000,5
sfmF,4,395,6.625708843064465,391,Unchanged,100000,5
sfmH,23,939,5.351419391596762,916,Unchanged,100000,5
sfmD,114,3380,4.889917517004805,3266,Unchanged,100000,5
sfmC,4,543,7.084808387804362,539,Unchanged,100000,5
sfmA,28,390,3.7999753916920067,362,Unchanged,100000,5
folD,4243,2476,-0.7770733640764715,-1767,Unchanged,100000,5
ybcJ,447,229,-0.964927233086374,-218,Unchanged,100000,5
ybcI,74,938,3.6639907468864266,864,Unchanged,100000,5
cysS,3271,3113,-0.07142618261359868,-158,Unchanged,100000,5
ppiB,10047,2164,-2.2149923776010567,-7883,Unchanged,100000,5
lpxH,1036,1731,0.7405817216800848,695,Unchanged,100000,5
purE,2789,2029,-0.4589790692716531,-760,Unchanged,100000,5
purK,5606,4585,-0.2900500105500771,-1021,Unchanged,100000,5
ybcF,43,1744,5.341919570074828,1701,Unchanged,100000,5
ylbF,64,1818,4.828136484194107,1754,Unchanged,100000,5
fdrA,18,3604,7.645458294371227,3586,Unchanged,100000,5
allD,25,1896,6.244887059123535,1871,Unchanged,100000,5
allC,153,2715,4.149348639999072,2562,Unchanged,100000,5
allE,386,1246,1.6906313157559214,860,Unchanged,100000,5
glxK,132,2210,4.06543653492034,2078,Unchanged,100000,5
ybbY,37,2610,6.140380725828297,2573,Unchanged,100000,5
allB,87,3142,5.174523969445468,3055,Unchanged,100000,5
ybbW,10,2416,7.916476644437717,2406,Unchanged,100000,5
glxR,34,1684,5.630213581816057,1650,Unchanged,100000,5
hyi,25,857,5.099295204337775,832,Unchanged,100000,5
gcl,150,3592,4.581752944245266,3442,Unchanged,100000,5
allR,4566,2143,-1.091299009548154,-2423,Unchanged,100000,5
allA,92,849,3.2060587874960254,757,Unchanged,100000,5
allS,46,1785,5.278146402859449,1739,Unchanged,100000,5
selU,435,2561,2.5576199468613776,2126,Unchanged,100000,5
ylbG,161,616,1.9358696625802845,455,Unchanged,100000,5
ybbD,2,191,6.577428828035749,189,Unchanged,100000,5
ylbH,25,603,4.59215800212536,578,Unchanged,100000,5
ybbC,37,51,0.4629719763425457,14,Unchanged,100000,5
rhsD,795,9827,3.6277242903545646,9032,Unchanged,100000,5
ybbP,851,7405,3.1212686984902476,6554,Unchanged,100000,5
ybbA,447,2034,2.1859729426741823,1587,Unchanged,100000,5
tesA,654,1539,1.2346306908301277,885,Unchanged,100000,5
ybbO,1202,2456,1.030873664658994,1254,Unchanged,100000,5
cnoX,4477,3871,-0.20982601061123315,-606,Unchanged,100000,5
fetB,459,1370,1.577609834434081,911,Unchanged,100000,5
fetA,512,1093,1.0940776856719046,581,Unchanged,100000,5
qmcA,2072,2847,0.4584184900557117,775,Unchanged,100000,5
ybbJ,542,944,0.8004940080079697,402,Unchanged,100000,5
cueR,905,855,-0.08199337219730746,-50,Unchanged,100000,5
ybaT,4897,3296,-0.5711819535255476,-1601,Unchanged,100000,5
glsA,2707,2125,-0.3492320463025373,-582,Unchanged,100000,5
copA,8910,9491,0.09113467014986153,581,Unchanged,100000,5
ybaQ,782,588,-0.411352452470988,-194,Unchanged,100000,5
ybaP,910,2226,1.290515142255901,1316,Unchanged,100000,5
ybaK,821,1051,0.3563085421843737,230,Unchanged,100000,5
ushA,3058,4611,0.5924912590511229,1553,Unchanged,100000,5
fsr,250,1988,2.991317756900199,1738,Unchanged,100000,5
ybaL,2669,5400,1.016660101796227,2731,Unchanged,100000,5
gsk,2047,3102,0.5996875840126802,1055,Unchanged,100000,5
aes,122,2060,4.0776912845076945,1938,Unchanged,100000,5
hemH,478,2308,2.271560700664734,1830,Unchanged,100000,5
adk,9547,2153,-2.1486991398140236,-7394,Unchanged,100000,5
htpG,15235,12864,-0.24405018839491935,-2371,Unchanged,100000,5
recR,3471,2292,-0.5987443210717411,-1179,Unchanged,100000,5
ybaB,2425,1321,-0.8763542807150246,-1104,Unchanged,100000,5
dnaX,3164,6854,1.1151965920463824,3690,Unchanged,100000,5
apt,1522,1568,0.042957200611662895,46,Unchanged,100000,5
ybaN,54,681,3.6566234858486024,627,Unchanged,100000,5
priC,592,1368,1.2083991492569481,776,Unchanged,100000,5
ybaM,23,51,1.1488633859144828,28,Unchanged,100000,5
mscK,2849,9773,1.7783458699855794,6924,Unchanged,100000,5
acrR,308,768,1.3181759600262548,460,Unchanged,100000,5
acrA,3209,3909,0.28467579500748336,700,Unchanged,100000,5
acrB,11104,11074,-0.0039030460478649926,-30,Unchanged,100000,5
tomB,118,224,0.9247118726957629,106,Unchanged,100000,5
hha,160,201,0.32912359629156634,41,Unchanged,100000,5
maa,325,1088,1.7431669333345226,763,Unchanged,100000,5
ylaC,190,787,2.0503642171765386,597,Unchanged,100000,5
pdeB,384,2214,2.527477006060396,1830,Unchanged,100000,5
ybaA,67,429,2.678744647041773,362,Unchanged,100000,5
ffs,2,6,1.584962500721156,4,Unchanged,100000,5
ybaZ,192,492,1.3575520046180838,300,Unchanged,100000,5
ybaY,1105,817,-0.4356383861331104,-288,Unchanged,100000,5
tesB,784,1422,0.858995905504207,638,Unchanged,100000,5
amtB,390,2511,2.686715999521889,2121,Unchanged,100000,5
glnK,18,403,4.484711027085655,385,Unchanged,100000,5
mdlB,374,3164,3.080639424585155,2790,Unchanged,100000,5
mdlA,487,3202,2.7169796304339147,2715,Unchanged,100000,5
decR,226,560,1.3091040545297787,334,Unchanged,100000,5
cof,159,1119,2.815111365692039,960,Unchanged,100000,5
ybaE,248,2614,3.397847115408558,2366,Unchanged,100000,5
queC,529,1094,1.048273110678531,565,Unchanged,100000,5
fadM,61,288,2.239187663879426,227,Unchanged,100000,5
ybaV,164,414,1.3359349528812416,250,Unchanged,100000,5
ppiD,6756,4998,-0.434818426714682,-1758,Unchanged,100000,5
hupB,11231,888,-3.6607829031649928,-10343,Unchanged,100000,5
lon,16664,12308,-0.4371383957071021,-4356,Unchanged,100000,5
clpX,17133,7366,-1.2178244880777658,-9767,Unchanged,100000,5
clpP,7476,2654,-1.4940981983749648,-4822,Unchanged,100000,5
tig,23630,7237,-1.7071559525913556,-16393,Unchanged,100000,5
bolA,1498,280,-2.4195388915137848,-1218,Unchanged,100000,5
yajG,2246,1235,-0.8628468859285612,-1011,Unchanged,100000,5
ampG,1180,2203,0.9006826354516795,1023,Unchanged,100000,5
cyoA,90,1251,3.797012977836145,1161,Unchanged,100000,5
cyoB,324,2943,3.1832218240557704,2619,Unchanged,100000,5
cyoC,88,694,2.9793602339409637,606,Unchanged,100000,5
cyoD,81,308,1.9269365378102767,227,Unchanged,100000,5
cyoE,338,1303,1.9467419322859503,965,Unchanged,100000,5
yajR,608,2110,1.7950997701509621,1502,Unchanged,100000,5
yajQ,6016,2713,-1.1489155193957714,-3303,Unchanged,100000,5
panE,1748,1690,-0.04868193833105162,-58,Unchanged,100000,5
yajL,1432,1063,-0.4298898957331517,-369,Unchanged,100000,5
thiI,3164,2925,-0.11331297511466266,-239,Unchanged,100000,5
xseB,1026,373,-1.4597831953518163,-653,Unchanged,100000,5
ispA,3515,2312,-0.6043832914592188,-1203,Unchanged,100000,5
dxs,3729,4300,0.2055478627031816,571,Unchanged,100000,5
yajO,1791,1975,0.1410873159658665,184,Unchanged,100000,5
pgpA,1451,1277,-0.18428899436402066,-174,Unchanged,100000,5
thiL,1102,1679,0.6074780063658725,577,Unchanged,100000,5
nusB,2820,1084,-1.3793304059322844,-1736,Unchanged,100000,5
ribE,1881,906,-1.05391689347696,-975,Unchanged,100000,5
ribD,2395,2657,0.14977257186696405,262,Unchanged,100000,5
nrdR,1299,1060,-0.29333716599731957,-239,Unchanged,100000,5
yajI,404,570,0.4966066263003092,166,Unchanged,100000,5
tsx,8516,2793,-1.608360376172344,-5723,Unchanged,100000,5
yajD,677,317,-1.0946729934355894,-360,Unchanged,100000,5
secF,3967,2681,-0.5652771781627194,-1286,Unchanged,100000,5
secD,7855,5854,-0.42418852977280813,-2001,Unchanged,100000,5
yajC,2403,817,-1.556428664984183,-1586,Unchanged,100000,5
tgt,2831,2499,-0.17996084781904326,-332,Unchanged,100000,5
queA,838,2284,1.4465405016634911,1446,Unchanged,100000,5
acpH,310,697,1.1688904405941856,387,Unchanged,100000,5
malZ,1538,3263,1.0851434841300376,1725,Unchanged,100000,5
proY,1340,2392,0.8359843888529702,1052,Unchanged,100000,5
brnQ,6619,3029,-1.1277716926731132,-3590,Unchanged,100000,5
phoR,294,2701,3.199605579672603,2407,Unchanged,100000,5
phoB,410,1412,1.7840442737657343,1002,Unchanged,100000,5
sbcD,800,2094,1.3881895371560837,1294,Unchanged,100000,5
sbcC,1553,6714,2.112114707310249,5161,Unchanged,100000,5
araJ,324,2030,2.647414009187914,1706,Unchanged,100000,5
mak,828,1859,1.1668240974201562,1031,Unchanged,100000,5
rdgC,3510,2217,-0.662862260324616,-1293,Unchanged,100000,5
ykiA,42,218,2.375866901998166,176,Unchanged,100000,5
ppnP,1151,423,-1.4441582650122806,-728,Unchanged,100000,5
aroM,322,1160,1.8489922119003175,838,Unchanged,100000,5
yaiA,130,174,0.4205756828202737,44,Unchanged,100000,5
aroL,673,1756,1.3836144349250412,1083,Unchanged,100000,5
yaiI,301,773,1.3607049271651455,472,Unchanged,100000,5
proC,2679,1822,-0.5561716220403283,-857,Unchanged,100000,5
dgcC,77,1721,4.482244841345302,1644,Unchanged,100000,5
psiF,173,295,0.7699429166124789,122,Unchanged,100000,5
phoA,803,3799,2.242147819147708,2996,Unchanged,100000,5
iraP,1126,493,-1.191547275702318,-633,Unchanged,100000,5
ddlA,3671,2020,-0.8618178214603903,-1651,Unchanged,100000,5
yaiZ,47,160,1.767339243209725,113,Unchanged,100000,5
yaiY,485,422,-0.20074174836730485,-63,Unchanged,100000,5
yaiW,1193,2233,0.9043892081272454,1040,Unchanged,100000,5
sbmA,416,2326,2.4831956633321264,1910,Unchanged,100000,5
ampH,937,2269,1.2759356560131505,1332,Unchanged,100000,5
iprA,15,310,4.369233809665719,295,Unchanged,100000,5
insE2,79,80,0.01814734671025952,1,Unchanged,100000,5
insF2,23,556,4.595379116666495,533,Unchanged,100000,5
hemB,2960,2919,-0.020122965014044487,-41,Unchanged,100000,5
tauD,64,1482,4.533329732305834,1418,Unchanged,100000,5
tauC,34,1582,5.5400710432224525,1548,Unchanged,100000,5
tauB,40,1135,4.826548487290915,1095,Unchanged,100000,5
tauA,20,2129,6.734032139564932,2109,Unchanged,100000,5
yaiS,7,580,6.372554167957331,573,Unchanged,100000,5
yaiP,61,1842,4.91632000852845,1781,Unchanged,100000,5
insD1,465,1296,1.478763096889231,831,Unchanged,100000,5
insC1,425,206,-1.0448185038418458,-219,Unchanged,100000,5
yaiO,70,1135,4.019193565233311,1065,Unchanged,100000,5
frmR,32,571,4.157346935362843,539,Unchanged,100000,5
frmA,348,3853,3.4688229748108217,3505,Unchanged,100000,5
frmB,57,1424,4.642843416801656,1367,Unchanged,100000,5
yaiL,674,815,0.27405146793658136,141,Unchanged,100000,5
mhpT,143,2410,4.074946094338935,2267,Unchanged,100000,5
mhpE,61,2177,5.15738835462532,2116,Unchanged,100000,5
mhpF,51,1802,5.142957953842043,1751,Unchanged,100000,5
mhpD,39,1386,5.151309323274965,1347,Unchanged,100000,5
mhpC,33,1868,5.822884620351209,1835,Unchanged,100000,5
mhpB,12,1865,7.279997414421444,1853,Unchanged,100000,5
mhpA,22,3827,7.442566567031198,3805,Unchanged,100000,5
mhpR,50,1819,5.185073637876762,1769,Unchanged,100000,5
lacI,971,2684,1.4668414707809911,1713,Unchanged,100000,5
lacZ,38115,24033,-0.6653421271462036,-14082,Unchanged,100000,5
lacY,2799,2464,-0.18390923087801353,-335,Unchanged,100000,5
lacA,2089,1009,-1.0498863179607512,-1080,Unchanged,100000,5
cynX,109,3069,4.815368605689558,2960,Unchanged,100000,5
cynS,55,731,3.732367882427778,676,Unchanged,100000,5
cynT,44,1523,5.113268607849995,1479,Unchanged,100000,5
cynR,204,2122,3.378783598943269,1918,Unchanged,100000,5
codA,13627,3555,-1.9385465211399973,-10072,Unchanged,100000,5
codB,16339,3201,-2.351725106555469,-13138,Unchanged,100000,5
prpE,84,5617,6.06326666479985,5533,Unchanged,100000,5
prpD,41,4370,6.735865559769877,4329,Unchanged,100000,5
prpC,27,2690,6.638502955280518,2663,Unchanged,100000,5
prpB,11,2420,7.78135971352466,2409,Unchanged,100000,5
prpR,36,3530,6.61552746671623,3494,Unchanged,100000,5
yahO,750,152,-2.302819271939658,-598,Unchanged,100000,5
yahN,85,1264,3.8943898120394014,1179,Unchanged,100000,5
yahM,12,170,3.8244284354165456,158,Unchanged,100000,5
yahL,23,627,4.768759676745026,604,Unchanged,100000,5
yahK,1614,2520,0.6427831551094985,906,Unchanged,100000,5
yahJ,1002,3537,1.8196437105057104,2535,Unchanged,100000,5
yahI,47,2160,5.522226745373193,2113,Unchanged,100000,5
yahG,92,3747,5.3479583062721,3655,Unchanged,100000,5
yahF,68,3626,5.7367003684938185,3558,Unchanged,100000,5
yahE,35,1183,5.078951341394822,1148,Unchanged,100000,5
yahD,81,639,2.9798221180623696,558,Unchanged,100000,5
yahC,23,879,5.2561573990863915,856,Unchanged,100000,5
yahB,192,1467,2.9336906549522337,1275,Unchanged,100000,5
pdeL,2092,2088,-0.0027611396770568656,-4,Unchanged,100000,5
betT,318,4523,3.8301813253470556,4205,Unchanged,100000,5
betI,305,1482,2.280664299855585,1177,Unchanged,100000,5
betB,866,4573,2.400701989080239,3707,Unchanged,100000,5
betA,494,4160,3.074000581443777,3666,Unchanged,100000,5
ykgH,5,283,5.82273014794452,278,Unchanged,100000,5
ykgG,153,1321,3.110026908554176,1168,Unchanged,100000,5
ykgF,427,2914,2.770692902444022,2487,Unchanged,100000,5
ykgE,77,1192,3.95238197976726,1115,Unchanged,100000,5
rclR,71,1419,4.320911754555869,1348,Unchanged,100000,5
rclA,543,1676,1.62599804589499,1133,Unchanged,100000,5
rclB,6,40,2.736965594166206,34,Unchanged,100000,5
rclC,43,599,3.8001474380866878,556,Unchanged,100000,5
ykgA,164,648,1.982297998266541,484,Unchanged,100000,5
insF1,30,351,3.548436624696042,321,Unchanged,100000,5
insE1,70,89,0.34645041402143123,19,Unchanged,100000,5
eaeH,10,1059,6.726558779104974,1049,Unchanged,100000,5
ykgM,6,105,4.129283016944966,99,Unchanged,100000,5
ykgL,11,35,1.669851398307669,24,Unchanged,100000,5
ecpR,193,312,0.6929451815941678,119,Unchanged,100000,5
ecpA,1126,873,-0.36715326845078944,-253,Unchanged,100000,5
ecpB,193,1083,2.4883604903402468,890,Unchanged,100000,5
ecpC,469,4713,3.328985853499976,4244,Unchanged,100000,5
ecpD,431,2405,2.480277119568306,1974,Unchanged,100000,5
ecpE,195,1016,2.381354373022555,821,Unchanged,100000,5
ykgJ,80,326,2.0268000593437154,246,Unchanged,100000,5
yagU,7525,1179,-2.674127863554664,-6346,Unchanged,100000,5
paoA,153,1570,3.3591610010863375,1417,Unchanged,100000,5
paoB,175,2281,3.7042396194798086,2106,Unchanged,100000,5
paoC,476,5693,3.5801556210832026,5217,Unchanged,100000,5
paoD,214,2674,3.643316763692206,2460,Unchanged,100000,5
intF,2685,3552,0.4037094934773309,867,Unchanged,100000,5
yagN,1014,572,-0.8259706002249511,-442,Unchanged,100000,5
yagM,18,256,3.8300749985576874,238,Unchanged,100000,5
yagL,29,285,3.296837113924532,256,Unchanged,100000,5
yagK,133,768,2.5296800652199667,635,Unchanged,100000,5
yagJ,170,1756,3.3686861933976564,1586,Unchanged,100000,5
insA3,35,320,3.192645077942396,285,Unchanged,100000,5
insB3,86,1523,4.146435471785194,1437,Unchanged,100000,5
argF,1092,5038,2.2058782658143885,3946,Unchanged,100000,5
xynR,739,2431,1.7179036238825778,1692,Unchanged,100000,5
yagH,1344,5885,2.130509277147046,4541,Unchanged,100000,5
yagG,917,4804,2.3892425121105796,3887,Unchanged,100000,5
yagF,553,6133,3.4712415654059843,5580,Unchanged,100000,5
yagE,247,2714,3.457837773834177,2467,Unchanged,100000,5
yagA,24,3061,6.994824828805835,3037,Unchanged,100000,5
yagB,140,454,1.6972654703459484,314,Unchanged,100000,5
insA2,49,420,3.0995356735509145,371,Unchanged,100000,5
insB2,137,1026,2.9047829326465275,889,Unchanged,100000,5
afuB,13,723,5.797412118810025,710,Unchanged,100000,5
afuC,73,2857,5.290460762056354,2784,Unchanged,100000,5
mmuM,922,2421,1.3927644235695986,1499,Unchanged,100000,5
mmuP,690,3402,2.3017148739978537,2712,Unchanged,100000,5
insH1,1717,3867,1.171324725080673,2150,Unchanged,100000,5
ykfC,398,2407,2.596395805930848,2009,Unchanged,100000,5
insI1,38,36,-0.07800251200127321,-2,Unchanged,100000,5
perR,105,1528,3.8631833103696263,1423,Unchanged,100000,5
ykfA,98,1401,3.83753139631561,1303,Unchanged,100000,5
yafZ,13,1392,6.742503777707636,1379,Unchanged,100000,5
yafY,26,405,3.9613383796308947,379,Unchanged,100000,5
ykfB,199,666,1.7427537465276133,467,Unchanged,100000,5
ykfF,25,264,3.400537929583729,239,Unchanged,100000,5
yafX,193,841,2.123504952987064,648,Unchanged,100000,5
ykfG,30,753,4.649615459063409,723,Unchanged,100000,5
yafW,29,438,3.9168060644736014,409,Unchanged,100000,5
ykfI,13,288,4.46948528330122,275,Unchanged,100000,5
proA,4837,3447,-0.48877123907859327,-1390,Unchanged,100000,5
proB,4802,3678,-0.3847139238184788,-1124,Unchanged,100000,5
phoE,29,1090,5.232131424536717,1061,Unchanged,100000,5
crl,1340,5219,1.961540401275384,3879,Unchanged,100000,5
frsA,2630,2974,0.1773418478727541,344,Unchanged,100000,5
gpt,2604,538,-2.2750513706090114,-2066,Unchanged,100000,5
pepD,16229,5064,-1.6802247966312664,-11165,Unchanged,100000,5
prfH,13,644,5.630477159973525,631,Unchanged,100000,5
ykfJ,1,74,6.20945336562895,73,Unchanged,100000,5
yafP,55,337,2.6152450676571988,282,Unchanged,100000,5
yafO,81,303,1.9033239805883262,222,Unchanged,100000,5
yafN,129,210,0.7030182622428686,81,Unchanged,100000,5
dinB,1003,2105,1.0694986273415776,1102,Unchanged,100000,5
lafU,62,898,3.8563753243542718,836,Unchanged,100000,5
lfhA,70,2642,5.238131734301861,2572,Unchanged,100000,5
rayT,213,419,0.9760968134735133,206,Unchanged,100000,5
yafL,92,957,3.3788131584290126,865,Unchanged,100000,5
dinJ,620,294,-1.0764520604378731,-326,Unchanged,100000,5
yafQ,299,177,-0.7563961241151075,-122,Unchanged,100000,5
ldtF,1510,934,-0.6930540945027793,-576,Unchanged,100000,5
yafJ,1260,1166,-0.11185594518678231,-94,Unchanged,100000,5
gmhA,3326,1753,-0.923962172527731,-1573,Unchanged,100000,5
fadE,380,4336,3.512293433022924,3956,Unchanged,100000,5
ivy,29038,2907,-3.3203391141626644,-26131,Unchanged,100000,5
yafV,755,1097,0.5390149761907516,342,Unchanged,100000,5
yafU,2,115,5.845490050944375,113,Unchanged,100000,5
yafT,39,546,3.807354922057604,507,Unchanged,100000,5
dnaQ,1774,1192,-0.5736217738389024,-582,Unchanged,100000,5
rnhA,404,533,0.39978024000738116,129,Unchanged,100000,5
yafS,498,701,0.4932687019425422,203,Unchanged,100000,5
gloB,457,575,0.33136779077366796,118,Unchanged,100000,5
mltD,6965,2992,-1.2190131776009787,-3973,Unchanged,100000,5
yafE,268,588,1.133583154378592,320,Unchanged,100000,5
yafD,2492,1788,-0.4789573318406841,-704,Unchanged,100000,5
yafC,561,1334,1.2496859905757922,773,Unchanged,100000,5
dkgB,225,648,1.5260688116675876,423,Unchanged,100000,5
gmhB,710,586,-0.2769183599697965,-124,Unchanged,100000,5
metN,10879,2560,-2.0873302345090456,-8319,Unchanged,100000,5
metI,4930,1454,-1.7615603773456796,-3476,Unchanged,100000,5
metQ,21292,2202,-3.273425097361117,-19090,Unchanged,100000,5
rcsF,1432,673,-1.0893530826539393,-759,Unchanged,100000,5
trmO,1062,1145,0.10856383218015271,83,Unchanged,100000,5
proS,10167,4531,-1.1659926466917614,-5636,Unchanged,100000,5
yaeF,61,896,3.876617584494718,835,Unchanged,100000,5
nlpE,768,1121,0.5456080620842706,353,Unchanged,100000,5
arfB,333,619,0.8944172321430025,286,Unchanged,100000,5
yaeQ,566,989,0.8051684679272285,423,Unchanged,100000,5
rof,1094,336,-1.7030796000137962,-758,Unchanged,100000,5
tilS,1674,2348,0.4881328805597085,674,Unchanged,100000,5
yaeR,330,418,0.3410369178350669,88,Unchanged,100000,5
ldcC,1860,3413,0.8757377931034717,1553,Unchanged,100000,5
accA,5631,2604,-1.112661702386395,-3027,Unchanged,100000,5
dnaE,6065,7506,0.30753664487910326,1441,Unchanged,100000,5
rnhB,1058,1287,0.282672426106676,229,Unchanged,100000,5
lpxB,3900,3379,-0.20687777347317152,-521,Unchanged,100000,5
lpxA,5579,3083,-0.8556716619409007,-2496,Unchanged,100000,5
fabZ,3247,1462,-1.1511640733336508,-1785,Unchanged,100000,5
lpxD,22317,4821,-2.2107387686637288,-17496,Unchanged,100000,5
skp,13479,2175,-2.6316261616211416,-11304,Unchanged,100000,5
bamA,23333,8136,-1.5199802269520264,-15197,Unchanged,100000,5
rseP,7681,3889,-0.9818949148622766,-3792,Unchanged,100000,5
cdsA,3120,1808,-0.7871513513344228,-1312,Unchanged,100000,5
uppS,3244,1321,-1.2961433529704454,-1923,Unchanged,100000,5
dxr,1423,2224,0.644221126197025,801,Unchanged,100000,5
frr,9176,2046,-2.1650592462704963,-7130,Unchanged,100000,5
pyrH,6446,2314,-1.4780153239520553,-4132,Unchanged,100000,5
tsf,26993,6595,-2.033140762144993,-20398,Unchanged,100000,5
rpsB,49068,9015,-2.4443830719278177,-40053,Unchanged,100000,5
map,3894,1640,-1.2475570692148488,-2254,Unchanged,100000,5
glnD,3717,4862,0.3874112051669712,1145,Unchanged,100000,5
dapD,9718,3613,-1.4274621776848422,-6105,Unchanged,100000,5
yaeI,218,969,2.152168530638155,751,Unchanged,100000,5
yaeH,1102,437,-1.3344190390705593,-665,Unchanged,100000,5
cdaR,234,1737,2.8920173191269885,1503,Unchanged,100000,5
degP,8840,7139,-0.3083243676423581,-1701,Unchanged,100000,5
dgt,1210,2212,0.8703443380727502,1002,Unchanged,100000,5
mtn,2775,2447,-0.18147367004544102,-328,Unchanged,100000,5
btuF,455,1461,1.6830177277174398,1006,Unchanged,100000,5
yadS,192,945,2.299208018387279,753,Unchanged,100000,5
erpA,1638,749,-1.1288977331822576,-889,Unchanged,100000,5
clcA,1423,3073,1.1107121050664799,1650,Unchanged,100000,5
hemL,6309,4937,-0.35377670571183883,-1372,Unchanged,100000,5
fhuB,289,4831,4.063180454931398,4542,Unchanged,100000,5
fhuD,183,1865,3.349260076858558,1682,Unchanged,100000,5
fhuC,240,1911,2.993221467368938,1671,Unchanged,100000,5
fhuA,812,4226,2.3797411347497643,3414,Unchanged,100000,5
mrcB,3223,6379,0.9849260901198685,3156,Unchanged,100000,5
hrpB,2277,6513,1.516187935199678,4236,Unchanged,100000,5
thpR,338,842,1.3167969867842118,504,Unchanged,100000,5
sfsA,796,1123,0.4965175918569524,327,Unchanged,100000,5
dksA,5898,1898,-1.6357458300406276,-4000,Unchanged,100000,5
gluQ,257,1532,2.575576032731079,1275,Unchanged,100000,5
pcnB,7003,4320,-0.6969417750889682,-2683,Unchanged,100000,5
folK,364,621,0.7706548180217851,257,Unchanged,100000,5
yadN,7,534,6.25334100962995,527,Unchanged,100000,5
yadV,8,686,6.422064766172812,678,Unchanged,100000,5
htrE,90,2363,4.714550817644172,2273,Unchanged,100000,5
yadM,45,400,3.15200309344505,355,Unchanged,100000,5
yadL,68,365,2.4242898125170402,297,Unchanged,100000,5
yadK,19,312,4.037474705418663,293,Unchanged,100000,5
yadC,68,607,3.1580898650053424,539,Unchanged,100000,5
panB,7600,4583,-0.7297071328439977,-3017,Unchanged,100000,5
panC,9902,4616,-1.1010767253166782,-5286,Unchanged,100000,5
rpnC,118,1048,3.150779952175609,930,Unchanged,100000,5
panD,3277,590,-2.4735888132935564,-2687,Unchanged,100000,5
yadE,379,1857,2.2927040617643293,1478,Unchanged,100000,5
yadI,187,516,1.4643327955356173,329,Unchanged,100000,5
yadH,773,1126,0.5426665081553823,353,Unchanged,100000,5
yadG,974,1747,0.8428859308344173,773,Unchanged,100000,5
can,1783,1054,-0.7584318359877802,-729,Unchanged,100000,5
hpt,1728,1087,-0.6687512771361593,-641,Unchanged,100000,5
gcd,365,4715,3.6912894017950793,4350,Unchanged,100000,5
cueO,1526,2906,0.9292797407983108,1380,Unchanged,100000,5
yacC,374,449,0.26367717485351017,75,Unchanged,100000,5
speE,3965,2539,-0.6430604709438351,-1426,Unchanged,100000,5
speD,5051,1945,-1.3767988865576484,-3106,Unchanged,100000,5
yacL,367,499,0.44325975249404775,132,Unchanged,100000,5
acnB,11551,12248,0.08452843305444614,697,Unchanged,100000,5
yacH,108,3410,4.980668521748067,3302,Unchanged,100000,5
lpd,4924,9621,0.9663560926783457,4697,Unchanged,100000,5
aceF,3333,15117,2.1812786395806607,11784,Unchanged,100000,5
aceE,4427,20500,2.2112226311823053,16073,Unchanged,100000,5
pdhR,214,3051,3.833599478177509,2837,Unchanged,100000,5
aroP,1341,3309,1.303086054408065,1968,Unchanged,100000,5
ampE,966,1616,0.7423321039160216,650,Unchanged,100000,5
ampD,585,977,0.7399219374976185,392,Unchanged,100000,5
nadC,880,1755,0.9958956016672635,875,Unchanged,100000,5
ppdD,6,668,6.798741791752896,662,Unchanged,100000,5
hofB,207,2662,3.6848078984125667,2455,Unchanged,100000,5
hofC,144,2558,4.150875547439325,2414,Unchanged,100000,5
guaC,8293,2263,-1.8736575077294848,-6030,Unchanged,100000,5
coaE,500,1018,1.0257375614136082,518,Unchanged,100000,5
zapD,1011,1439,0.5092835948372834,428,Unchanged,100000,5
yacG,75,157,1.0658020583957462,82,Unchanged,100000,5
mutT,74,281,1.9249729545919763,207,Unchanged,100000,5
secA,8479,11743,0.46983499204021323,3264,Unchanged,100000,5
secM,1363,1227,-0.15165031314230443,-136,Unchanged,100000,5
lpxC,40225,24484,-0.716253147691607,-15741,Unchanged,100000,5
ftsZ,22718,8607,-1.4002534575093086,-14111,Unchanged,100000,5
ftsA,5696,4396,-0.37375776001716665,-1300,Unchanged,100000,5
ftsQ,3490,2794,-0.3208950156875514,-696,Unchanged,100000,5
ddlB,5291,3034,-0.8023193321603057,-2257,Unchanged,100000,5
murC,6363,4643,-0.45464984068504954,-1720,Unchanged,100000,5
murG,3622,2956,-0.2931402768040169,-666,Unchanged,100000,5
ftsW,3563,3704,0.05599161512693684,141,Unchanged,100000,5
murD,5300,4248,-0.31920859353377024,-1052,Unchanged,100000,5
mraY,3504,2775,-0.3365150034763427,-729,Unchanged,100000,5
murF,6004,4034,-0.573712893007727,-1970,Unchanged,100000,5
murE,7043,4850,-0.5382053354274857,-2193,Unchanged,100000,5
ftsI,3873,4417,0.18961533101180636,544,Unchanged,100000,5
ftsL,783,608,-0.3649409838474552,-175,Unchanged,100000,5
rsmH,5264,3646,-0.5298449276961072,-1618,Unchanged,100000,5
mraZ,2814,1921,-0.5507648095710056,-893,Unchanged,100000,5
cra,4031,3394,-0.24815121830841616,-637,Unchanged,100000,5
ilvH,1567,1606,0.03546671304473432,39,Unchanged,100000,5
ilvI,6468,6503,0.007785744966595214,35,Unchanged,100000,5
leuO,356,1323,1.8938639153122792,967,Unchanged,100000,5
leuL,1,1,0.0,0,Unchanged,100000,5
leuA,9070,4953,-0.8727999297814705,-4117,Unchanged,100000,5
leuB,9512,3489,-1.4469351175512815,-6023,Unchanged,100000,5
leuC,13063,5585,-1.225857073092109,-7478,Unchanged,100000,5
leuD,4945,1867,-1.4052485934202712,-3078,Unchanged,100000,5
setA,654,2432,1.894780687945503,1778,Unchanged,100000,5
sgrR,629,4527,2.8474233843685504,3898,Unchanged,100000,5
thiB,676,2262,1.7425037777076362,1586,Unchanged,100000,5
thiP,254,3743,3.8812946461277957,3489,Unchanged,100000,5
thiQ,147,1537,3.3862291048544066,1390,Unchanged,100000,5
yabI,336,1797,2.4190572707311815,1461,Unchanged,100000,5
araC,558,2223,1.9941709211978025,1665,Unchanged,100000,5
araB,96,4012,5.385143389891025,3916,Unchanged,100000,5
araA,169,3659,4.436354264056903,3490,Unchanged,100000,5
araD,34,1458,5.422312163076597,1424,Unchanged,100000,5
polB,1148,4883,2.0886451359617757,3735,Unchanged,100000,5
rapA,1702,6270,1.8812344060034387,4568,Unchanged,100000,5
rluA,323,1135,1.8130862274843524,812,Unchanged,100000,5
djlA,683,1745,1.353269552806924,1062,Unchanged,100000,5
lptD,15687,8100,-0.9535756629086479,-7587,Unchanged,100000,5
surA,9386,5589,-0.7479202853654693,-3797,Unchanged,100000,5
pdxA,2187,2558,0.22606304383354378,371,Unchanged,100000,5
rsmA,3304,2135,-0.6299776169115925,-1169,Unchanged,100000,5
apaG,1093,832,-0.3936379675308125,-261,Unchanged,100000,5
apaH,1602,1895,0.2423237006497438,293,Unchanged,100000,5
folA,663,764,0.2045637679231608,101,Unchanged,100000,5
kefC,818,4462,2.4475177653023916,3644,Unchanged,100000,5
kefF,220,912,2.0515303006400822,692,Unchanged,100000,5
yaaU,31,2853,6.524067721194845,2822,Unchanged,100000,5
fixX,5,294,5.877744249949002,289,Unchanged,100000,5
fixC,46,2992,6.023332503830623,2946,Unchanged,100000,5
fixB,59,2155,5.190829104614619,2096,Unchanged,100000,5
fixA,58,1677,4.853685978436774,1619,Unchanged,100000,5
caiT,36,2922,6.3428154613611865,2886,Unchanged,100000,5
caiA,466,2368,2.3452672209746694,1902,Unchanged,100000,5
caiB,244,2260,3.211369719739664,2016,Unchanged,100000,5
caiC,312,2861,3.196901563460935,2549,Unchanged,100000,5
caiD,56,1653,4.883516087234709,1597,Unchanged,100000,5
caiE,49,1168,4.575114714764809,1119,Unchanged,100000,5
caiF,2125,1004,-1.0817035719616543,-1121,Unchanged,100000,5
carB,87261,11084,-2.976858390979492,-76177,Unchanged,100000,5
carA,39642,3752,-3.4012980175830543,-35890,Unchanged,100000,5
dapB,2670,1893,-0.4961653308712111,-777,Unchanged,100000,5
rihC,369,2201,2.576466423831161,1832,Unchanged,100000,5
ispH,3204,3048,-0.0720112449153881,-156,Unchanged,100000,5
fkpB,1220,1102,-0.14675692387909103,-118,Unchanged,100000,5
lspA,2428,1585,-0.6152855812289125,-843,Unchanged,100000,5
ileS,26188,16243,-0.6890877684242107,-9945,Unchanged,100000,5
ribF,5326,3097,-0.7821810455359511,-2229,Unchanged,100000,5
yaaY,16,143,3.1598713367783895,127,Unchanged,100000,5
rpsT,3080,393,-2.9703291333236574,-2687,Unchanged,100000,5
insA1,18,180,3.321928094887362,162,Unchanged,100000,5
insB1,37,444,3.584962500721156,407,Unchanged,100000,5
nhaR,999,1918,0.9410461372257125,919,Unchanged,100000,5
nhaA,4014,5155,0.36093181089285364,1141,Unchanged,100000,5
mokC,20,112,2.4854268271702415,92,Unchanged,100000,5
insL1,1370,2634,0.9430794524086253,1264,Unchanged,100000,5
dnaJ,4436,7278,0.7142826856799565,2842,Unchanged,100000,5
dnaK,59018,42708,-0.4666486929157538,-16310,Unchanged,100000,5
yaaI,10,571,5.83541884047548,561,Unchanged,100000,5
yaaW,51,1140,4.482392767080609,1089,Unchanged,100000,5
satP,321,1268,1.981909543017104,947,Unchanged,100000,5
mog,716,1296,0.8560342256203683,580,Unchanged,100000,5
talB,30807,7264,-2.0844220911612354,-23543,Unchanged,100000,5
yaaJ,622,2970,2.255476445557526,2348,Unchanged,100000,5
yaaA,1210,1732,0.5174318825647681,522,Unchanged,100000,5
yaaX,114,320,1.4890380807226207,206,Unchanged,100000,5
thrC,8008,11992,0.5825584091118661,3984,Unchanged,100000,5
thrB,5969,11160,0.9027758682667467,5191,Unchanged,100000,5
thrA,18297,38832,1.0856388918640891,20535,Unchanged,100000,5
thrL,1,1,0.0,0,Unchanged,100000,5
